SILVER BLAZE	白銀の失踪
Conan Doyle	コナンドイル
``I am afraid, Watson that I shall have to go,''	「ワトソン君、僕は行（ゆ）かなきゃならないんだがね」
said Holmes as we sat down together to our breakfast one morning.	ある朝、一緒に食事をしている時にホームズがいった。
``Go! Where to?''	「行くってどこへ？」
``To Dartmoor;	「ダートムアだ
to King's Pyland.''	――キングス・パイランドだ」
I was not surprised.	私は格別おどろきもしなかった。
Indeed, my only wonder was that he had not already been mixed up in this extraordinary case, which was the one topic of conversation through the length and breadth of England.	事実、私は、今全イングランドの噂の種になっているこの驚くべき事件に、ホームズが関係しないということをむしろ不思議にさえ思っていたのである。
For a whole day my companion had rambled about the room with his chin upon his chest and his brows knitted, charging and recharging his pipe with the strongest black tobacco, and absolutely deaf to any of my questions or remarks.	前の日、ホームズは終日眉根をよせた顔を首垂（うなだ）れて、強い黒煙草をパイプにつめかえつめかえ部屋の中を歩き廻ってばかりいて、私が何を話しかけても何を訊ねても石のように黙りこくっていた。
Fresh editions of every paper had been sent up by our news agent, only to be glanced over and tossed down into a corner.	あらゆる新聞の新らしい版が出るごとに、いちいち配達所から届けられたが、それすらちょっと眼を通すだけですぐに部屋の隅へ投げすてた。
Yet, silent as he was, I knew perfectly well what it was over which he was brooding.	しかも、彼が一言も口をきかないにも拘らず、彼の頭脳（あたま）の中で考えられていることは、私にはよく分っていた。
There was but one problem before the public which could challenge his powers of analysis, and that was the singular disappearance of the favourite for the Wessex Cup, and the tragic murder of its trainer.	いま彼の推理力と太刀打ちの出来る問題といえばただ一つ、ウェセックス賞杯（カップ）争覇戦出場の名馬の奇怪なる失踪と、その調馬師の惨殺された事件があるのみだ。
When, therefore, he suddenly announced his intention of setting out for the scene of the drama, it was only what I had both expected and hoped for.	だから彼が突然、その悲劇の現場（げんじょう）へ行くといい出したことは、私にとっては予期していたことでありまた希望していたことでもあったのだ。
``I should be most happy to go down with you if I should not be in the way,''	「差支えがなければ僕も行ってみたいんだがね」
said I.	と、私はいった。
``My dear Watson, you would confer a great favour upon me by coming.	「君に来てもらえれば大変有難いんだが。
And I think that your time will not be misspent, for there are points about the case which promise to make it an absolutely unique one.	この事件は極めて特異なものだと思われる節があるから、君にしたって行くことはまんざらむだにはなるまいと思う。
We have, I think, just time to catch our train at Paddington,	今からパディントン停車場へ行けば、ちょうど汽車の時間にいいだろう。
and I will go further into the matter upon our journey.	委（くわ）しいことは途々（みちみち）話すとして、
You would oblige me by bringing with you your very excellent field-glass.''	すまないが君のあの上等の双眼鏡を持って来てくれたまえ」
And so it happened that an hour or so later I found myself in the corner of a first-class carriage flying along en route for Exeter,	それから一時間あまりの後には、私はエクスタ行の一等車の一隅に腰かけていた。
while Sherlock Holmes, with his sharp, eager face framed in his ear-flapped travelling-cap, dipped rapidly into the bundle of fresh papers which he had procured at Paddington.	シャーロック・ホームズは耳垂れつきの旅行用ハンチングを被った顔を緊張させて、パディントンで新らたに買った新聞に忙しそうに眼を通していた。
We had left Reading far behind us before he thrust the last one of them under the seat and offered me his cigar-case.	そしてリイディングをずっと過ぎた頃、彼はそれ等の新聞をまとめて座席の下へ突込み、シガー・ケースを取出して私にもすすめた。
``We are going well,''	「至極順調に走ってるようだね」
said he, looking out of the window	ホームズは窓の外を眺めながらそういった。
and glancing at his watch.	そして時計を出して見て、
``Our rate at present is fifty-three and a half miles an hour.''	「今ちょうど速力は一時間五十三哩（まいる）半だ」
``I have not observed the quarter-mile posts,''	「四分の一哩標が見えなかったようだが」
said I.	と、私はいった。
``Nor have I.	「僕はそんなものは見やしないよ、
But the telegraph posts upon this line are sixty yards apart, and the calculation is a simple one.	だが、この線路の電柱は六十ヤードごとに立ってるのだから計算は極めて簡単に出来るんだ。
I presume that you have looked into this matter of the murder of John Straker and the disappearance of Silver Blaze?''	ところで、ジョン・ストレーカ殺しと白銀号（しろがねごう）失踪事件については、もう十分知ってるんだろうね？」
``I have seen what the Telegraph and the Chronicle have to say.''	「テレグラフ紙とクロニクル紙との記事は読んだ」
``It is one of those cases where the art of the reasoner should be used rather for the sifting of details than for the acquiring of fresh evidence.	「この事件も探究の方法としては、新らしい証拠を求めるよりも、既に知れている些末な事実を分析し淘汰して行く方が、賢い方法かも知れぬ。
The tragedy has been so uncommon, so complete, and of such personal importance to so many people that we are suffering from a plethora of surmise, conjecture, and hypothesis.	今度の事件は非常に珍らしい事件で巧妙に行われ、その上多大の人々に重大な関係を持ってるものだから、いろいろと揣摩臆説が行われるんで困らされてるんだが、
The difficulty is to detach the framework of fact -- of absolute undeniable fact -- from the embellishments of theorists and reporters.	要するに問題は事実の骨組を、絶対に動かすべからざる事実の骨組を、諸説紛々たる報道の中から掴み出せばいいんだ。
Then, having established ourselves upon this sound basis, it is our duty to see what inferences may be drawn and what are the special points upon which the whole mystery turns.	そして、それが出来たら、そのしっかりとした根底の上に立って、そこからいかなる推論が出て来るか、事件の秘密はどの点にかかっているかということを発見するのが我々の役目だ。
On Tuesday evening I received telegrams from both Colonel Ross, the owner of the horse, and from Inspector Gregory, who is looking after the case, inviting my cooperation.''	僕は火曜日の晩に、馬の持主のロス大佐と事件担当のグレゴリ警部との両方から、来て一緒に調べてくれという依頼の電報を受け取ったんだ」
``Tuesday evening!''	「火曜日の晩に？」
I exclaimed.	私は叫んだ。
``And this is Thursday morning.	「今日は木曜日じゃないか。
Why didn't you go down yesterday?''	何んだって昨日のうちに行かなかったんだい？」
``Because I made a blunder, my dear Watson	「僕がどじを踏んだんだよ君、
-- which is, I am afraid, a more common occurrence than anyone would think who only knew me through your memoirs.	そうした失敗は、君の記録によってのみ僕を知る人々が考えているよりもはるかにちょいちょい僕にはあるんだよ。
The fact is	こういうわけさ、
that I could not believe it possible that the most remarkable horse in England could long remain concealed, especially in so sparsely inhabited a place as the north of Dartmoor.	――イングランド一流の名馬がそう長く行方の知れないわけがない、殊にダートムアの北部のような人口の稀れな地方にあっては、そんなことはあり得ないと考えたんだ。
From hour to hour yesterday I expected to hear that he had been found, and that his abductor was the murderer of John Straker.	だから、昨日は、今に馬盗人が知れた、そしてストレーカ殺しもその馬盗人と同一人だったと知らせて来るかと、そればかり待ち暮したんだよ、
When, however, another morning had come and I found that beyond the arrest of young Fitzroy Simpson nothing had been done, I felt that it was time for me to take action.	しかし、また一日が空しくすぎて、今朝になってみると、フィツロイ・シンプソンという青年が捕まったきりで、事が少しも捗らないようだから、いよいよ自分の出場（でば）が来たと思ったんだ。
Yet in some ways I feel that yesterday has not been wasted.''	とはいっても、昨日だって決して空費したわけではないがね」
``You have formed a theory, then?''	「じゃ、見込でもついたのかね？」
``At least I have got a grip of the essential facts of the case.	「少くとも事件の主要な事実だけは掴んだ。
I shall enumerate them to you,	それを君に話してきかそう。
for nothing clears up a case so much as stating it to another person, and I can hardly expect your cooperation if I do not show you the position from which we start.''	他人に事件の経緯（いきさつ）を話してきかせるくらい自分の考えをはっきりさせ得ることはないのだし、それに事件をよく知ってもらって、どこから手をつけるべきかを話しておかないと、君にしても助力のしようがあるまいからね」
I lay back against the cushions, puffing at my cigar, while Holmes, leaning forward, with his long, thin forefinger checking off the points upon the palm of his left hand, gave me a sketch of the events which had led to our journey.	私はクッションに身を埋（うず）めて葉巻を吹かしながら、ホームズが身体を前へ乗り出して、要点ごとに細長い人差指で左の掌を叩き、事件の大体を話すのをきくのであった。
``Silver Blaze,'' said he, ``is from the Somomy stock and holds as brilliant a record as his famous ancestor.	「白銀号というのはアイソノミ系の馬だが、祖先の名を恥かしめぬ立派な記録を持っている。
He is now in his fifth year and has brought in turn each of the prizes of the turf to Colonel Ross, his fortunate owner.	今は五歳で競馬のあるたびに賞品をみんな攫って来るんで、持主のロス大佐は非常にうまくやってるわけだ。
Up to the time of the catastrophe he was the first favourite for the Wessex Cup, the betting being three to one on him.	現に今度の事件の起るまで、白銀号といえばウェセクス賞杯（しょうはい）争覇戦第一の人気馬で、賭もほかの馬に対して三対一という割合だった。
He has always, however, been a prime favourite with the racing public and has never yet disappointed them, so that even at those odds enormous sums of money have been laid upon him.	それほど競馬界切っての人気をつづけて来ながら、まだ一度もその贔負に失望を与えたことがないものだから、少々ぐらい賭金は高くても、依然として白銀号には莫大な金が賭けられるというわけなんだ。
It is obvious, therefore, that there were many people who had the strongest interest in preventing Silver Blaze from being there at the fall of the flag next Tuesday.	だから、この火曜日の決戦に白銀号が出られなくするということは、多くの人々に非常な利害関係を持つことになる。
``The fact was, of course, appreciated at King's Pyland, where the colonel's training-stable is situated. Every precaution was taken to guard the favourite.	この事実は、むろん大佐の調馬場のあるキングス・パイランドではよく心得ていた、
The trainer, John Straker, is a retired jockey who rode in Colonel Ross's colours before he became too heavy for the weighing-chair.	調馬師のジョン・ストレーカという男はもと騎手で、ロス大佐の騎手をやっていたが、体重が重くなったので止めたんだ。
He has served the colonel for five years as jockey and for seven as trainer, and has always shown himself to be a zealous and honest servant.	騎手として五年、調馬師として七年大佐に仕えているが、その間いつも熱心で正直な男としてつとめて来た、
Under him were three lads, for the establishment was a small one, containing only four horses in all.	規模の小さな調馬場で、馬が四頭しかいなかったから、ストレーカの下に三人の若い者がいるだけで、
One of these lads sat up each night in the stable, while the others slept in the loft.	そのうちの一人が毎晩厩舎（うまや）に寝ずの番をし、あとの二人は厩舎の二階に寝ることになっていた。
All three bore excellent characters.	三人とも至極性質のよい若者だ。
John Straker, who is a married man lived in a small villa about two hundred yards from the stables.	ストレーカには妻があって、厩舎から二百ヤードばかりはなれたところにある小さな家（うち）に住んでいた。
He has no children, keeps one maidservant, and is comfortably off.	子供はないが女中を一人おいて気楽に暮していた。
The country round is very lonely, but about half a mile to the north there is a small cluster of villas which have been built by a Tavistock contractor for the use of invalids and others who may wish to enjoy the pure Dartmoor air.	この附近は極めて淋しいところで、だだ半哩ばかり北の方に、タヴィストック市のある請負師が、病人や、ダートムアの新鮮な空気を楽しみたいという人達をあてこんで建てた別荘風の家が一かたまりあるだけだ。
Tavistock itself lies two miles to the west, while across the moor, also about two miles distant, is the larger training establishment of Mapleton,	タヴィストックへは西へ二哩ばかりあり、荒地（あれち）を越して二哩ばかり行くと、ケープルトンにはかなり大きな調馬場がある。
which belongs to Lord Backwater and is managed by Silas Brown.	これはバックウォータ卿の所有で、サイラス・ブラウンという男が管理している。
In every other direction the moor is a complete wilderness, inhabited only by a few roaming gypsies.	そのほかどっちを見ても、荒地は全く人気（ひとげ）というものがなく、ただわずかに漂白（さすらい）のジプシーが二三いるくらいのものだ。
Such was the general situation last Monday night when the catastrophe occurred.	これが日曜の晩に事件が起るまでの大体の状況だ。
``On that evening the horses had been exercised and watered as usual, and the stables were locked up at nine o'clock.	当夜はいつもの通り馬を運動させて、水をやった上九時に厩舎の戸を閉めて戸締りをした。
Two of the lads walked up to the trainer's house, where they had supper in the kitchen, while the third, Ned Hunter, remained on guard.	そして三人の若い者のうち二人は台所で夕飯を食べに調馬師の家まで歩いて行くし、あとの一人ネッド・ハンタだけは厩舎に残って番をしていた、
At a few minutes after nine the maid, Edith Baxter, carried down to the stables his supper, which consisted of a dish of curried mutton.	すると、女中のエディス・バクスタが九時ちょっとすぎに、羊のカレ料理の夕飯を運んで来てくれたが、それには飲みものは何も添えてなかった。
She took no liquid, as there was a water-tap in the stables, and it was the rule that the lad on duty should drink nothing else.	仕事中は水以外の飲みものは飲んでならないことになっていたし、水なら厩舎にいくらでも出る栓があるからだ。
The maid carried a lantern with her, as it was very dark and the path ran across the open moor.	非常に暗い晩だったので、それに途中は淋しい荒地だったので女中は提灯を持っていた。
``Edith Baxter was within thirty yards of the stables when a man appeared out of the darkness and called to her to stop.	女中のエディス・バクスタは厩舎から三十ヤードばかりのところまで来ると、暗がりの中から不意に声をかけて一人の男が現われて来た。
As she stepped into the circle of yellow light thrown by the lantern she saw that he was a person of gentlemanly bearing, dressed in a gray suit of tweeds, with a cloth cap.	提灯の投げる丸い光の圏内まで来たのを見ると、鼠色のスコッチの服を着て羅紗のハンチングを被った紳士風の男で、
He wore gaiters and carried a heavy stick with a knob to it.	ゲートルをつけて、握りの玉になってる太いステッキを持っていたという。
She was most impressed, however, by the extreme pallor of his face and by the nervousness of his manner.	が、エディスが特に印象づけられたのは、顔色がひどく蒼ざめて、何んとなく挙動のそわそわしてることだった。
His age, she thought, would be rather over thirty than under it.	年は三十をちょっとすぎたくらいだったという。
```Can you tell me where I am?'	「一体ここはどこなんですか？」
he asked.	と男は訊ねた。
`I had almost made up my mind to sleep on the moor when I saw the light of your lantern.'	「仕方がないからこの荒野で野宿をしようと決心してるところへ、お前さんの灯が見えたんでホッとしたわけですよ」
```You are close to the King's Pyland training stables,'	「ここはキングス・パイランド調馬場のすぐ側（わき）です」
```Oh, indeed!	「おお、そうだったか！
What a stroke of luck!'	それはまあ何んという仕合せなことだろう！
`I understand that a stable-boy sleeps there alone every night.	ふむ、毎晩一人ずつ厩舎で寝るんだと見えるな。
Perhaps that is his supper which you are carrying to him.	それでいまお前さんが夕飯を持って行って来たんだな。
Now I am sure that you would not be too proud to earn the price of a new dress, would you?'	ところでお前さん、新らしい着物が一重ね拵えられるお金の儲かる話があるんだが、嫌だなんて見栄を張るお前さんじゃありますまいね？」
He took a piece of white paper folded up out of his waistcoat pocket.	男はチョッキのポケットから折りたたんだ白い紙を取出して、
`See that the boy has this to-night, and you shall have the prettiest frock that money can buy.'	「これを今晩の中（うち）に厩番（うまやばん）に手渡してくれれば、お前さんは飛切上等（じょうら）の晴着が手に入るんだがね」
``She was frightened by the earnestness of his manner and ran past him to the window through which she was accustomed to hand the meals.	「女中がこの男の様子があんまり真剣だったので恐くなって、すりぬけるようにしていつも食事を渡すことになってる厩舎の窓のところへ駈けて行った。
It was already opened, and Hunter was seated at the small table inside.	と、ハンタはもう窓を開けて、小さなテーブルに向って食事をしていた。
She had begun to tell him of what had happened when the stranger came up again.	ネッド実はいまこれこれだと話しかけてると、そこへまたも先刻（さっき）の男が追っかけて来た。
```Good-evening,'	「今晩は」
looking through the window.	男は窓から中を覗き込みながら、
`I wanted to have a word with you.'	「実はお前さんに少々話したいことがあるんですがね」
The girl has sworn that as he spoke she noticed the corner of the little paper packet protruding from his closed hand.	とハンタに声をかけたが、その時に手に握っていた小さな紙包の端がチラッと見えたと、後で女中は断言している。
```What business have you here?'	「何用で来なすったのかね？」
asked the lad.	ハンタは反問した。
'' `It's business that may put something into your pocket,'	「お前さんの儲かる耳よりな話なんだがね。
`You've two horses in for the Wessex Cup	ここにはウェセクス賞杯戦に出る馬が二頭いる
-- Silver Blaze and Bayard.	――白銀と栗毛と
Let me have the straight tip and you won't be a loser.	――お前さん確実な予想を教えてくれませんかね、決して悪いようにはしないが。
Is it a fact that at the weights Bayard could give the other a hundred yards in five furlongs, and that the stable have put their money on him?'	重量の点で、栗毛は八分の五哩で白銀に百ヤードは分があるというんで、馬主筋はみんな栗毛に賭けたというが本当かね？」
```So, you're one of those damned touts!'	「うむ、さては手前は馬の様子を探りに来たスパイだな？
`I'll show you how we serve them in King's Pyland.'	よしッ！
He sprang up and rushed across the stable to unloose the dog.	とハンタは叫んで、犬を放しに走った。
The girl fled away to the house, but as she ran she looked back and saw that the stranger was leaning through the window.	女中はそのまま家の方へ駈け戻ったが、走りながら振返ってみると、その男は窓から中へ半身を乗り入れるようにしていたという。
A minute later, however, when Hunter rushed out with the hound he was gone, and though he ran all round the buildings he failed to find any trace of him.''	けれどもそれから一分間後に、ハンタが犬をつれて外へ飛び出して見た時には、もうその男はいなかったので、厩舎のまわりを駈けずりまわって探してみたが、どこにも姿は見えなかった。」［＃「」」は底本では欠落］
``One moment,''	「ちょっと」
I asked.	私はホームズを遮った。
``Did the stable-boy, when he ran out with the dog, leave the door unlocked behind him?''	「ハンタは犬をつれて飛び出した時、厩舎の戸締りをしないでおったのかい？」
``Excellent,	「素敵！
Watson, excellent!''	素敵だ！
``The importance of the point struck me so forcibly that I sent a special wire to Dartmoor yesterday to clear the matter up.	その点が非常に大切だと思ったから、僕は昨日ダートムアへ電報を打って訊ねてみた。
The boy locked the door before he left it.	ハンタは出る時鍵をかけたそうだ。
The window, I may add, was not large enough for a man to get through.	そして窓は、人間の入れるほどの大きさはないという。
``Hunter waited until his fellow-grooms had returned, when he sent a message to the trainer and told him what had occurred.	ハンタは仲間が食事から帰って来るのを待って、親方の調馬師に事の次第を報告に出かけた。
Straker was excited at hearing the account, although he does not seem to have quite realized its true significance.	ストレーカはそれをきくとひどく昂奮して、それが何を意味するか分らなかったらしいが、漠然たる不安を感じたらしかった。
It left him, however, vaguely uneasy, and Mrs. Straker, waking at one in the morning, found that he was dressing.	そして夜の一時に細君がふと眼を覚ましてみると、服を着かけていたという。
In reply to her inquiries, he said that he could not sleep on account of his anxiety about the horses, and that he intended to walk down to the stables to see that all was well.	細君が驚いてその理由（わけ）を訊ねると、馬のことが心配になって眠れないから、厩舎に間違いでもないかを見に行くつもりだという。
She begged him to remain at home, as she could hear the rain pattering against the window, but in spite of her entreaties he pulled on his large mackintosh and left the house.	ちょうど雨が窓を打つ音をきいたので、細君はどうぞ家（うち）にいてくれと願ったが、泣かんばかりに願ったが肯（きき）入れないで、大きな雨外套に身を包んでそのまま出ていってしまった。
``Mrs. Straker awoke at seven in the morning	細君が翌朝眼を覚ましたのは七時だった。
to find that her husband had not yet returned.	が、その時はまだストレーカは帰っていなかった。
She dressed herself hastily, called the maid, and set off for the stables.	そこで細君は急いで着物を着て、女中を呼んで一緒に厩舎まで行ってみた。
The door was open;	すると、厩舎の戸は開け放しになっていて、
inside, huddled together upon a chair, Hunter was sunk in a state of absolute stupor, the favourite's stall was empty, and there were no signs of his trainer.	中にはハンタが椅子にうずくまって深い深い眠りに落ちているばかりで、白銀の厩舎は藻抜けの殻で、ストレーカの姿も見えなかった。
``The two lads who slept in the chaff-cutting loft above the harness-room were quickly aroused.	馬具部屋の二階の乾草の中に眠っている二人の若い者をすぐに呼び起したが、
They had heard nothing during the night, for they are both sound sleepers.	二人とも寝ぼすけな性質（たち）なので、夜中に何もきかなかったという。
Hunter was obviously under the influence of some powerful drug,	ハンタはむろん強い薬品のために眠っているのに違いなかった。
and as no sense could be got out of him, he was left to sleep it off while the two lads and the two women ran out in search of the absentees.	ゆり起してみたが、全く正体なく眠っているので、それはそのままにしておいて、二人の若者と二人の女とで、ストレーカと白銀とを探しに［＃「に」は底本では「た」］飛び出して行った。
They still had hopes that the trainer had for some reason taken out the horse for early exercise,	というのは、ストレーカが何かの理由で朝早くから白銀を運動させにつれて行ったものだろうと思われたから。
but on ascending the knoll near the house, from which all the neighbouring moors were visible, they not only could see no signs of the missing favourite, but they perceived something which warned them that they were in the presence of a tragedy.	だが、厩舎の傍の低い丘へかけ上ってみると、そこからは八方の荒地（あれち）が見渡せるが、どっちを見ても名馬の影すら見えないばかりか、何か不吉なことが起ったんだなという予感を起させられたのだった。
``About a quarter of a mile from the stables John Straker's overcoat was flapping from a furze-bush.	厩舎から四分の一哩ばかりのところのはりえにしだの藪にストレーカの外套が引っかかっていた。
Immediately beyond there was a bowl-shaped depression in the moor, and at the bottom of this was found the dead body of the unfortunate trainer.	そしてすぐその先に鉢形の凹（くぼ）みがあって、その底に不幸な調馬師の死体が発見された。
His head had been shattered by a savage blow from some heavy weapon,	何か重い兇器でやられたらしく、頭蓋骨は粉砕され、腿にも傷があった。
and he was wounded on the thigh, where there was a long, clean cut, inflicted evidently by some very sharp instrument.	腿の傷は極めて鋭い兇器でやられたらしく、長く鮮かに切られていた。
It was clear, however, that Straker had defended himself vigorously against his assailants, for in his right hand he held a small knife, which was clotted with blood up to the handle, while in his left he clasped a red and black silk cravat,	ストレーカ自身もよほど烈しく抵抗したものと見え、右の手には柄元までべっとり血のついた小さなナイフをしっかりと握り、左の手には赤と黒との絹の襟飾（ネクタイ）を掴んでいた。
which was recognized by the maid as having been worn on the preceding evening by the stranger who had visited the stables.	この襟飾（ネクタイ）は、前夜厩舎へ来た見知らぬ男のつけていたものに間違いないと女中が申し立てた。
Hunter, on recovering from his stupor, was also quite positive as to the ownership of the cravat.	昏睡からさめたハンタも、この襟飾（ネクタイ）の持主に関しては同様のことを証言した。
He was equally certain that the same stranger had, while standing at the window, drugged his curried mutton, and so deprived the stables of their watchman.	そして自分がこんなに眠ったのも、あの男が窓の外に立ってる時、羊のカレー料理に薬を混ぜたのに相違ないと力んだ。
As to the missing horse, there were abundant proofs in the mud which lay at the bottom of the fatal hollow that he had been there at the time of the struggle.	失踪した名馬に関しては、ストレーカの格闘中その辺にいたものと見え、死の凹みの附近に無数の足跡があったが、
But from that morning he has disappeared, and although a large reward has been offered, and all the gypsies of Dartmoor are on the alert, no news has come of him.	それ以来全く行方不明で、莫大な賞金もかけられたことだし、ダートムアのジプシーどもがしきりに目を配ってもいるのだが、全然知れない、
Finally, an analysis has shown that the remains of his supper left by the stable-lad contained an appreciable quantity of powdered opium,	最後に、ハンタの食べ残した夕食を分析してみると、その中には阿片末がかなり多量に混入していることが分った。
while the people at the house partook of the same dish on the same night without any ill effect.	しかも、同夜同じものを食べた他の人々には少しも別条がなかった。
``Those are the main facts of the case, stripped of all surmise, and stated as baldly as possible.	以上がすべての臆説を排除し、出来るだけ粉飾を加えないで述べた事件の骨子だ。
I shall now recapitulate what the police have done in the matter.	今度は警察がこの事件をどう取扱ってるか、その要点だけをいってみよう。
``Inspector Gregory, to whom the case has been committed, is an extremely competent officer.	この事件を担当させられたグレゴリ警部は、極めて敏腕な人物だ。
Were he but gifted with imagination he might rise to great heights in his profession.	もう少し想像力さえあったら、この方面で非常に出世し得る人だと思う。
On his arrival he promptly found and arrested the man upon whom suspicion naturally rested.	警部は現場へ出張すると、すぐ当然嫌疑のかかってある男を発見して引捕まえた。
There was little difficulty in finding him, for he inhabited one of those villas which I have mentioned.	その男は附近では広く知られていたから、探し出すのは何んの困難もなかった。
His name, it appears, was Fitzroy Simpson.	フィッロイ・シムソンという名前だ。
He was a man of excellent birth and education, who had squandered a fortune upon the turf, and who lived now by doing a little quiet and genteel book-making in the sporting clubs of London.	立派な生れで立派な教育のある男なんだが、競馬ですっかり失敗して、今ではロンドンのスポート倶楽部で、内々小さな賭事の胴元をやって暮してるということだ。
An examination of his betting-book shows that bets to the amount of five thousand pounds had been registered by him against the favourite.	持っていた賭帳を調べてみると、白銀の競走馬に五千ポンドも自分で賭けていたという。
On being arrested he volunteered the statement that he had come down to Dartmoor in the hope of getting some information about the King's Pyland horses, and also about Desborough, the second favourite, which was in charge of Silas Brown at the Mapleton stables.	捕われた時彼は、実はキングス・パイランドの白銀と栗毛や、ケープルトンの厩舎でサイラス・ブラウンが管理している第二の人気者デスボロについて何か予想材料を得たいと思ってわざわざダートムアまで出かけて来たんだと、自分から進んで述べた。
He did not attempt to deny that he had acted as described upon the evening before, but declared that he had no sinister designs and had simply wished to obtain first-hand information.	そして前夜、前にいったような行動をとったことも否定はしなかったが、それについては他意あったわけではなく、ただ確実な材料を掴みたかったからそうしたまでだといい切った。
When confronted with his cravat he turned very pale and was utterly unable to account for its presence in the hand of the murdered man.	そこでストレーカの掴んでいた襟飾（ネクタイ）を見せると、さっと顔色を変えたが、なぜそれが被害者の手にあったかということは、一言もいい開きはし得なかった、
His wet clothing showed that he had been out in the storm of the night before, and his stick, which was a penang-lawyer weighted with lead, was just such a weapon as might, by repeated blows, have inflicted the terrible injuries to which the trainer had succumbed.	服のぬれていることは、前夜あらしに屋外にいたことを語っているし、ステッキはピナン島産の棕梠（しゅろ）製で、鉛を入れて重みがつけてあって、何度も乱打すればストレーカの受けてるような傷を与えるに十分な兇器となり得るものだった。
On the other hand, there was no wound upon his person, while the state of Straker's knife would show that one at least of his assailants must bear his mark upon him.	「しかるに、ストレーカのナイフにあのように血のついてるところを見れば、加害者は一人ではなかったにしても、少くともその中の誰かは切られていなければならないはずだのに、シムソンの身体には少しも傷がない。
There you have it all in a nutshell, Watson, and if you can give me any light I shall be infinitely obliged to you.''	これで話の概略は終ったわけだが、何か君の気付いた点をいってもらえれば大変有難いのだが―」
I had listened with the greatest interest to the statement which Holmes, with characteristic clearness, had laid before me.	ホームズが独特の明快さで語る一語一語を、私は異常な熱心さで傾聴した。
Though most of the facts were familiar to me, I had not sufficiently appreciated their relative importance, nor their connection to each other.	その事実の大部分は既に私の承知していることであったが、どれが重大であるのか、またどれがどこへ関係を持つのかよくは分らなかった。
``Is it not possible,''	「ストレーカの傷は、頭をやられて痙攣的に藻掻いている中（うち）に、自分のナイフでやったんじゃないだろうか？」
I suggested,	私は一説をいってみた。
``It is more than possible;	「有り得ないことではないね。
it is probable,''	あるいはそんなことかもしれぬ。
``In that case one of the main points in favour of the accused disappears.''	そうだとすれば、シムソンに有利な材料が一つだけなくなるわけだ」
``And yet,'' said I, ``even now I fail to understand what the theory of the police can be.''	「それにしても、警察ではどんな見込を立てているか、今からだけれどどうも分りかねるね」
``I am afraid that whatever theory we state has very grave objections to it,''	「警察の見込なんかどうせ我々の考えることとは大（おおい）に違うにきまってるんだよ。
returned my companion.	それはおそらくこうだと思う。
``The police imagine, I take it, that this Fitzroy Simpson, having drugged the lad, and having in some way obtained a duplicate key, opened the stable door and took out the horse, with the intention, apparently, of kidnapping him altogether.	フィッロイ・シムソンは厩番を薬で眠らせ、どうかして合鍵を手に入れて、誘拐し去る目的で馬をつれ出した。
His bridle is missing, so that Simpson must have put this on.	手綱の見えなくなっているのは、シムソンが使ったからだ。
Then, having left the door open behind him, he was leading the horse away over the moor when he was either met or overtaken by the trainer.	厩舎の戸を開け放しにしたままシムソンは荒地（あれち）の方へ馬をつれ出していったが、その途中で調馬師に出会ったか、または追いつかれた。
A row naturally ensued.	そこですぐ争いになり、
Simpson beat out the trainer's brains with his heavy stick without receiving any injury from the small knife which Straker used in self-defence,	シムソンは太いステッキでストレーカの頭を叩き潰したが、小さなナイフを持って立向って来たストレーカからは、擦傷一つ受けなかった。
and then the thief either led the horse on to some secret hiding-place, or else it may have bolted during the struggle, and be now wandering out on the moors.	馬はシムソンが首尾よく秘密の隠し場所へかくしてしまったか、さもなくば二人の男の闘争中勝手に逸走したまま、いまなお荒地のどこかをうろついてるのかもしれない
That is the case as it appears to the police,	――警察の考え方はおそらくこんなことだろう。
and improbable as it is, all other explanations are more improbable still.	これでは一向得心のゆく解釈とはいえないが、といって外の解釈はこれよりまだまだ信じられない。
However, I shall very quickly test the matter when I am once upon the spot, and until then I cannot really see how we can get much further than our present position.''	とにかく、現場へ着いたらすぐに調べてみることにしようが、それまでのところはまずこれ以上どう考えてみようもない」
It was evening before we reached the little town of Tavistock,	タヴィストックの小さな市（まち）へ着いたのはもう夕方であった。
which lies, like the boss of a shield, in the middle of the huge circle of Dartmoor.	タヴィストックはまるで楯の中央の突起のように、ダートムアの荒漠たる土地の中央にぽつんと存在する小さな市（まち）である。
Two gentlemen were awaiting us in the station	着いてみると、二人の紳士が停車場まで迎えに来ていた。
-- the one a tall, fair man with lion-like hair and beard and curiously penetrating light blue eyes;	一人は背の高い色の白い人で、獅子のような頭髪と顎髭とを持ち、明るい青色の眼には妙に射るような光があった。
the other a small, alert person, very neat and dapper, in a frock-coat and gaiters, with trim little side-whiskers and an eyeglass.	もう一人は小柄できびきびした人で、フロックにゲートルというきちんとした身装（みなり）で、短く刈込んだ頬髯を持ち眼鏡をかけていた。
The latter was Colonel Ross, the well-known sportsman; the other, Inspector Gregory; a man who was rapidly making his name in the English detective service.	前者は、近頃英国探偵界にメキメキ男をあげて来たグレゴリ警部、後者は運動家として有名なロス大佐である。
``I am delighted that you have come down, Mr. Holmes,''	「ホームズさん、あなたの御出張を得ましたことは欣快の至りです」
said the colonel.	大佐が挨拶をした。
``The inspector here has done all that could possibly be suggested, but I wish to leave no stone unturned in trying to avenge poor Straker and in recovering my horse.''	「ここにおいでの警部殿も出来るだけの手をつくして下すっていますが、気の毒なストレーカの復讐のため、かつは馬を取戻すためには草の根を分け石を起し、あらゆることをやってみたいと思って、それであなたの御出張をお願いいたした次第です」
``Have there been any fresh developments?''	「その後何か新発見でもおありでしたか？」
asked Holmes.	ホームズが訊ねた。
``I am sorry to say that we have made very little progress,''	「残念ながらほとんど進展してはいません」
said the inspector.	警部が引取って答えた。
``We have an open carriage outside, and as you would no doubt like to see the place before the light fails, we might talk it over as we drive.''	「出口に無蓋馬車の用意をして来ましたから、暗くならない中（うち）に、何より先きに現場をごらんになりたいでしょうから、委しいことは馬車の中で申し上げることにしましょう」
A minute later we were all seated in a comfortable landau and were rattling through the quaint old Devonshire city.	一分間の後、私たちは乗心地のよい回転馬車（ランドウ）に座を占めて、見馴れぬ古風なデヴォンシャの市を駆（かけ）らせていた。
Inspector Gregory was full of his case and poured out a stream of remarks,	グレゴリ警部は今度の事件で胸一杯だったと見え、話は後から後へと迸り出た。
while Holmes threw in an occasional question or interjection.	それに対してホームズは時々質問や間投詞を挟んだ。
Colonel Ross leaned back with his arms folded and his hat tilted over his eyes,	ロス大佐は腕を拱（こまね）いて反身（そりみ）に座席に身をもたせて、帽子を眼のあたりまですべらせ黙々として耳を傾けていた。
while I listened with interest to the dialogue of the two detectives.	私は二人の探偵の対話をいと興味深く聴いていた。
Gregory was formulating his theory, which was almost exactly what Holmes had foretold in the train.	グレゴリは自分の意見をも述べていたが、それは来がけの汽車の中でいったホームズの言葉とほとんど変らなかった。
``The net is drawn pretty close round Fitzroy Simpson,''	「フィツロイ・シムソンはそういうわけで、四囲の状況が非常に不利なわけです。
``and I believe myself that he is our man.	私一個としても彼が犯人であることを信じています。
At the same time I recognize that the evidence is purely circumstantial, and that some new development may upset it.''	同時に、その証拠が全く情況証拠ばかりですから、何か新事実が現われればいつでもこの嫌疑は覆えされるものであるということも認めなければなりませんが」
``How about Straker's knife?''	「ストレーカのナイフについてのお考えは？」
``We have quite come to the conclusion that he wounded himself in his fall.''	「あれはストレーカが倒れる時、自分で自分を傷つけたための血痕だと決定しました。」
``My friend Dr. Watson made that suggestion to me as we came down.	「ワトソン君も来る途中で、そうじゃないかしらといっていましたが、
If so, it would tell against this man Simpson.''	それが事実だとすると、シムソンにとっては不利な材料になるわけですね」
``Undoubtedly.	「その通りです。
He has neither a knife nor any sign of a wound.	シムソンはナイフも持っていなければ、身体に傷一つなかったです。
The evidence against him is certainly very strong.	彼に対しては極めて有力な不利な証拠があります。
He had a great interest in the disappearance of the favourite.	第一に白銀の消失は彼に莫大な利益をもたらします。
He lies under suspicion of having poisoned the stable-boy;	彼には厩番のハンタに薬を盛った嫌疑があります。
he was undoubtedly out in the storm;	同夜雨が降り出してから屋外にいたことも争われぬ事実です。
he was armed with a heavy stick,	兇器としては太いステッキを持っていました。
and his cravat was found in the dead man's hand.	そして最後に、死人が彼の襟飾（ネクタイ）を掴んでいました。
I really think we have enough to go before a jury.''	これだけ材料があれば、十分陪審員たちを承伏させることが出来るに違いありません」
Holmes shook his head.	ホームズは首を傾げて、
``A clever counsel would tear it all to rags,''	「上手な弁護士にかかったらそれくらいのことは難なく論破されてしまうでしょうね。
``Why should he take the horse out of the stable?	シムソンはなぜ白銀を厩舎の外へつれ出さなければならなかったんですか？
If he wished to injure it, why could he not do it there?	傷つけて競馬に出られなくしたければ厩舎の中でも出来ることじゃないですか？
Has a duplicate key been found in his possession?	捕えられた時、厩舎の合鍵を持っていましたか？
What chemist sold him the powdered opium?	阿片末を売り渡したのはどこの薬種商です？
Above all, where could he, a stranger to the district, hide a horse, and such a horse as this?	とりわけ土地不案内なシムソンが、馬のような大きなものを、しかもこうした有名な馬をどこへかくせるというんです？
What is his own explanation as to the paper which he wished the maid to give to the stable-boy?''	シムソンは女中に頼んで厩舎に届けさせようとした紙片（かみきれ）を何んだといってるんですか？」
``He says that it was a ten-pound note.	「十ポンドの紙幣だったといっています。
One was found in his purse.	そういえばポケットの中へ十ポンドの紙幣を一枚持っていました。
But your other difficulties are not so formidable as they seem.	しかし、あなたの仰しゃった反駁はそう有力なものとも思われませんね。
He is not a stranger to the district.	シムソンは土地不案内の者じゃないです。
He has twice lodged at Tavistock in the summer.	夏時分二度、タヴィストックに泊っていたことがあります。
The opium was probably brought from London.	阿片はおそらくロンドンから持って来たものでしょう。
The key, having served its purpose, would be hurled away.	合鍵は目的を達した上は、どこへかすててしまったものと考えられます。
The horse may be at the bottom of one of the pits or old mines upon the moor.''	馬はどこか荒地（あれち）の中の凹みか、廃坑の中に殺されているかもしれません」
``What does he say about the cravat?''	「襟飾（ネクタイ）のことはどう弁明していますか？」
``He acknowledges that it is his and declares that he had lost it.	「自分のものには相違ないけれど、遺失したのだといっています。
But a new element has been introduced into the case which may account for his leading the horse from the stable.''	しかし、シムソンが馬をつれ出したのだという新らしい事実が一つ発見されています」
Holmes pricked up his ears.	ホームズは急に聞耳を立てた。
``We have found traces which show that a party of gypsies encamped on Monday night within a mile of the spot where the murder took place.	「［＃「「」は底本では一文後にある］兇行のあった月曜の夜。
On Tuesday they were gone.	火曜日に出発してしまったのです。
Now, presuming that there was some understanding between Simpson and these gypsies, might he not have been leading the horse to them when he was overtaken, and may they not have him now?''	そこで、ジプシーとシムソンとの間にある了解があったものとすると、シムソンはジプシーのいるところまで馬をつれて行く途中をストレーカに追いつかれた、で、馬はいまジプシー達の手にあるのだと考えられなくもありますまい？」
``It is certainly possible.''	「たしかに有り得ないことではありませんね」
``The moor is being scoured for these gypsies.	「いまこのジプシーの行方を尋ねて荒地を捜索中です。
I have also examined every stable and outhouse in Tavistock, and for a radius of ten miles.''	同時にタヴィストックを中心に、十哩の円を描いてその中にある厩という厩、小舎という小舎をことごとく調べました」
``There is another training-stable quite close, I understand?''	「すぐ附近にも一つ調馬場があるということでしたね？」
``Yes,	「あります。
and that is a factor which we must certainly not neglect.	その調馬場も見逃してはならないものの一つです。
As Desborough, their horse, was second in the betting, they had an interest in the disappearance of the favourite.	そこにいるデスボロという馬は第二の人気馬なんですから、白銀が失踪すれば非常な利益を得るわけです。
Silas Brown, the trainer, is known to have had large bets upon the event, and he was no friend to poor Straker.	そこの調馬師のサイラス・ブラウンという男は自分の方の馬に大金を賭けているということですが、死んだストレーカとも仲がよくなかったともいいます。
We have, however, examined the stables, and there is nothing to connect him with the affair.''	で、一応その厩舎をも調べてはみましたが、この事件に関係のありそうなものは何一つ見付かりませんでした。」
``And nothing to connect this man Simpson with the interests of the Mapleton stables?''	「そのケープルトンの調馬師の利害とシムソンと何か関係はないんですか？」
``Nothing at all.''	「全然ありません」
Holmes leaned back in the carriage,	ホームズは後方へ寄りかかった。
and the conversation ceased.	そして話はそれ切りきれてしまった。
A few minutes later our driver pulled up at a neat little red-brick villa with overhanging eaves which stood by the road.	その間も馬車はとめどなく駈けていたが、まもなく道路に面して立っている軒の長くつき出た小じんまりとした赤煉瓦の別荘風の家の前へ停められた。
Some distance off, across a paddock, lay a long gray-tiled outbuilding.	少し離れて調馬場があり、その向うには灰色の屋根を持った建物――厩舎が見えていた。
In every other direction the low curves of the moor, bronze-coloured from the fading ferns, stretched away to the sky-line, broken only by the steeples of Tavistock, and by a cluster of houses away to the westward which marked the Mapleton stables.	どっちを見ても枯れ羊歯で、ブロンズに色づけられた荒地（こうち）がゆるやかな起伏をなして地平線の果てまでつづき、眼を遮ぎるものとてはただタヴィストックの教会の尖塔と、ケープルトンの調馬場だけだという家々が遥か西の方に群がっているのみである。
We all sprang out with the exception of Holmes, who continued to lean back with his eyes fixed upon the sky in front of him, entirely absorbed in his own thoughts.	私達は馬車から飛び降りたが、ホームズだけは依然として前方の空を見つめたまま降りようともせず、座席に身を埋（うず）めてじっと深く瞑想に耽っていた。
It was only when I touched his arm that he roused himself with a violent start and stepped out of the carriage.	私が腕をゆすぶって注意すると、やっと気がついて慌てて飛び降りて、
``Excuse me,''	「御免下さい」
said he, turning to Colonel Ross, who had looked at him in some surprise.	と、呆気にとられて顔を見つめていたロス大佐に向って、
``I was day-dreaming.''	「白昼夢を見ていたもんですからつい」
There was a gleam in his eyes and a suppressed excitement in his manner which convinced me, used as I was to his ways,	彼の性癖をよく知っている私には、それを見て、たしかにある手懸りを得たのだということが分った。
that his hand was upon a clue, though I could not imagine where he had found it.	ただし、その手懸りが果して何んであるかはさっぱり見当はつかなかったけれど。
``Perhaps you would prefer at once to go on to the scene of the crime, Mr. Holmes?''	「ホームズさん、すぐに兇行の現場へいらっしゃるんでしょうね？」
said Gregory.	グレゴリ警部が訊ねた。
``I think that I should prefer to stay here a little and go into one or two questions of detail.	「いや、それよりもしばらくここにいて二三の細目について訊ねたいと思います。
Straker was brought back here, I presume?''	ストレーカの死体はいったんここへつれて帰ったんでしょうね？」
``Yes,	「そうです。
he lies upstairs.	まだ二階に置いてあります。
The inquest is to-morrow.''	検死は明白ですから」
``He has been in your service some years, Colonel Ross?''	「ストレーカは永年あなたのところに働いていたんですか、ロスさん？」
``I have always found him an excellent servant.''	「はい、いつもよく働いてくれました」
``I presume that you made an inventory of what he had in his pockets at the time of his death, Inspector?''	「警部さん、ストレーカの死体のポケットに何が入っていたか、お調べだったでしょうね？」
``I have the things themselves in the sitting-room if you would care to see them.''	「ごらんになるなら居間の方に全部まとめてありますから」
``I should be very glad.''	「ぜひ見せていただきたいものです」［＃空白は底本では「「」］
We all filed into the front room and sat round the central table	私達一同は表の間へ通って、中央のテーブルを囲んでそれぞれ席についた。
while the inspector unlocked a square tin box and laid a small heap of things before us.	すると、グレゴリ警部は四角い小さなブリキの函（はこ）を取出し、鍵で蓋をとっていろいろな品物を私達の前へ並べてみせた。
There was a box of vestas, two inches of tallow candle, an A D P brier-root pipe, a pouch of sealskin with half an ounce of long-cut Cavendish, a silver watch with a gold chain, five sovereigns in gold, an aluminum pencil-case, a few papers, and an ivory-handled knife with a very delicate, inflexible blade marked Weiss & Co., London.	蝋マッチが一箱、二吋（インチ）ほどの獣脂蝋燭が一つ、Ａ・Ｄ・印のブライヤのパイプに長刻みのカヴェンデッシュ煙草を半オンスばかりつめた海豹（いるか）皮の煙草入れ、金鎖のついた銀時計、金貨で五ソヴリン、アルミニュウムの鉛筆さし、書附二三通、『ロンドン、ワイス会社製』と刻印された非常に細く鋭い、それでいて曲りにくい刄を持った象牙柄のナイフが一つ。［＃「。」は底本では「」」］
``This is a very singular knife,''	「これは非常に変ったナイフだ」
said Holmes, lifting it up and examining it minutely.	ホームズはナイフをとり上げて、うら返してじっと見ながらいった。
``I presume, as I see blood-stains upon it, that it is the one which was found in the dead man's grasp.	「血がついているようですが、ストレーカが握っていたというのはこれなんですか？
Watson, this knife is surely in your line?''	ワトソン君、このナイフはむしろ君の領分らしいね」
``It is what we call a cataract knife,''	「これは医者の方で白内障（そこひ）メスという奴だ」
``I thought so.	「そうだと思った。
A very delicate blade devised for very delicate work.	極めて緻密な仕事をするために、極めて尖鋭に作られているんだ。
A strange thing for a man to carry with him upon a rough expedition,	荒っぽい仕事をしに出て行った男が、こんなものを持っていたというのは不思議ですね。
especially as it would not shut in his pocket.''	殊にポケットにかくすわけにもゆかないこんなものを」
``The tip was guarded by a disc of cork which we found beside his body,''	「現に死体の傍に落ちていましたが、刄の先はコルクを当ててあったんです」
said the inspector.	警部がいった。
``His wife tells us that the knife had lain upon the dressing-table, and that he had picked it up as he left the room.	「妻君の話では、このナイフは前から化粧台の上に置いてあったのを、出がけにストレーカが握って行ったんだということです。
It was a poor weapon, but perhaps the best that he could lay his hands on at the moment.''	護身用としても、攻撃用としても貧弱なことは貧弱ですが、その時手近にあったもののうちでは、これが一番よかったんでしょう」
``Very possibly.	「そんなことでしょうね。
How about these papers?''	この書附はどうですか？」
``Three of them are receipted hay-dealers' accounts.	「その中（うち）三枚は乾草商人の清算書で、受取済になっています。
One of them is a letter of instructions from Colonel Ross.	一つはロス大佐からの命令の手紙で、
This other is a milliner's account for thirty-seven pounds fifteen made out by Madame Lesurier, of Bond Street, to William Derbyshire.	もう一枚残っているのはロンドンのボンド街のマダム・ルスリエという帽飾店から、ウィリアム・ダービシャ宛に出した、合計三十七ポンド十五シルの勘定書です。
Mrs. Straker tells us that Derbyshire was a friend of her husband's and that occasionally his letters were addressed here.''	ストレーカの妻君の話によれば、ダーヴィシャというのは夫の友達で、ここへもちょいちょいダーヴィシャ宛に手紙が来たということです」
``Madame Derbyshire had somewhat expensive tastes,''	「ダーヴィシャ夫人の帽子だとすると、夫人はなかなか贅沢家だな」
remarked Holmes, glancing down the account.	と、ホームズは勘定書を眺めながらいった。
``Twenty-two guineas is rather heavy for a single costume.	「一枚の着物に二十二ギンもかけるとは、ちと奢りすぎる。
However, there appears to be nothing more to learn, and we may now go down to the scene of the crime.''	しかし、これでここはもう済んだようですから、今度は兇行の現場を見せてもらいましょうか」
As we emerged from the sitting-room a woman, who had been waiting in the passage, took a step forward and laid her hand upon the inspector's sleeve.	居間からどやどやと出て行くと、廊下に一人の婦人が待ち構えていたのがつかつかと進んで来てグレゴリ警部の腕に手をかけた。
Her face was haggard and thin and eager, stamped with the print of a recent horror.	憔悴し切った顔に焦慮しているらしい胸の中（うち）をそのまま現わして、まだおどおどと恐ろしそうにしている。
``Have you got them?	「あの、捕まったんですか？」
``No, Mrs. Straker.	「いや、まだですよ奥さん。
But Mr. Holmes here has come from London to help us, and we shall do all that is possible.''	しかし、このホームズさんがロンドンからわざわざ加勢に来て下さいましたから、一同で出来るだけはやってみるつもりです」
``Surely I met you in Plymouth at a garden-party some little time ago, Mrs. Straker?''	「ああ、あなたにはいつぞやプリマスで園遊会の時お目にかかりましたね、ストレーカさん」
said Holmes.	と、ホームズはいった。
``No, sir;	「さあ、いいえ、
you are mistaken.''	それは何かのお間違いでございましょう」
``Dear me!	「おや、
Why, I could have sworn to it.	そうですかいやいやたしかにお目にかかりましたよ。
You wore a costume of dove-coloured silk with ostrich-feather trimming.''	あの時あなたは鳩色絹の服に駝鳥の羽根の飾りをつけて、来ていらしったじゃありませんか」
``I never had such a dress, sir,''	「いいえ、私はそんな服はもってはおりません」
``Ah, that quite settles it,''	「ああ、それでは間違いでした」
And with an apology he followed the inspector outside.	ホームズはちょっと失礼を詑びて、警部を追って外へ出た。
A short walk across the moor took us to the hollow in which the body had been found.	荒地（あれち）を通って少しばかり行くと、死体のあったという凹みへ出た。
At the brink of it was the furze-bush upon	凹みの縁（へり）にははりえにしだの藪が繁っていた。
which the coat had been hung.	そこへストレーカの外套はかかっていたのである。
``There was no wind that night, I understand,''	「その晩は風はありませんでしたね？」
said Holmes.	ホームズは訊ねた。
``None, but very heavy rain.''	「風はちっともありませんでしたが、雨はどしゃ降りでした」
``In that case the overcoat was not blown against the furze-bush, but placed there.''	「そうすると、外套は風に吹き上げられたんじゃなくて、誰かがそこへおいたんだということになりますね」
``Yes,	「そうです。
it was laid across the bush.''	灌木の上へちゃんとのせておいたものです」
``You fill me with interest.	「ふむ、面白いですね。
I perceive that the ground has been trampled up a good deal.	地面はひどく踏みにじられているようですが、
No doubt many feet have been here since Monday night.''	兇行以来いろんな人が歩き廻ったんでしょうね？」
``A piece of matting has been laid here at the side, and we have all stood upon that.''	「いいえ、ここんところへ莚（むしろ）を敷いて、みんなその上にいることにしました」
``Excellent.''	「そいつはよかったです」
``In this bag I have one of the boots which Straker wore, one of Fitzroy Simpson's shoes, and a cast horseshoe of Silver Blaze.''	「この鞄の中にストレーカの穿いていた靴を片っ方と、フィツロイ・シムソンのを一つと、それから白銀の蹄鉄の型を一つ持って来ました」
``My dear Inspector, you surpass yourself!''	「ほう！
Holmes took the bag, and, descending into the hollow, he pushed the matting into a more central position.	ホームズは鞄を受取って凹みの底へ降りて行き、莚を真中の方へやってその上に腹這いになり、
Then stretching himself upon his face and leaning his chin upon his hands, he made a careful study of the trampled mud in front of him.	両手に顎をのせて眼の前の踏みにじられた泥を注意深く研究していたが、
``Hullo!''	突然、
said he suddenly.	「や、や、これは何んだ？」
``What's this?''	と叫んだ。
It was a wax vesta, half burned, which was so coated with mud that it looked at first like a little chip of wood.	ホームズの発見したものは泥がついて、ちょっと見ると小さな木の枝か何かのように見えたが、蝋マッチの半分ばかり燃え残ったものであった。
``I cannot think how I came to overlook it,''	「はて、どうして私はそんなものを見落しましたかな」
said the inspector with an expression of annoyance.	と、警部は少し苦い顔をした。
``It was invisible, buried in the mud.	「泥に埋（うず）もれていたから分らなかったんですよ、
I only saw it because I was looking for it.''	私はこいつを探すつもりでいたから見つかったんです」
``What!	「えッ！
you expected to find it?''	初めからあるものと思って探しにかかったんですか？」
``I thought it not unlikely.''	「あってもいいはずだと思ったんです」
He took the boots from the bag and compared the impressions of each of them with marks upon the ground.	ホームズは鞄から靴を出して、それを泥の上の型に一つ一つ合せてみた。
Then he clambered up to the rim of the hollow and crawled about among the ferns and bushes.	それから凹みの縁（ふち）へ上って来て、羊歯や灌木の間をうろうろと這い廻った。
``I am afraid that there are no more tracks,''	「もう何んにもありゃしますまいよ」
said the inspector.	警部はその後姿を眼で追いながらいった。
``I have examined the ground very carefully for a hundred yards in each direction.''	「百ヤード四方は私が念入りに調べてみたんですからな」
``Indeed!''	「ですがね」
said Holmes, rising.	ホームズは起き上って、
``I should not have the impertinence to do it again after what you say.	「あなたがそうまで仰しゃるのを探し廻るのは失礼ですから止めましょう。
But I should like to take a little walk over the moor before it grows dark	その代り日が暮れるまでこの荒地（あれち）を少し散歩してみたいと思います。
that I may know my ground to-morrow,	そうすれば明日の調べには地理が分って好都合ですから。
and I think that I shall put this horseshoe into my pocket for luck.''	それからこの蹄鉄は幸運のお呪（まじな）いにポケットへ入れて行きましょう」
Colonel Ross, who had shown some signs of impatience at my companion's quiet and systematic method of work, glanced at his watch.	ロス大佐はさっきから、ホームズの組織的な調べ方にあきあきしていたらしく、この時時計を出してみていった。
``I wish you would come back with me, Inspector,''	「警部さんは私と一緒にお帰りを願いたいですな。
``There are several points on which I should like your advice,	あなたに御相談願いたいことがいろいろありますから。
and especially as to whether we do not owe it to the public to remove our horse's name from the entries for the cup.''	そして白銀の名を今度の競馬から取除いてもらうことが、公衆に対する義務ではないかと思うもんですからな」
``Certainly not,''	「その必要は絶対にありません」
cried Holmes with decision.	ホームズが傍からはっきりといい切った。
``I should let the name stand.''	「名前をそのままにしておくだけのことは必ず私がして上げます」
The colonel bowed.	大佐は一礼して、
``I am very glad to have had your opinion, sir,''	「そのお言葉を承わるのは非常に欣快です。
``You will find us at poor Straker's house when you have finished your walk,	私達はストレーカの家でお待ちしますから、散歩がおすみでしたらお帰り下さい。
and we can drive together into Tavistock.''	御一緒にタヴィストックへ馬車で帰りましょう」
He turned back with the inspector, while Holmes and I walked slowly across the moor.	大佐はグレゴリ警部と共に去り、ホームズと私とは荒地（あれち）の中を静かに歩いていた。
The sun was beginning to sink behind the stable of Mapleton, and the long sloping plain in front of us was tinged with gold, deepening into rich, ruddy browns where the faded ferns and brambles caught the evening light.	太陽はケープルトン調馬場の彼方に沈みかけて、眼前のゆるやかな傾斜を持つ平原は金色（きんしょく）に染まり、枯れ羊歯や茨のある部分は濃いばら色がかった褐色に燃えた。
But the glories of the landscape were all wasted upon my companion, who was sunk in the deepest thought.	が、深い思索に耽っているホームズにとっては、それ等の光景は何んでもなかった。
``It's this way, Watson,''	「我々のとるべき道はだね、ワトソン君」
said he at last.	しばらくして彼はいい出した。
``We may leave the question of who killed John Straker for the instant and confine ourselves to finding out what has become of the horse.	「ジョン・ストレーカは誰が殺したかの問題はしばらく措いて、馬はどうなったかを専ら考えてみよう。
Now, supposing that he broke away during or after the tragedy, where could he have gone to?	いま、馬は、ストレーカが殺されているうちまたは殺された後で逸走したものとすると、一体どこに逃げるだろう？
The horse is a very gregarious creature.	馬というものは非常に群集性の強い動物だ、
If left to himself his instincts would have been either to return to King's Pyland or go over to Mapleton.	だから、もし自由に放り出しておいたら本能的にキングス・パイランドへ帰るか、ケープルトンへ行くかするに違いない。
Why should he run wild upon the moor?	どうしてこの荒地（あれち）をうろついているものか！
He would surely have been seen by now.	それだったら今までにちゃんと発見されているに決まっている。
And why should gypsies kidnap him?	また、ジプシーがどうして馬を誘拐するものか、［＃「、」は底本では欠落］
These people always clear out when they hear of trouble, for they do not wish to be pestered by the police.	ジプシーというものは警察にいじめられるのを厭うから、何か事が起ったときけばすぐにその場所を引き払うものだ。
They could not hope to sell such a horse.	あんな名馬は売ろうたって売れもしない。
They would run a great risk and gain nothing by taking him.	だから馬をつれて逃げるなんてことは、非常な危険があるばかりで、何等利益がない。
Surely that is clear.''	これは間違いのないところだ」
``Where is he, then?''	「じゃ一体どこにいるんだろう？」
``I have already said that he must have gone to King's Pyland or to Mapleton.	「いまいった通り、キングス・パイランドへ帰ったか、ケープルトンへ行ったに違いない。
He is not at King's Pyland.	しかるにキングス・パイランドへは帰っていないんだから
Therefore he is at Mapleton.	ケープルトンへ行ったものに違いない。
Let us take that as a working hypothesis and see what it leads us to.	これを差当り実行的仮定として、それがどういうことになるか、研究してみよう。
This part of the moor, as the inspector remarked, is very hard and dry.	荒地（あれち）のうちでもこの辺は警部もいってるように極めて土地が固くて乾燥しているけれども、
But it falls away towards Mapleton, and you can see from here that there is a long hollow over yonder,	ケープルトンの方へ行くに従って低くなっていて、見たまえ、あそこに細長く凹（くぼ）んだところがある。
which must have been very wet on Monday night.	あの辺は兇行のあった月曜日の晩には、非常にぐしょぐしょだったに違いない。
If our supposition is correct, then the horse must have crossed that, and there is the point where we should look for his tracks.''	もし我々の想像が当ってるなら、馬はあそこを通っているはずだから、あそここそ足跡が残っている場所でなければならない。」
We had been walking briskly during this conversation, and a few more minutes brought us to the hollow in question.	ホームズがこう話す間、私達はすたすたとその方へ歩いて行ったが、二三分で問題の凹みのところまで来た。
At Holmes's request I walked down the bank to the right, and he to the left,	ホームズの要求によって私はその凹みの縁（ふち）を右の方へ辿って行き、ホームズ自身は左の方へ行った。
but I had not taken fifty paces before I heard him give a shout and saw him waving his hand to me.	が、五十歩と歩かぬうちにホームズが急に声を挙げたので振り返ってみると、来い来いをやってるので、
The track of a horse was plainly outlined in the soft earth in front of him,	行ってみると、そこの軟らかい土の上に馬蹄の跡が判然といくつもついていた。
and the shoe which he took from his pocket exactly fitted the impression.	ホームズがポケットから蹄鉄を出して当てがってみると、それがぴったり符合した。
``See the value of imagination,''	「想像力の有難味が分るだろう？
``It is the one quality which Gregory lacks.	グレゴリにはこの素質だけが欠けているんだ。
We imagined what might have happened, acted upon the supposition, and find ourselves justified.	我々が想像力を働かして事件を仮定し、その仮定に従って取調べの歩を進めた結果、その仮定の正しかったことを確めたんだ。
Let us proceed.''	さ、行ってみよう」
We crossed the marshy bottom and passed over a quarter of a mile of dry, hard turf.	私達はじめじめした凹地を越えて、乾いて固い草土を四分の一哩ばかり歩いて行った。
Again the ground sloped, and again we came on the tracks.	と、再び土地の傾斜しているところがあり、そこにも馬蹄の跡があった。
Then we lost them for half a mile, but only to pick them up once more quite close to Mapleton.	また半哩ばかり何んにもなくて、ケープルトンにかなり近くなってからまたまた発見された。
It was Holmes who saw them first, and he stood pointing with a look of triumph upon his face.	それを最初に発見したのはホームズであったが、彼は得意げにそれを指さして見せた。
A man's track was visible beside the horse's.	馬蹄の跡に並んで、男の靴あとが明らかに認められたのである。
``The horse was alone before,''	「これまでは馬だけだったのに！」
I cried.	私は思わずに走った。
``Quite so.	「その通りさ。
It was alone before.	今までは馬だけだったんだ。
Hullo, what is this?''	や、や、これはどうだ！」
The double track turned sharp off and took the direction of King's Pyland.	人と馬との足跡はそこで急に方向を転じて、キングス・パイランドの方へ向っていたのである。
Holmes whistled, and we both followed along after it.	ホームズは呻吟したが、そのままその足跡を追って新らしい方向へ歩き出した。
His eyes were on the trail, but I happened to look a little to one side and saw to my surprise the same tracks coming back again in the opposite direction.	そして、彼はじっと足跡ばかり見て歩いたが、私はふと横の方に眼をやってみると、驚いたことには、少し離れたところに同じ足跡が、再びケープルトンの方へ向っているのを発見した。
``One for you, Watson,''	私がそれを注意すると、ホームズは、
said Holmes when I pointed it out.	「ワトソン君、お手柄だ！
``You have saved us a long walk, which would have brought us back on our own traces.	おかげでうんと無駄足をふまされるのが助かった。
Let us follow the return track.''	さ、あの足跡を辿って進もう」
We had not to go far.	そこから先きはあまり歩かなくともよかった。
It ended at the paving of asphalt which led up to the gates of the Mapleton stables.	足跡はケープルトン調馬場の厩舎の入口に通ずるアスファルト舗装の道路の前でつきていたのである。
As we approached, a groom ran out from them.	そこまで歩いて行くと、厩舎から一人の馬丁が飛び出して来た。
``We don't want any loiterers about here,''	「ここは用のない者の来るところじゃねえだよ」
``I only wished to ask a question,''	「いや、ちょっとものを伺いたいのだがね」
said Holmes, with his finger and thumb in his waistcoat pocket.	ホームズは二本の指をチョッキのポケットへ入れていった。
``Should I be too early to see your master, Mr. Silas Brown, if I were to call at five o'clock to-morrow morning?''	「明日の朝五時に来たいと思うんだけれど、サイラス・ブラウンさんに会うにはちと早すぎるかね？」
``Bless you, sir,	「ようがしょうとも。
if anyone is about he will be,	来さえすれば会えますだ。
for he is always the first stirring.	旦那はいつでも朝は一番に起きるだから。
But here he is, sir,	だが、そういえば旦那が出て来ましたぜ。
to answer your questions for himself.	お前さまじかにきいてみなさるがいいだ。
No, sir, no, it is as much as my place is worth to let him see me touch your money.	はあれ、とんでもねえ、お前さまからお金貰ったことが分れば、たちまちお払い箱だあ。
if you like.''	――なんなら後でね」
As Sherlock Holmes replaced the half-crown which he had drawn from his pocket, a fierce-looking elderly man strode out from the gate with a hunting-crop swinging in his hand.	シャーロック・ホームズがいったん出した半クラウン銀貨をポケットへ納めると、そこへ怖い顔をした年輩の男が、猟用の鞭を振り振り大跨（おおまた）に門から出て来た。
``What's this, Dawson!''	「どうしたんだ、ドウソン？
``No gossiping!	べちゃべちゃと喋らずと、
Go about your business!	早く仕事を片付けるんだ！
And you,	そして君達は？
what the devil do you want here?''	一体何の用があってこんなところへ来たんですい？」
``Ten minutes' talk with you, my good sir,''	「御主人、ちょっと十分ばかりお話がしたいんですが」
said Holmes in the sweetest of voices.	ホームズはニコニコしていった。
``I've no time to talk to every gadabout.	「用もねえのにうろうろしてるような者の相手になってる暇はおれにゃねえな。
We want no strangers here.	ここは知らねえ者の来るところじゃねえ。
Be off,	さっさと帰った帰った。
or you may find a dog at your heels.''	帰らねえと犬を嗾（け）しかけるぞ」
Holmes leaned forward and whispered something in the trainer's ear.	ホームズは上半身を前へ曲げるようにして、調馬師の耳へ何か囁いた。
He started violently and flushed to the temples.	と、ブラウンはぎくりとして、生際（はえぎわ）まで真赤になった。
``It's a lie!''	「嘘だッ！
``An infernal lie!''	それあとんでもねえ大うそだッ！」
``Very good.	「よろしい！
Shall we argue about it here in public	それじゃここで大きな声でそれを証拠立ててみようか？
or talk it over in your parlour?''	それとも中へ入って客間で静かに話し合いますか？」
``Oh, come in if you wish to.''	「いや、それじゃ中へ入ってもらいましょうか」
Holmes smiled.	ホームズはニヤリとして、
``I shall not keep you more than a few minutes, Watson.''	「ワトソン君、ほんの二三分間で出て来るからね。
Mr. Brown.	ブラウンさん、
I am quite at your disposal.''	お言葉に従って中へ入れてもらいましょうか」
It was twenty minutes,	二三分間といったのが、きっかり二十分はかかった。
and the reds had all faded into grays before Holmes and the trainer reappeared.	ホームズがブラウンとつれ立って出て来た時には、夕映（ゆうばえ）は消え去って、四辺（あたり）は灰色の黄昏が迫りかけていた。
Never have I seen such a change as had been brought about in Silas Brown in that short time.	たった二十分の間に、サイラス・ブラウンの変りようったらなかった。
His face was ashy pale, beads of perspiration shone upon his brow, and his hands shook until the hunting-crop wagged like a branch in the wind.	顔の色といったら灰のように蒼ざめ、額には汗の玉を浮べ、手に持つ猟鞭は嵐の中の小枝のようにゆらいでいた。
His bullying, overbearing manner was all gone too, and he cringed along at my companion's side like a dog with its master.	そして横暴で尊大なさっきの態度はどこへやら、まるで主人に仕える忠実な犬のように、ホームズの側でかしこまっている有様だった。
``Your instructions will be done.	「それではお指図の通りに致します。
It shall all be done,''	必ず致しますから」
``There must be no mistake,''	「必ず間違わないようにしてもらいたい」
said Holmes, looking round at him.	ホームズはブラウンをじろじろ眺めながらいった。
The other winced as he read the menace in his eyes.	ブラウンはホームズの視線に威圧されて、ぱちぱちと瞬きをした。
``Oh, no, there shall be no mistake.	「はいはい、決して間違いは致しません。
It shall be there.	必ず出します。
Should I change it first or not?''	それからあれは初めから変えておきましょうか、それともまた――」
Holmes thought a little and then burst out laughing.	ホームズはちょっと考えていたが、急に噴き出して、
``No, don't,''	「いや、そのままがいい。
``I shall write to you about it.	それについては後で手紙を出そう。
No tricks, now,	もう狡（ず）るいことをするじゃないよ。
or -- ''	さもないと――」
``Oh, you can trust me,	「大丈夫です！
you can trust me!''	どうぞ私を信じて下さい」
``Yes, I think I can.	「よろしい、安心していよう。
Well, you shall hear from me to-morrow.''	では明日手紙を上げるから」
He turned upon his heel, disregarding the trembling hand which the other held out to him, and we set off for King's Pyland.	ホームズはブラウンが震える手をのべて握手を求めたのを構わずに、くるりと向きを代えてそのまま私と一緒にキングス・パイランドの方へ帰って行った。
``A more perfect compound of the bully, coward, and sneak than Master Silas Brown I have seldom met with,''	「サイラス・ブラウンのようなあんな傲慢で臆病で狡猾な三拍子そろった奴を見たことがない」
remarked Holmes as we trudged along together.	ホームズは歩きながらいった。
``He has the horse, then?''	「じゃ、あの馬を持っていたんだね？」
``He tried to bluster out of it, but I described to him so exactly what his actions had been upon that morning	「初めはつべこべと誤魔化そうとしたから、あの晩、いや朝のあいつの行動を正確に話してやったら、図星を指されたと見えて、とうとう兜を脱いだよ。
that he is convinced that I was watching him.	僕が見ていたとでも思い込んだらしく。
Of course you observed the peculiarly square toes in the impressions, and that his own boots exactly corresponded to them.	君はあの足跡が妙に爪先が角ばっていたのも、ブラウンの穿いていた靴がちょうどそれに適合する形だったのも、無論気がついたろう。
Again, of course no subordinate would have dared to do such a thing.	そして部下の使用人にはこんなことが出来るものじゃないことも
I described to him how, when according to his custom he was the first down, he perceived a strange horse wandering over the moor.	――だから、僕は毎朝あいつが一番に起きる習慣であること、あの朝も早く起きてみると、荒地によその馬がうろうろしているので、
How he went out to it, and his astonishment at recognizing, from the white forehead	出て行ってみたところ驚いたことには、それが白銀号だった
which has given the favourite its name, that chance had put in his power the only horse which could beat the one upon which he had put his money.	――白銀というのは額が真白なところから出た名なんだが、自分が大金を賭けてる馬の唯一の強敵が手に入ったんでびっくりしただろうと、そのことについて委しく話してやった。
Then I described how his first impulse had been to lead him back to King's Pyland, and how the devil had shown him how he could hide the horse until the race was over, and how he had led it back and concealed it at Mapleton.	最初は、キングス・パイランドへつれて行こうとしたが、急に魔がさして、競馬のすむまでかくしておいたらという考えを起し、そっとケープルトンへつれ戻ってかくしておいただろうといってやったもんだから、
When I told him every detail he gave it up and thought only of saving his own skin.''	あいつもとうとう降参して、どうかして自分が罰せられないですむ方法はないかと考えるまでになったんだ」
``But his stables had been searched?''	「だって、あの厩舎はグレゴリ警部が調べたんだろう？」
``Oh, an old horse-faker like him has many a dodge.''	「馬の扱いもあいつぐらいになると、どうにでもぺてんの利くもんだよ」
``But are you not afraid to leave the horse in his power now	「だって君は、ブラウンに馬を預けておいて心配はないのかい？
since he has every interest in injuring it?''	あの馬に傷をつければ、どの点から見てもブラウンの利益になるんだのに」
``My dear fellow,	「安心したまえ。
he will guard it as the apple of his eye.	ブラウンは掌中の玉のように馬を大切にするから。
He knows that his only hope of mercy is to produce it safe.''	少しでも罪を軽くしてもらうには馬を安全にしておくのが、唯一の方法だと、ちゃんと心得ているんだ」
``Colonel Ross did not impress me as a man who would be likely to show much mercy in any case.''	「だが、ロス大佐のあの様子じゃどんなことをしたって、寛大な処置をとりそうもないね」
``The matter does not rest with Colonel Ross.	「この事件は大佐の一存じゃきまらないんだ。
I follow my own methods and tell as much or as little as I choose.	僕は自分の思う通りに歩を進めていいように話しておく。
That is the advantage of being unofficial.	そこは警察の役人でない有難さ。
I don't know whether you observed it, Watson, but the colonel's manner has been just a trifle cavalier to me.	君はどう思ったか知らないが、大佐の態度は僕には少々素気（そっけ）なさすぎた。
I am inclined now to have a little amusement at his expense.	だから費用は先持ちで、ちょっとばかり面白いことをしてやろうと思うんだ。
Say nothing to him about the horse.''	馬のことは大佐には何んにもいわずにおきたまえ」
``Certainly not without your permission.''	「いいとも、君が許すまでは黙ってるよ」
``And of course this is all quite a minor point compared to the question of who killed John Straker.''	「もっともこんなことはジョン・ストレーカ殺しの犯人問題に比べれば、ごく些細なことだがね」
``And you will devote yourself to that?''	「じゃ、これからその方に専念するつもりなのか？」
``On the contrary, we both go back to London by the night train.''	「いいや、夜行列車で一緒にロンドンへ帰ろう」
I was thunderstruck by my friend's words.	ホームズのこの言葉に私はひどく驚かされた。
We had only been a few hours in Devonshire, and that he should give up an investigation which he had begun so brilliantly was quite incomprehensible to me.	デヴォンシャへ来てまだ二三時間にしかならないのに、これほど素晴しい成功を持って進捗しつつある事件を、すっぱりと見切りをつけてしまおうとする彼の腹が、私には分らなかった。
Not a word more could I draw from him until we were back at the trainer's house.	いろいろ訊ねてみたが、彼が黙々として、ストレーカの家へ帰りつくまで一言も発しなかった。
The colonel and the inspector were awaiting us in the parlour.	帰ってみると、大佐は警部と一緒に客間で待っていた。
``My friend and I return to town by the night-express,''	「私達は今晩の夜中の汽車でロンドンへ引揚げます」
said Holmes.	ホームズはいった。
``We have had a charming little breath of your beautiful Dartmoor air.''	「おかげでダートムアの美しい空気を、しばらく呼吸させていただきました」
The inspector opened his eyes, and the colonel's lip curled in a sneer.	これを聞いて警部は呆気にとられ、大佐は唇に冷笑を浮べた。
``So you despair of arresting the murderer of poor Straker,''	「では、ストレーカ殺しの犯人は捕まらんと断念されたんですか？」
Holmes shrugged his shoulders.	ホームズは昂然として、
``There are certainly grave difficulties in the way,''	「非常な困難が横（よこた）わってることは事実です。
``I have every hope, however, that your horse will start upon Tuesday,	それにしてもこの火曜日にあなたの馬が競馬に出られることは、相違あるまいと思われます。
and I beg that you will have your jockey in readiness.	どうか騎手の御用意をお忘れないように。
Might I ask for a photograph of Mr. John Straker?''	それから、ストレーカ氏の写真を一枚拝借願いたいと思いますが」
The inspector took one from an envelope and handed it to him.	グレゴリ警部はポケットに持っていた封筒から一枚取出して、ホームズに渡した。
``My dear Gregory, you anticipate all my wants.	「グレゴリさんは私が欲しいと思うものはいつも先廻りして用意しておいて下さるですね、有難う。
If I might ask you to wait here for an instant, I have a question which I should like to put to the maid.''	ところで、しばらく皆さまにお待ちを願って、女中に二三質問したいことがありますが――」
``I must say that I am rather disappointed in our London consultant,''	ホームズが部屋を出て行くと大佐は露骨にいった。
said Colonel Ross bluntly as my friend left the room.	「ロンドンなんかからわざわざ探偵を呼んでどうも馬鹿を見ちゃった。
``I do not see that we are any further than when he came.''	あの男が来てからこればかりも捗ったことか！」
``At least you have his assurance that your horse will run,''	「少なくとも白銀が競馬に出ることだけはホームズは保証しましたよ」
said I.	私は口を入れた。
``Yes, I have his assurance,''	「なるほど、その保証はあった」
said the colonel with a shrug of his shoulders.	大佐は冷笑を浮べて、
``I should prefer to have the horse.''	「保証よりは馬を早く戻してもらった方がいい」
I was about to make some reply in defence of my friend when he entered the room again.	私がホームズのために弁明しようとしたところへ、彼は入って来た。
``Now, gentlemen,'' said he, ``I am quite ready for Tavistock.''	「それでは皆さん、いつでもタヴィストックへお供いたしましょう」
As we stepped into the carriage one of the stable-lads held the door open for us.	私達が馬車に乗ろうとすると、一人の若者が扉（ドア）を押えていてくれた。
A sudden idea seemed to occur to Holmes, for he leaned forward and touched the lad upon the sleeve.	ホームズはつと何か考えついたらしく若者の袖を引いて訊ねた。
``You have a few sheep in the paddock,'' he said.	「調馬場の柵の中に羊が少しいるようだが、
``Who attends to them?''	誰が世話するのかね？」
``I do, sir.''	「私がやりますんで」
``Have you noticed anything amiss with them of late?''	「近頃何か羊に変ったことはなかったかね？」
``Well, sir, not of much account, but three of them have gone lame, sir.''	「へえ、大したこともございませんが、三頭だけどういうものか跛（ちんば）になりましたんで」
I could see that Holmes was extremely pleased,	ホームズはいと満足げだった。
for he chuckled and rubbed his hands together.	ニッコリと笑って、頻りに両手をこすり合せていた。
``A long shot, Watson, a very long shot,''	「大変な想像だよ、ワトソン君、非常に大胆な想像が当ったよ。
``Gregory, let me recommend to your attention this singular epidemic among the sheep.	グレゴリさん、羊の中に妙な病気が流行しているのは、大（おおい）に御注意なさったらいいと思います。
Drive on, coachman!''	じゃ、馭者君やって下さい」
Colonel Ross still wore an expression which showed the poor opinion which he had formed of my companion's ability, but I saw by the inspector's face that his attention had been keenly aroused.	ロス大佐は依然としてホームズを軽蔑するらしい顔をしていたが、警部はいたく注意を喚起させられたらしかった。
``You consider that to be important?''	「あなたはそれを重大視されますか？」
he asked.	警部はいった。
``Exceedingly so.''	「極めて重大視します」
``Is there any point to which you would wish to draw my attention?''	「その他何か私の注意すべきことはないでしょうか？」
``To the curious incident of the dog in the night-time.''	「あの晩の犬の不思議な行動に御注意なさるといいでしょう」
``The dog did nothing in the night-time.''	「犬は全然何もしなかったはずですが」
``That was the curious incident,''	「そこが不思議な行動だと申すのです」
Four days later Holmes and I were again in the train, bound for Winchester to see the race for the Wessex Cup.	それから四日たって私達はウェセクス賞杯争覇戦を見るために、再びウィンチェスタ行の汽車に乗った。
Colonel Ross met us by appointment outside the station, and we drove in his drag to the course beyond the town.	約束通りロス大佐は停車場の入口まで来て待っていてくれたので、私達はそのまま大佐の四頭立（よんとうだて）馬車で市はずれの競馬場へ向った。
His face was grave, and his manner was cold in the extreme.	大佐はひどく暗い顔をして、更に元気がなかった。
``I have seen nothing of my horse,''	「私の馬を一向見かけないようですがね」
said he.	大佐はいった。
``I suppose that you would know him when you saw him?''	「ごらんになれば御自分の馬だからお分りになるでしょう」
asked Holmes.	ホームズはそういった。
The colonel was very angry.	大佐はムッとして、
``I have been on the turf for twenty years and never was asked such a question as that before,''	「私は二十年来競馬場に出入りしているが、只今のようなお訊ねを受けるのは始めてです。
``A child would know Silver Blaze with his white forehead and his mottled off-foreleg.''	あの馬の純白の額と、斑の前脚とを見れば、子供にだって分ることです」
``How is the betting?''	「賭けはどんな模様です」
``Well, that is the curious part of it.	「その点だけはどうも妙です。
You could have got fifteen to one yesterday, but the price has become shorter and shorter, until you can hardly get three to one now.''	昨日なら十五対一でも売り手があったのに、だんだん差が少くなって、今では三対一でもどうですかな」
``Hum!''	「ふむ！」
said Holmes.	ホームズは独りごちて、
``Somebody knows something, that is clear.''	「何か知った奴があるんだな、たしかにそうです」
As the drag drew up in the enclosure near the grandstand I glanced at the card to see the entries.	馬車が大スタンド近くの入口から入る時、競争加入者表を見あげると、次のように書き出されてあった。
Wessex Plate	ウェセクス賞杯競馬
[ it ran ] 50 sovs.	各出場馬金五〇ソヴリン。
each h ft with 1000 sovs. added, for four and five year olds.	同五歳馬にて一着には金一〇〇〇ソヴリンを副賞す。
Second, 300 pounds.	二着二〇〇ポンド。
New course ( one mile and five furlongs ).	新コース（一哩八分の五）
1. Mr. Heath Newton's The Negro.	一、ヒース・ニウトン氏　黒人
Red cap.	（赤色（せきしょく）帽、
Cinnamon jacket.	肉桂色（にくけいしょく）短衣（ジャケツ））
2. Colonel Wardlaw's Pugilist.	二、ワードロ大佐　拳闘家
Pink cap.	（淡紅色（たんこうしょく）帽、
Blue and black jacket.	青及（および）黒短衣（ジャケツ））
3. Lord Backwater's Desborough.	三、バックウォータ卿　デスボロ
Yellow cap and sleeves.	（黄色（こうしょく）帽、袖同色）
4. Colonel Ross's Silver Blaze.	四、ロス大佐　白銀
Black cap.	（黒色（こくしょく）帽、
Red jacket.	赤色短衣（ジャケツ））
5. Duke of Balmoral's Iris.	五、バルモーラル公爵　アイリス
Yellow and black stripes.	（黄及黒の縞）
6. Lord Singleford's Rasper.	六、シングルフォド卿　ラスパ
Purple cap.	（紫色（ししょく）帽、
Black sleeves.	袖黒）
``We scratched our other one and put all hopes on your word,''	「私の方ではもう一頭の方を見合せて、すべての希望をあなたの言葉につないでいるんです」
said the colonel.	大佐はいった、
``Why, what is that?	「おや、これはどうだ！
Silver Blaze favourite?''	白銀はちゃんと出ているな！」
``Five to four against Silver Blaze!''	「白銀は五対四！」
roared the ring.	賭場（かけば）から喚き声が起った。
``Five to four against Silver Blaze!	「白銀は五対四！
Five to fifteen against Desborough!	デスボロは十五対三！
Five to four on the field!''	場（じょう）に出れば五対四！」
``There are the numbers up,''	「ぞろぞろ出て行くぜ」
I cried.	私が注意をした。
``They are all six there.''	「ああ、六頭全部いる！」
``All six there?	「六等全部だ！
Then my horse is running,''	してみると私の馬もいるんだな！」
cried the colonel in great agitation.	大佐は叫び声を挙げた。
``But I don't see him.	「だが、白銀はいない！
My colours have not passed.''	黒帽赤短衣（ジャケツ）はここを通らなかった」
``Only five have passed.	「いや、まだ五頭通っただけです。
This must be he.''	今度のがそうに違いありません」
As I spoke a powerful bay horse swept out from the weighing enclosure and cantered past us,	私がこういった時、逞ましい栗毛の逸物が重量検査所から出て来て、ゆるやかな駈足で私達の前を通った。
bearing on its back the well-known black and red of the colonel.	鞍上（くらうえ）にはロス大佐の色別（しきべつ）として有名な黒と赤との騎手が乗っていた。
``That's not my horse,''	「あれは私の馬じゃない！」
cried the owner.	持主の大佐は叫んだ。
``That beast has not a white hair upon its body.	「あいつには額に白い毛がない！
What is this that you have done, Mr. Holmes?''	ホームズさん、あんたは一体何をやったんですッ？」
``Well, well, let us see how he gets on,''	「まあ、まあ、あの馬がどんなことになるか見ていましょう」
said my friend imperturbably.	ホームズは騒がずにいって
For a few minutes he gazed through my field-glass.	私の双眼鏡をとってしばらく一心に眺めていたが、
``Capital!	「見事だ！
An excellent start!''	素晴らしいスタートだ！
``There they are,	や、や、来たぞ！
coming round the curve!''	コーナを廻って来たぞ！」
From our drag we had a superb view as they came up the straight.	馬車の上から見ていると、やがて直線部に来た時の彼等は壮大であった。
The six horses were so close together that a carpet could have covered them,	六頭の馬は一枚の敷物でかくせるくらい接近して馳（かけ）っていた。
but halfway up the yellow of the Mapleton stable showed to the front.	が、半ば頃まではケープ［＃「プ」は底本では「ブ」］ルトンの黄色がその中の先頭を切っていたが、
Before they reached us, however, Desborough's bolt was shot, and the colonel's horse, coming away with a rush, passed the post a good six lengths before its rival,	私達の前まで来た時はデスボロは力つきて出足鈍り、大佐の馬は突進してそれを抜き、決勝点に入った時は、優に六馬身の差があった。
the Duke of Balmoral's Iris making a bad third.	バルモーラル公のアイリス号はずっとおくれて三着になった。
``It's my race, anyhow,''	「とにかく、勝（かつ）には勝った」
gasped the colonel, passing his hand over his eyes.	大佐はホッとして、手で両眼（りょうがん）を拭き払いながら、
``I confess that I can make neither head nor tail of it.	「しかし、正直なところ私には何が何んだかさっぱり分りません。
Don't you think that you have kept up your mystery long enough, Mr. Holmes?''	ホームズさん、もういい加減に教えて下すってもよくはありませんか」
``Certainly, Colonel,	「申し上げましょう。
you shall know everything.	何もかも申し上げましょう。
Let us all go round and have a look at the horse together.	みんなであっちへ行って馬を見てやりましょう。
Here he is,''	ここにいますよ」
he continued as we made our way into the weighing enclosure, where only owners and their friends find admittance.	ホームズは馬主とその連れだけしか入（い）れない重量検査所へ入って行きながら、
``You have only to wash his face and his leg in spirits of wine,	「この馬の顔と脚とをアルコールで洗っておやりなさい。
and you will find that he is the same old Silver Blaze as ever.''	そうすればもとのままの白銀だということが分りますから」
``You take my breath away!''	「えッ！
``I found him in the hands of a faker and took the liberty of running him just as he was sent over.''	「あるいかさま師の手に入っていたのを見つけ出して、勝手ながらその時のままの姿で出場させたわけです」
``My dear sir, you have done wonders.	「どうもあなたの慧眼は驚くべきものです。
The horse looks very fit and well.	馬は非常に調子がいいようです。
It never went better in its life.	全く今までになかったいい調子です。
I owe you a thousand apologies for having doubted your ability.	あなたの手腕を疑ぐったりして、なんと謝罪していいか分りません。
You have done me a great service by recovering my horse.	こうして大切な馬を取戻して下すったのですから、
You would do me a greater still if you could lay your hands on the murderer of John Straker.''	この上はジョン・ストレーカ殺しの犯人を見つけて下されば、これに越す幸いはありません」
``I have done so,''	「加害者も捕えておきました」
said Holmes quietly.	ホームズはすましていった。
The colonel and I stared at him in amazement.	大佐は無論、私までも驚いて彼の顔を眺めやった。
``You have got him!	「えッ！
Where is he,	どこにいます？
then?''	それでは？」
``He is here.''	「ここにいます」
``Here!	「ここに？
Where?''	どこです？」
``In my company at the present moment.''	「今現に我々と一緒にいます」
The colonel flushed angrily.	大佐はこの一語にカッとなって、
``I quite recognize that I am under obligations to you, Mr. Holmes,''	「ホームズさん、あなたのおかげを受けてることは十分認めもし、感謝もしていますが、
``but I must regard what you have just said as either a very bad joke	只今のお言葉は冗談にしては少し重すぎはしませんか。
or an insult.''	あなたは私を侮辱しますか！」
Sherlock Holmes laughed.	ホームズは笑っていった。
``I assure you that I have not associated you with the crime, Colonel,''	「大佐、あなたを何も犯人だと申したのではありませんよ。
``The real murderer is standing immediately behind you.''	真犯人はあなたのすぐ後に立っていますよ」
He stepped past and laid his hand upon the glossy neck of the thoroughbred.	ロス大佐は進みよって、名馬の沢（つや）やかな額に手をかけたが、急に気がついて、
``The horse!''	「馬がッ！」
cried both the colonel and myself.	と叫んだ。
``Yes, the horse.	「そうです、馬がです。
And it may lessen his guilt if I say that it was done in self-defence, and that John Straker was a man who was entirely unworthy of your confidence.	ジョン・ストレーカは全然あなたの信頼するに足りない男であります、馬は正当防禦のために殺したにすぎないことを申し上げれば、この馬の罪もいく分軽くなるわけでしょう。
But there goes the bell,	ところでベルが鳴り出しました。
and as I stand to win a little on this next race, I shall defer a lengthy explanation until a more fitting time.''	今度の競馬で私は少し勝ちたいと思いますから、その説明はいずれ後でゆっくりと委しく申し上げることにしましょう」
We had the corner of a Pullman car to ourselves that evening as we whirled back to London, and I fancy that the journey was a short one to Colonel Ross as well as to myself as we listened to our companion's narrative of the events which had occurred at the Dartmoor training-stables upon that Monday night, and the means by which he had unravelled them.	その晩、ロンドンへの帰りを、私達は寝台車の一隅に席を占めたが、前週の月曜日にダートムアの競馬場で起った出来事を、順序を追ってホームズは話し、そしていかにしてそれを解決するに至ったかを語り聞かせてくれたから、汽車の無聊を感じるどころか、ロス大佐にしても私にしても時間のたつのを知らなかったくらいである。
``I confess,'' said he, ``that any theories which I had formed from the newspaper reports were entirely erroneous.	「実のところ、新聞の報道を根拠に組立てた私の意見は全然誤っていました。
And yet there were indications there, had they not been overlaid by other details which concealed their true import.	しかも、新聞の記事にも正しい暗示の出ていたことは出ていたのですが、いろんな他の事項のためにそれがかくされていたのです。
I went to Devonshire with the conviction that Fitzroy Simpson was the true culprit,	デヴォンシャへ行くまでは、フィツロイ・シムソンが真犯人だと私は信じていました。
although, of course, I saw that the evidence against him was by no means complete.	もっとも彼に対する証拠は完全だとはむろん考えていませんでしたけれど。
It was while I was in the carriage, just as we reached the trainer's house, that the immense significance of the curried mutton occurred to me.	ところが、いよいよ馬車でストレーカの家に着いた時に、ふと羊のカレー料理が非常に重要な意味を持っていることに気がつきました。
You may remember that I was distrait and remained sitting after you had all alighted.	あの時、私がぼんやりして、みんなが降りてしまったのにまだ馬車の中に残っていたことを覚えていらっしゃるでしょう。
I was marvelling in my own mind how I could possibly have overlooked so obvious a clue.''	あの時私は、こんな明瞭な手懸りがあるのに、どうして今まで見逃していたろうかと、我れながらつくづく驚いていたのです」
``I confess,''	「と仰しゃられてもまだ私にはさっぱり分りませんなあ」
said the colonel,	大佐はいった。
``It was the first link in my chain of reasoning.	「あれが私の推理の第一階梯となったのです。
Powdered opium is by no means tasteless.	阿片末は無味なものではありません。
The flavour is not disagreeable, but it is perceptible.	匂いは不快ではありませんが、すぐに知れるものです。
Were it mixed with any ordinary dish the eater would undoubtedly detect it and would probably eat no more.	だから普通の料理にこれを混ぜれば一口でそれと気がついて食べるのを止（や）めてしまいます。
A curry was exactly the medium which would disguise this taste.	そこでカレーを使えばこの味を消してしまいます。
By no possible supposition could this stranger, Fitzroy Simpson, have caused curry to be served in the trainer's family that night,	全くの他人であるフィツロイ・シムソンが、この夜あの一家に、カレー料理を食べさせるように仕込んだろうなんてことは、全然想像も許されないことです。
and it is surely too monstrous a coincidence to suppose that he happened to come along with powdered opium upon the very night when a dish happened to be served which would disguise the flavour.	それかといって、阿片の味を消す料理の出た晩に、折よくシムソンが阿片を使うつもりで来たと考えるのも、あまりに奇怪な暗合というものです。
That is unthinkable.	そんな馬鹿なことは考えられません。
Therefore Simpson becomes eliminated from the case, and our attention centres upon Straker and his wife, the only two people who could have chosen curried mutton for supper that night.	だから、シムソンはこの事件から除外することが出来、その夜の御馳走をカレー料理と定（き）めることの出来る人、すなわちストレーカ夫婦に我々の注意は集中されるわけです。
The opium was added after the dish was set aside for the stable-boy,	阿片は厩舎に残ってるハンタの分として、別の皿へとり分けられてから入れたものです。
for the others had the same for supper with no ill effects.	同じものを食べた他の人達に、異状のなかったのでも知れます。
Which of them, then, had access to that dish without the maid seeing them?	では、女中に気づかれないようにその皿に近附いたのは夫婦の中（うち）果してどっちでしょうか？
``Before deciding that question I had grasped the significance of the silence of the dog, for one true inference invariably suggests others.	一つの正しい結論は、必然第二の結論を暗示するものです。
The Simpson incident had shown me that a dog was kept in the stables, and yet, though someone had been in and had fetched out a horse, he had not barked enough to arouse the two lads in the loft.	シムソン事件のおかげで私は厩舎に犬の飼ってあることを知りましたが、夜中に誰かが厩舎へ入って馬をつれ出したのに犬が吠えなかった、少くとも二階に寝ていた二人の若者の眼をさますほどには吠えなかったという事実に考え至りました。
Obviously the midnight visitor was someone whom the dog knew well.	これは馬をつれ出した者が、犬のよく知ってる人物であるということを示しています。
``I was already convinced, or almost convinced, that John Straker went down to the stables in the dead of the night and took out Silver Blaze.	そこで私は真夜中に厩舎へ行って白銀をつれ出したのはジョン・ストレーカであると断じました。
For what purpose?	しからばそれは何んのためであったか？
For a dishonest one, obviously,	無論不正の目的のためであることはいうまでもありません。
or why should he drug his own stable-boy?	でなければ何んで薬で厩番を眠らせたりしましょう。
And yet I was at a loss to know why.	しかも、不正な目的とまでは分っても、それが果してどんなことであるか私には分りません。
There have been cases before now where trainers have made sure of great sums of money by laying against their own horses through agents and then preventing them from winning by fraud.	調馬師が自分の預かっている馬を故意に痛めて出場不可能ならしめ、それによってうまうまと大金を得る例はこれまでもいくらもあったことです。
Sometimes it is a pulling jockey.	時には騎手を手に入れて八百長をやらせたり、
Sometimes it is some surer and subtler means.	また時には、もっと確実で、分りにくい方法を執ることもありますが、
What was it here?	この場合は果してどうでしょう？
I hoped that the contents of his pockets might help me to form a conclusion.	ストレーカのポケットにあった品物を見れば、何かこの間の消息を知る手懸りがありそうなものだと私は思いました。
``And they did so.	その品物は果して役に立ちました。
You cannot have forgotten the singular knife which was found in the dead man's hand,	お忘れもありますまいが、ストレーカは不思議なナイフを握って倒れていました。
a knife which certainly no sane man would choose for a weapon.	あれは決して普通の人間の持つナイフではありません。
It was, as Dr. Watson told us, a form of knife which is used for the most delicate operations known in surgery.	ワトソン君も申した通り、あれは極めて緻密な外科手術に使うメスの一種です。
And it was to be used for a delicate operation that night.	しかも、まさしくあの晩は緻密な手術をするため用意されていたものなんです。
You must know, with your wide experience of turf matters, Colonel Ross, that it is possible to make a slight nick upon the tendons of a horse's ham, and to do it subcutaneously, so as to leave absolutely no trace.	大佐、あなたの競馬に関する広い経験をもってすれば、馬の膝膕部（ひざかがみ）の腱に、外面に何んの痕跡をも残さず皮下手術的にちょっと傷をつけることは容易であって、
A horse so treated would develop a slight lameness,	しかもそれをやられた馬は軽い跛（びっこ）を引き出すけれど、
which would be put down to a strain in exercise or a touch of rheumatism, but never to foul play.''	調馬中に筋でも違（たが）えたかそれとも軽いリウマチスに罹ったかということになって、不正の行われたのは決して分らないということを御承知でございましょうね」
``Villain!	「不届きな奴め！
Scoundrel!''	そんなことを企みおったのかッ」
``We have here the explanation of why John Straker wished to take the horse out on to the moor.	「そこでジョン・ストレーカがなぜ馬を荒地（あれち）へつれ出したかは説明がつきます。
So spirited a creature would have certainly roused the soundest of sleepers when it felt the prick of the knife.	馬のような敏感な動物はナイフの先をちくりと感じただけでも烈しく騒ぎたてて、どんなによく眠っている者をでも起してしまいます。
It was absolutely necessary to do it in the open air.''	だから、その手術は屋外の広い場所ですることが、絶対に必要だったのです」
``I have been blind!''	「私が盲目（めくら）だった。
``Of course that was why he needed the candle and struck the match.''	だから、蝋燭を持っていたり、マッチをすったりしたんですな」
``Undoubtedly.	「無論そうです。
But in examining his belongings I was fortunate enough to discover not only the method of the crime but even its motives.	ところでポケットから出た品物を調べてみると、私は犯行の方法を発見したばかりでなく、幸いにしてその動機をも知ることが出来ました。
As a man of the world, Colonel, you know that men do not carry other people's bills about in their pockets.	大佐、あなたは世間の広い方ですが、他人の勘定書を持ってる者がどこにありましょう？
We have most of us quite enough to do to settle our own.	普通の人間ならば自分の払いを始末するだけで十分のはずです。
I at once concluded that Straker was leading a double life and keeping a second establishment.	私はあの書附を見てストレーカは二重生活をやって、第二の家をどこかに持っているのだと断定しました。
The nature of the bill showed that there was a lady in the case,	しかも書附の内容を見れば、それには婦人の関係していることが知れます。
and one who had expensive tastes.	非常に贅沢な好みの婦人です。
Liberal as you are with your servants, one can hardly expect that they can buy twenty-guinea walking dresses for their ladies.	あなたが雇人にいくら寛大であり、いくら酬（むく）いられるからといって、彼等が自分の女に二十ギンの散歩服を買ってやれる身分だとは考えられますまい。
I questioned Mrs. Straker as to the dress without her knowing it, and, having satisfied myself that it had never reached her,	私はストレーカの細君にそれとなく服のことを訊ねてみますと、その服は果して細君の買ってもらったものではないことが分りました。
I made a note of the milliner's address and felt that by calling there with Straker's photograph I could easily dispose of the mythical Derbyshire.	この上はその帽飾店のところを控えて帰って、ストレーカの写真を持って店へ行って訊ねてみれば、事件の秘密はすっかりさらけ出せるだろうと思います。
``From that time on all was plain.	そのあとは極めて簡単です。
Straker had led out the horse to a hollow where his light would be invisible.	ストレーカは馬をつれ出して、燈火（ともしび）をつけても人の眼につかぬようにあの凹みへ降りて行きました。
Simpson in his flight had dropped his cravat, and Straker had picked it up -- with some idea,	その前に、シムソンは逃げる時、襟飾（ネクタイ）を落して逃げましたが、ストレーカは何か考えがあってそれを拾っておきました。
perhaps, that he might use it in securing the horse's leg.	おそらくそれで馬の脚でもしばるつもりだったのでしょう。
Once in the hollow, he had got behind the horse and had struck a light;	で、凹みの底へ降りて行くとすぐに、馬の後へ廻ってマッチをすりました。
but the creature, frightened at the sudden glare, and with the strange instinct of animals feeling that some mischief was intended, had lashed out,	ところが馬は急にマッチの光に驚いて、同時に動物の不思議な本能で、自分の身に何か危険が企まれていることを感じ、ぱっと跳ね上りました。
and the steel shoe had struck Straker full on the forehead.	その拍子にストレーカは額を蹴られて倒れたのです。
He had already, in spite of the rain, taken off his overcoat in order to do his delicate task,	雨は降っていましたが、仕事が細かいためストレーカはその前に外套を脱いでおきました。
and so, as he fell, his knife gashed his thigh.	そして、倒れる時自分で自分の腿を刺したのです。
Do I make it clear?''	これですっかりお分りですか？」
``Wonderful!''	「驚いた！
``Wonderful!	実に驚きました。
You might have been there!''	まるで傍で見ていたようです！」
``My final shot was, I confess, a very long one.	「正直に申すと、私の最後の断定は極めて大胆でした。
It struck me that so astute a man as Straker would not undertake this delicate tendon-nicking without a little practise.	ストレーカのような狡猾な男が、この難しい腱の手術をするに、少しも練習なしにいきなりやるはずはないと気がついたのです。
What could he practise on?	ではどうしたら練習が出来るでしょう？
My eyes fell upon the sheep, and I asked a question which, rather to my surprise,	その時、私はふと羊のことを思い、訊ねてみると、自分でも驚くほど私の推定が当ってるのを知りました」
showed that my surmise was correct.	「これで何もかも完全に判明しました」
``When I returned to London I called upon the milliner, who had recognized Straker as an excellent customer of the name of Derbyshire, who had a very dashing wife, with a strong partiality for expensive dresses.	「ロンドンへ帰ってから帽飾店へ行ってみますと、ストレーカはダービシャといって、特に高価な服の好きな、見栄坊の妻を持ったその店の上客だということが分りました。
I have no doubt that this woman had plunged him over head and ears in debt, and so led him into this miserable plot.''	この女がストレーカを借財で首のまわらぬまでにし、遂にこの悲惨な結果に終った陰謀を企ませたことは申すまでもありません」
``You have explained all but one thing,''	「すっかり分りましたが、一つだけまだお話し下さらないことがあります。
``Where was the horse?''	馬はいったいどこにいたのですか？」
``Ah, it bolted, and was cared for by one of your neighbours.	「馬ですか、馬は逸走してしまって、あの附近のある人の保護を受けていたのです。
We must have an amnesty in that direction, I think.	その辺のことは大目に見ておかなければなりますまい。
This is Clapham Junction, if I am not mistaken,	ああ、ここはどうやらクラパムの乗換駅ですね？
and we shall be in Victoria in less than ten minutes.	ヴィクトリア・ステーションまではもう十分とかかりません。
If you care to smoke a cigar in our rooms, Colonel,	大佐、私のところへお寄り下すって、葉巻でもおやりになりませんか？
I shall be happy to give you any other details which might interest you.''	この他に何かお訊ねになりたいことでもありましたら、何んなりと喜んでお答えいたします」
