I had called upon my friend Sherlock Holmes upon the second morning after Christmas, with the intention of wishing him the compliments of the season.	クリスマス後2日目の朝、私はシャーロック・ホームズに祝いを言っておこうと思い、部屋を訪れた。
He was lounging upon the sofa in a purple dressing-gown,	ホームズは紫色のガウンにくるまってソファに持たれかかっていた。
a pipe-rack within his reach upon the right, and a pile of crumpled morning papers, evidently newly studied, near at hand.	右側のパイプ置きは手が届くところにあり、手元には、調べたばかりに違いない、皺だらけの朝刊が山積みされている。
Beside the couch was a wooden chair, and on the angle of the back hung a very seedy and disreputable hard-felt hat,	ソファのそばには木製の椅子があって、背もたれの角にひどくみっともない帽子がかかっていた。
much the worse for wear, and cracked in several places.	かなりくたびれており、ひび割れているところがいくつもある。
A lens and a forceps lying upon the seat of the chair suggested that the hat had been suspended in this manner for the purpose of examination.	レンズとピンセットが椅子に乗っているところからして、この帽子は分析するためにこうしてあるらしい。
"You are engaged,"	「仕事中か」
said I;	と私。
"perhaps I interrupt you."	「邪魔かな」
"Not at all.	「ちっとも。
I am glad to have a friend with whom I can discuss my results.	成果を話す相手がきたんで嬉しいよ。
The matter is a perfectly trivial one"	問題はじつにくだらない」
--he jerked his thumb in the direction of the old hat--	――ホームズは例の古帽子に親指を向けた――
"but there are points in connection with it which are not entirely devoid of interest and even of instruction."	「が、その裏にはおもしろい点もあるし、ためになる点だってないわけじゃない」
I seated myself in his armchair and warmed my hands before his crackling fire,	私はホームズの肱掛椅子に腰を下ろし、ホームズの前の爆ぜかえる暖炉で両手を暖めた。
for a sharp frost had set in, and the windows were thick with the ice crystals.	外には厳しい霜がおり、窓は厚い氷のクリスタルで覆われていた。
"I suppose,"	「どうやら」
I remarked,	と私は言った。
"that, homely as it looks, this thing has some deadly story linked on to it	「見た目こそありふれているけど、これにまつわる恐ろしい話があるらしいね
--that it is the clew which will guide you in the solution of some mystery and the punishment of some crime."	――そして、それが手がかりとなり、君は謎を解き明かしてその犯罪を裁く」
"No, no. No crime,"	「違う、違う、犯罪とは違うんだ」
said Sherlock Holmes, laughing.	ホームズは笑い出した。
"Only one of those whimsical little incidents	「気まぐれな、くだらない偶発事のひとつだよ。
which will happen when you have four million human beings all jostling each other within the space of a few square miles.	ほんの数平方マイルの土地で400万の人間が押し合いへし合いやっていれば、こんな事件も起きるもんだ。
Amid the action and reaction of so dense a swarm of humanity, every possible combination of events may be expected to take place,	こうも密集した人の群れによる作用と反作用の中では、さまざまな出来事のあらゆる組み合わせが起こりうる。
and many a little problem will be presented which may be striking and bizarre without being criminal.	そして、犯罪性とは無縁ながらも、突飛な小事が無数に姿をあらわすんだ。
We have already had experience of such."	ぼくらはそういう事件もすでに経験してきた」
"So much so," l remarked,	「そうだね。
"that of the last six cases which I have added to my notes, three have been entirely free of any legal crime."	ぼくが記録に加えた最近の6事件も、3つはまったく法律に触れていなかったな」
"Precisely.	「まったくだ。
You allude to my attempt to recover the Irene Adler papers,	それで思い出したよ。アイリーン・アドラー文書。
to the singular case of Miss Mary Sutherland,	ミス・メアリ・サザーランドの奇妙な事件。
and to the adventure of the man with the twisted lip.	唇のねじれた男の冒険、か。
Well, I have no doubt that this small matter will fall into the same innocent category.	そう、この小さな事件が同じカテゴリーに収まるのは間違いないな。
You know Peterson, the commissionaire?"	守衛のピータースンを知っているね？」
"Yes."	「ああ」
"It is to him that this trophy belongs."	「これはピータースンの戦利品だよ」
"It is his hat."	「ピータースンの帽子だったのか」
"No, no, he found it.	「違う、違う、拾ったんだ。
Its owner is unknown.	所有者は不明。
I beg that you will look upon it not as a battered billycock but as an intellectual problem.	使い古しの山高帽としてではなく、知的な問題として見てもらいたいな。
And, first, as to how it came here.	では最初にこれがどうやってここにきたのかを。
It arrived upon Christmas morning,	こいつはクリスマスの朝にやってきた。
in company with a good fat goose,	立派な太った鵞鳥と一緒にね。
which is, I have no doubt, roasting at this moment in front of Peterson's fire.	鵞鳥の方は、間違いなく、いまこの瞬間にピータースン家の暖炉であぶられている。
The facts are these:	事実はこうだ。
about four o'clock on Christmas morning, Peterson, who, as you know, is a very honest fellow, was returning from some small jollification and was making his way homeward down Tottenham Court Road.	クリスマスの朝4時ごろ、ピータースンという、知ってのとおり、きわめて誠実な人物が、ささやかなお祭り騒ぎからの帰り道、トテナム・コート街を通った。
In front of him he saw, in the gaslight, a tallish man, walking with a slight stagger, and carrying a white goose slung over his shoulder.	前方を見ると、ガス灯に照らされて、背の高い男が、白い鵞鳥を肩にぶらさげ、よろめきながら歩いている。
As he reached the corner of Goodge Street, a row broke out between this stranger and a little knot of roughs.	グッジ街の角のところで、男と乱暴者の群れとの間に騒動が持ちあがった。
One of the latter knocked off the man's hat, on which he raised his stick to defend himself and,	乱暴者の1人が男の帽子を叩き落し、男がステッキを構えて身を守ろうとする。
swinging it over his head, smashed the shop window behind him.	そして、頭上で降り回したところ、背後にあった商店の窓に派手にぶつけてしまった。
Peterson had rushed forward to protect the stranger from his assailants;	ピータースンが、この見知らぬ男を乱暴者から守ろうと駆けよった。
but the man, shocked at having broken the window, and seeing an official-looking person in uniform rushing towards him, dropped his goose, took to his heels, and vanished amid the labyrinth of small streets which lie at the back of Tottenham Court Road.	ところがその男は、窓を割ってしまったことにショックを受けており、また制服をきた警官のような人物が駆け寄ってくるのを目にしたので、鵞鳥を落として逃げ出し、トテナム・コート街の背後に横たわる迷路のような街並に姿を消してしまった。
The roughs had also fled at the appearance of Peterson, so that he was left in possession of the field of battle,	乱暴者もピータースンの出現と同時に逃げ出したので、ピータースンは孤軍戦場に勝ちを占め、勝利の略奪品をものにした。
and also of the spoils of victory in the shape of this battered hat and a most unimpeachable Christmas goose."	それが、このくたびれた帽子と、まったく非のうちどころのないクリスマスの鵞鳥というわけだ」
"Which surely he restored to their owner?"	「持ち主に返そうとはしたのかい？」
"My dear fellow, there lies the problem.	「それには問題があるね、ワトスンくん。
It is true that 'For Mrs. Henry Baker' was printed upon a small card which was tied to the bird's left leg, and it is also true that the initials 'H. B.' are legible upon the lining of this hat, but as there are some thousands of Bakers, and some hundreds of Henry Bakers in this city of ours,	確かに、『ミセス・ヘンリー・ベイカーへ』と印刷された小さなカードが鳥の左足につけられていたし、これまた確かに、『Ｈ・Ｂ』のイニシャルが帽子の裏地に書いてあるけど、この街にはベイカーさんなんて何千人もいるし、ヘンリー・ベイカーさんとやらも何百人といるんだよ。
it is not easy to restore lost property to any one of them."	彼らのうち、特定の1人に品物を返すのは簡単なことじゃない」
"What, then, did Peterson do?"	「じゃあ、ピータースンはどうしたんだ？」
"He brought round both hat and goose to me on Christmas morning,	「クリスマスの朝に、ぼくに帽子と鵞鳥の両方を持ち込んできた。
knowing that even the smallest problems are of interest to me.	ぼくがきわめて小さな問題にも興味を持つことを知っていたからね。
The goose we retained until this morning,	鵞鳥も今朝まではとってあった。
when there were signs that, in spite of the slight frost, it would be well that it should be eaten without unnecessary delay.	霜が降りるような天気だというのに、今朝見てみるとどうにもすぐに食べてしまわないとまずいことになりそうだったから、
Its finder has carried it off, therefore, to fulfil the ultimate destiny of a goose, while I continue to retain the hat of the unknown gentleman who lost his Christmas dinner."	鵞鳥は拾い主の家でその究極的な目的を果たさせてやることにして、その一方、クリスマスディナーを失ったどこか紳士の帽子をここに残しておくことにしたんだ」
"Did he not advertise?"	「広告は出ていないのか？」
"No."	「ああ」
"Then, what clew could you have as to his identity?"	「じゃあ、その人物に関する手がかりは？」
"Only as much as we can deduce."	「推理できるだけ」
"From his hat?"	「その帽子から？」
"Precisely."	「まったくそのとおり」
"But you are joking.	「冗談はよせ。
What can you gather from this old battered felt?"	この使い古しのフェルトから何が分かる？」
"Here is my lens.	「ここにぼくのレンズがある。
You know my methods.	君はぼくのやり口を知っている。
What can you gather yourself as to the individuality of the man who has worn this article?"	さて、この品物をかぶっていた人物の特徴について、君なら何が分かる？」
I took the tattered object in my hands and turned it over rather ruefully.	私はボロボロの物体を手に取り、いくぶんうんざりしながら調べていった。
It was a very ordinary black hat of the usual round shape, hard and much the worse for wear.	ごくありふれた黒い帽子で、普通に丸い形をしており、かたくて、たいへんくたびれている。
The lining had been of red silk, but was a good deal discolored.	裏地は赤いシルクだが、かなり色あせてしまっていた。
There was no maker's name;	メーカーの名前はなく、
but, as Holmes had remarked, the initials "H. B." werescrawled upon one side.	ただ、ホームズが言ったとおり、片面に「Ｈ・Ｂ」というイニシャルが殴り書きされている。
It was pierced in the brim for a hat-securer, but the elastic was missing.	へりには帽子止めの穴を開けられているものの、ゴム紐はなし。
For the rest, it was cracked, exceedingly dusty, and spotted in several places,	あとは、ひび、ひどい埃、いくつものしみ。
although there seemed to have been some attempt to hide the discolored patches by smearing them with ink.	ただし、色あせた部分はインクを塗りつけて隠そうとしたようだ。
"I can see nothing,"	「何も見えてこないな」
said I, handing it back to my friend.	私は帽子をホームズの手に返した。
"On the contrary, Watson, you can see everything.	「逆だよ、ワトスン、君にはすべてが見えているんだ。
You fail, however, to reason from what you see.	ただし、見たものから原因を考えることにつまづいている。
You are too timid in drawing your inferences."	臆病すぎて推理を描けないんだよ」
"Then, pray tell me	「じゃあ、どうか教えてくれよ。
what it is that you can infer from this hat?"	いったい何がこの帽子から推理できるんだ？」
He picked it up and gazed at it in the peculiar introspective fashion which was characteristic of him.	ホームズは帽子をつまみあげ、ホームズ特有の内視的な雰囲気でそれを見つめた。
"It is perhaps less suggestive than it might have been,"	「かつてあったほどの手がかりは、もうないのかもしれない」
he remarked,	ホームズが話しだした。
"and yet thereare a few inferences which are very distinct,	「それでも、いくつかの点では、きわめてはっきりとした推理を立てられる。
and a few others which represent at least a strong balance of probability.	またいくつかの点では、とりあえず確率的には問題のなさそうな推理は立つね。
That the man was highly intellectual is of course obvious upon the face of it, and also that he was fairly well-to-do within the last three years, although he has now fallen upon evil days.	高い知性を持つ男だったという点は、もちろん見た目だけで分かるし、また、ここ3年以内にうまくいっていたことがあるが、今は不遇の日々に落ちこんでいるのだと思われる。
He had foresight, but has less now than formerly,	彼には先見の明があったが、今となってはそれも衰え、堕落しつつある。
pointing to a moral retrogression, which, when taken with the decline of his fortunes, seems to indicate some evil influence,	彼の運勢が下り坂になっていることと考え合わせると、何かから悪い影響を受けているようだ。
probably drink, at work upon him.	たぶん酒。
This may account also for the obvious fact that his wife has ceased to love him."	妻に愛してもらえなくなったという明らかな事実もそれが原因かもしれない」
"My dear Holmes!"	「ホームズくん？」
"He has, however, retained some degree of self-respect,"	「ただし、ある程度の自尊心は残している」
he continued, disregarding my remonstrance.	ホームズは、私の声に耳を貸さずに先を続けた。
"He is a man who leads a sedentary life, goes out little, is out of training entirely, is middle-aged,	「1日のほとんどを座ってすごし、ほとんど外出することのない、完全な運動不足の中年男性。
has grizzled hair which he has had cut within the last few days, and which he anoints with lime-cream.	白髪混じりの髪はここ数日中に切られており、ライムクリームが塗られている。
These are the more patent facts which are to be deduced from his hat.	……こういったところかな、この帽子から見て取れる特徴的な事実は。
Also, by the way, that it is extremely improbable that he has gas laid on in his house."	そうそうそれと、彼が家にガスを引いているのはまずありえないね」
"You are certainly joking, Holmes."	「もう冗談はいいよ、ホームズ」
"Not in the least.	「よくないよ。
Is it possible that even now, when I give you these results, you are unable to see how they are attained?"	今になっても、結果を教えてやっても、まだそれをたどれないのかい？」
"I have no doubt that I am very stupid, but I must confess that I am unable to follow you.	「ぼくがひどい馬鹿なのは間違いないけど、正直に言って君の意見には賛成しないね。
For example, how did you deduce that this man was intellectual?"	たとえばさ、その男が知的だというのはどうやって推理したんだ？」
For answer Holmes clapped the hat upon his head.	それに答える形で、ホームズは帽子を自分の頭に落とした。
It came right over the forehead and settled upon the bridge of his nose.	額はすっかり隠れ、鼻柱にきたところで止まった。
"It is a question of cubic capacity,"	「容積の問題だよ」
said he;	と、ホームズ。
"a man with so large a brain must have something in it."	「これほど大きな頭を持っているのなら、中身もあるに違いない」
"The decline of his fortunes, then?"	「じゃあ、運勢が下り坂というのは？」
"This hat is three years old.	「これは3年前に作られた帽子だ。
These flat brims curled at the edge came in then.	平べったいへりが端の方で内側に巻いている。
It is a hat of the very best quality.	まさに極上品だね。
Look at the band of ribbed silk and the excellent lining.	このシルクのバンドや、すばらしい裏地を見てくれ。
If this man could afford to buy so expensive a hat three years ago, and has had no hat since,	こんな贅沢な帽子を買う余裕が3年前にはあって、それから買い換えていない。
then he has assuredly gone down in the world."	となると、きっとこの男は落ちぶれてしまったんだ」
"Well, that is clear enough, certainly.	「なるほど、それは十分に分かったよ、そうだとも。
But how about the foresight and the moral retrogression?"	だけど、先見の明とか堕落しつつあるとかはどうなんだ？」
Sherlock Holmes laughed.	シャーロック・ホームズは笑い飛ばした。
"Here is the foresight,"	「先見の明はここに」
said he putting his finger upon the little disc and loop of the hat-securer.	と、帽子止めの小さな輪の上に指を置いた。
"They are never sold upon hats.	「店は絶対に帽子止めを売りこまないんだ。
If this man ordered one, it is a sign of a certain amount of foresight,	この男が注文をつけたのだとしたら、それはある程度の先見の明の表れだよ。
since he went out of his way to take this precaution against the wind.	手数をかけて風に対する予防策を採ったんだから。
But since we see that he has broken the elastic and has not troubled to replace it, it is obvious that he has less foresight now than formerly, which is a distinct proof of a weakening nature.	だけど、見てのとおりゴム紐が切れてしまっているのに、それを取り替える手間を惜しむあたり、明らかに以前ほど先見の明を持ち合わせておらず、さらにここで、天性の衰退がはっきりと証明されている。
On the other hand, he has endeavored to conceal some of these stains upon the felt by daubing them with ink, which is a sign that he has not entirely lost his self-respect."	一方では、フェルトの痛みをインクで隠そうとするあたり、自尊心を完全には失っていない、となるわけだ」
"Your reasoning is certainly plausible."	「たしかにもっともらしい論法だけどね」
"The further points, that he is middle-aged, that his hair is grizzled, that it has been recently cut, and that he uses imecream, are all to be gathered from a close examination of the lower part of the lining.	「残りの部分、中年だとか、白髪交じりだとか、最近髪を切ったとか、ライムクリームだとかいうのはね、裏地の下のほうに顔を近づけてみれば推測できるんだよ。
The lens discloses a large number of hair-ends, clean cut by the scissors of the barber.	レンズを使うと、理髪店の鋏できれいに切り落とされた大量の髪の毛先が見える。
They all appear to be adhesive, and there is a distinct odour of lime-cream.	どれもべとべとしているようだし、ライムクリームの香りもしている。
This dust, you will observe, is not the gritty, gray dust of the street but the fluffy brown dust of the house, showing that it has been hung up indoors most of the time, while the marks of moisture upon the inside are proof positive that the wearer perspired very freely, and could therefore, hardly be in the best of training."	この埃は、観察してみるといい、道端でつく砂や灰色の埃ではなく、家屋の茶色い埃であり、この帽子がほぼ常に室内にかけられていることが分かるし、また内側の湿気の跡は、持ち主がきわめてさかんに汗をかく人物でありほとんど体を鍛えていない人物である可能性を裏づけている」
"But his wife--you said that she had ceased to love him."	「だけど奥さんは――君は妻に愛されなくなったなんて言ったけど？」
"This hat has not been brushed for weeks.	「この帽子には数週間、ブラシがかけられていない。
When I see you, my dear Watson, with a week's accumulation of dust upon your hat, and when your wife allows you to go out in such a state, I shall fear	君に会ったときにさ、ワトスンくん、数週間分の埃が積もった帽子をかぶっていたり、そんな格好で奥さんに見送られたりしていたら、そのときは心配してやるよ。
that you also have been unfortunate enough to lose your wife's affection."	君もまた運命の悪戯か奥さんの愛情を失いつつあるということだからね」
"But he might be a bachelor."	「だけど独身かもしれないじゃないか」
"Nay, he was bringing home the goose as a peace-offering to his wife.	「否、彼は妻との和解の品として鵞鳥を運んでいた。
Remember the card upon the bird's leg."	鳥の足についていたカードを思い出せ」
"You have an answer to everything.	「何に対しても答えを握っているんだな。
But how on earth do you deduce that the gas is not laid on in his house?"	だけど、ガスが家にひかれていないというのはいったい？」
"One tallow stain, or even two, might come by chance;	「獣脂のしみひとつ、あるいはふたつまでは、偶然といってもいい。
but when I see no less than five, I think that there can be little doubt	が、5つもあるようだと、絶対に間違いないね。
that the individual must be brought into frequent contact with burning tallow	この男は燃えさかる獣脂にたびたび触れている
--walks upstairs at night probably with his hat in one hand and a guttering candle in the other.	――たとえば、夜、帽子と獣脂がしたたる蝋燭とを別々の手に持って階段を昇るのかもしれないな。
Anyhow, he never got tallow-stains from a gas-jet.	いずれにせよ、ガス灯から獣脂のしみができることは決してない。
Are you satisfied?"	ご満足いただけましたか？」
"Well, it is very ingenious,"	「うむ、実に見事であった」
said I, laughing;	私は笑いながら言った。
"but since, as you said just now, there has been no crime committed, and no harm done save the loss of a goose, all this seems to be rather a waste of energy."	「だけどさ、さっき君が言ったように、犯罪にはかかわってきていないし、鵞鳥を除けば損害もないし、どっちかというとエネルギーの無駄使いのような気がするね」
Sherlock Holmes had opened his mouth to reply, when the door flew open, and Peterson, the commissionaire, rushed into the apartment	シャーロック・ホームズが口を開きかけたそのとき、いきなりドアが開いて、ピータースン、例の守衛が頬を真っ赤にして飛びこんできた。
with flushed cheeks and the face of a man who is dazed with astonishment.	驚嘆のあまり呆然としたような面持ちである。
"The goose, Mr. Holmes!	「鵞鳥が、ミスター・ホームズ！
The goose, sir!"	鵞鳥が！」
he gasped.	ピータースンは息を喘がせた。
"Eh?	「ん？
What of it, then?	何だ、どうしたんだ？
Has it returned to life and flapped off through the kitchen window?"	鵞鳥が生き返って、キッチンの窓から飛んでいきでもしたのか？」
Holmes twisted himself round upon the sofa to get a fairer view of the man's excited face.	ホームズはソファに座ったまま体をひねると、興奮している男の顔を正面にとらえた。
"See here, sir!	「ほらこれを！
See what my wife found in its crop!"	うちのが餌袋の中からこれを！」
He held out his hand and displayed upon the centre of the palm a brilliantly scintillating blue stone,	ピータースンは手を差し出し、手のひらの中央に煌々と輝く青い石を広げた。
rather smaller than a bean in size, but of such purity and radiance that it twinkled like an electric point in the dark hollow of his hand.	サイズは豆粒よりも小さかったが、その純度と輝度の高さゆえに、ピータースンの手の薄暗いくぼみの中で電光のようにきらめいていた。
Sherlock Holmes sat up with a whistle.	シャーロック・ホームズは口笛を吹いて立ちあがった。
"By Jove, Peterson!"	「ジュピターに誓おう、ピータースン！」
said he,	とホームズ。
"this is treasure trove indeed.	「これはまさしくお宝だよ。
I suppose you know what you have got?"	手に入れたのが何か、分かっているだろうね？」
"A diamond, sir?	「ダイアモンド？
A precious stone.	とにかく貴重な宝石です。
It cuts into glass as though it were putty."	ガラスがまるでパテのように切れるんです」
"It's more than a precious stone.	「単なる貴重な宝石どころじゃないんだよ。
It is the precious stone."	例の貴重な宝石なんだ」
"Not the Countess of Morcar's blue carbuncle!"	「モルカー伯爵婦人のブルー・カーバンクルじゃないか！」
I ejaculated.	私は絶叫した。
"Precisely so.	「そう、まったくそのとおり。
I ought to know its size and shape, seeing that I have read the advertisement about it in The Times every day lately.	ぼくがサイズと形を知っているのも当然だ、こいつに関する広告を連日タイムズで読んでいるからね。
It is absolutely unique, and its value can only be conjectured, but the reward offered of 1000 pounds is certainly not within a twentieth part of the market price."	まったく他に類のない代物で、価値は推測するしかないが、報奨金の千ポンドなど市場価格の20分の1にも届かないだろう」
"A thousand pounds!	「千ポンド！
Great Lord of mercy!"	なんてこった！」
The commissionaire plumped down into a chair and stared from one to the other of us.	守衛は椅子にしりもちをついて、我々をかわるがわる見つめた。
"That is the reward,	「それは賞金だ。
and I have reason to know that there are sentimental considerations in the background which would induce the Countess to part with half her fortune if she could but recover the gem."	そしてあの伯爵婦人は、宝石の背景に思い入れがあって、ただ取り戻すことさえできれば財産の半分でも分け与える気になるのも、ぼくは訳あって知っている」
"It was lost, if I remember aright, at the Hotel Cosmopolitan,"	「紛失したんだ、もし記憶どおりなら、ホテル・コスモポリタンで」
I remarked.	私が言った。
"Precisely so, on December 22d, just five days ago.	「そう、まったくそのとおり、12月22日、ほんの5日前のことだ。
John Horner, a plumber, was accused of having abstracted it from the lady's jewel-case.	配管工のジョン・ホーナーが、伯爵婦人の宝石箱からこれを抜き取ったかどで告発されている。
The evidence against him was so strong that the case has been referred to the Assizes.	その証拠はきわめてはっきりしていたので、事件はすでに巡回裁判の手に委ねられている。
I have some account of the matter here, I believe."	関連記事もあったな、確か」
He rummaged amid his newspapers, glancing over the dates, until at last he smoothed one out, doubled it over, and read the following paragraph:	ホームズは新聞の束から、くまなく日付に目を通していき、やがてその手を止め、最後に見ていた新聞の皺を伸ばし、2つ折りにして以下の記事を読み上げた。
"Hotel Cosmopolitan Jewel Robbery.	「ホテル・コスモポリタン宝石盗難。
John Horner, 26, plumber, was brought up upon the charge of having upon the 22d inst.,	今月22日、配管工ジョン・ホーナー（26）に対する告発が行われた。
abstracted from the jewel-case of the Countess of Morcar the valuable gem known as the blue carbuncle.	モルカー伯爵婦人の宝石箱から、ブルー・カーバンクルとして知られる高価な宝石を抜き取った疑い。
James Ryder, upper-attendant at the hotel, gave his evidence to the effect that he had shown Horner up to the dressing-room of the Countess of Morcar upon the day of the robbery in order that he might solder the second bar of the grate, which was loose.	決め手となった上級係員ジェイムズ・ライダーの証言によると、盗難のあった日、ホーナーをモルカー伯爵婦人の化粧室に通し、なくなっていた端から2本目の暖炉の格子を修繕させた。
He had remained with Horner some little time, but had finally been called away.	しばらくホーナーと部屋に残っていたが、やがて呼び出された。
On returning, he found that Horner had disappeared, that the bureau had been forced open,	部屋に戻ってくると、ホーナーの姿はなく、化粧ダンスがこじあけられていた。
and that the small morocco casket in which, as it afterwards transpired, the Countess was accustomed to keep her jewel, was lying empty upon the dressing-table.	後に判明したところでは、タンスの中にはモロッコ革の小箱があり、伯爵婦人はこの箱を宝石の保管に使用していたのだが、化粧台の上に空になって転がっていた。
Ryder instantly gave the alarm, and Horner was arrested the same evening;	ライダーが即座に通報したため、同日夕方、ホーナーは逮捕されたが、
but the stone could not be found either upon his person or in his rooms.	宝石は、身体からも部屋からも発見されなかった。
Catherine Cusack, maid to the Countess, deposed to having heard Ryder's cry of dismay on discovering the robbery, and to having rushed into the room, where she found matters as described by the last witness.	伯爵夫人のメイド、キャサリン・キュザックの供述によると、ライダーが盗難を知って狼狽する声を聞きつけて部屋に駈けつけたところ、室内の状況は先の証言どおりだったとのことだ。
Inspector Bradstreet, B division, gave evidence as to the arrest of Horner, who struggled frantically, and protested his innocence in the strongest terms.	Ｂ区のブラッドストリート警部は、ホーナーを逮捕したことを認め、容疑者は必死に抵抗し、強い調子で無罪を主張したと語っている。
Evidence of a previous conviction for robbery having been given against the prisoner, the magistrate refused to deal summarily with the offence, but referred it to the Assizes.	容疑者に窃盗の前科があるという証拠から、警察判事は略式起訴を拒否、事件は巡回裁判の手に委ねられた。
Horner, who had shown signs of intense emotion during the proceedings, fainted away at the conclusion and was carried out of court.	ホーナーは、審理中、激しく感情を昂ぶらせる様子を見せたが、決定が下されると気を失って、室外に運び出された。
"Hum!	「ふん！
So much for the police-court,"	警察の仕事はそれでおしまい、と」
said Holmes thoughtfully, tossing aside the paper.	とホームズは考え深げに言って、新聞をかたわらに放り出した。
"The question for us now to solve is the sequence of events leading from a rifled jewel-case at one end to the crop of a goose in Tottenham Court Road at the other.	「今ぼくらが解かねばならないのは、漁られた宝石箱とトテナム・コート・ロードの鵞鳥の餌袋との間に、どういう経緯があるのかという問題だ。
You see, Watson, our little deductions have suddenly assumed a much more important and less innocent aspect.	そうともワトスン、つまらない推理とやらが不意に重要性と犯罪性を高めてきたよ。
Here is the stone;	ここに問題の宝石があり、
the stone came from the goose, and the goose came from Mr. Henry Baker,	宝石は鵞鳥の餌袋から、鵞鳥はミスター・ヘンリー・ベイカーからやってきた。
the gentleman with the bad hat and all the other characteristics with which I have bored you.	そして問題の紳士は、ひどい帽子と、さっき君をうんざりさせてやったような特徴を持っている。
So now we must set ourselves very seriously to finding this gentleman	となると、本気でこの紳士を探し出すしかない。
and ascertaining what part he has played in this little mystery.	そうして、彼がこの小さな謎の中でどんな役割を果たしているのかつきとめるんだ。
To do this, we must try the simplest means first,	それにはまず、いちばん単純な手段からやってみなければならない。
and these lie undoubtedly in an advertisement in all the evening papers.	いちばん単純な手段といえば夕刊の広告に決まっている。
If this fail, I shall have recourse to other methods."	もしこれが失敗したときは、他の手を使ってみることにしよう」
"What will you say?"	「何と言ってやるんだ？」
"Give me a pencil and that slip of paper.	「鉛筆とあそこの紙をとってくれ。
Now, then:	そうだな、
'found At The Corner Of Goodge Street, A Goose And A Black Felt Hat.	『グッジ街の角で鵞鳥と黒いフェルト帽を拾得。
Mr. Henry Baker can have the same	ミスター・ヘンリー・ベイカーへ、申請により同品をお渡しする。
by applying at 6:30 this evening at 221B, Baker Street.'	時間は午後6時半、場所はベイカー街221B』。
That is clear and concise."	これで単純明瞭だ」
"Very.	「まったく。
But will he see it?"	だけどこれを見るかな？」
"Well, he is sure to keep an eye on the papers,	「ま、きっと新聞に目を光らせているよ。
since, to a poor man, the loss was a heavy one.	だって、貧乏人にはさ、耐えがたい損失だからね。
He was clearly so scared by his mischance in breaking the window and by the approach of Peterson that he thought of nothing but flight, but since then he must have bitterly regretted the impulse which caused him to drop his bird.	不運にも窓を割ってしまったり、ピータースンが向かってきたりして、ひどく恐れをなしただろうから、逃げ出すことしか頭になかったんだけど、その後、鳥を置いてきてしまったことをいたく後悔しているに違いない。
Then, again, the introduction of his name will cause him to see it, for everyone who knows him will direct his attention to it.	それに、名前を紹介してやれば目にすることになるよ、彼を知っている人がみんなで広告のことを教えてやるだろうから。
Here you are, Peterson, run down to the advertising agency and have this put in the evening papers."	さあこれを、ピータースン、広告代理店にかけこんで、夕刊に載せてもらうんだ」
"In which, sir?"	「どれに？」
"Oh, in the Globe, Star, Pall Mall, St. James's, Evening News Standard, Echo, and any others that occur to you."	「あー、グローヴ、スター、ポールモール、セントジェイムズ、イヴニングニューズ、スタンダード、エコー、他に思いついたらそれにも」
"Very well, sir.	「わかりました、はい。
And this stone?"	それと、この宝石は？」
"Ah, yes, I shall keep the stone.	「うん、そうだな、その石はぼくが預かるよ。
Thank you.	ありがとう。
And, I say, Peterson, just buy a goose on your way back and leave it here with me,	それと、あのね、ピータースン、ちょっと帰り道に鵞鳥を買って、ここに置いていってくれないか。
for we must have one to give to this gentleman in place of the one which your family is now devouring."	この紳士のために1羽持っておいて、君の家族がたいらげているやつの代わりに渡してやらないと」
When the commissionaire had gone, Holmes took up the stone and held it against the light.	ピータースンが出ていくと、ホームズは宝石を取り上げて、光にかざした。
"It's a bonny thing,"	「見事な代物だな」
said he.	とホームズ。
"Just see how it glints and sparkles.	「見ろよ、この輝きにこの光。
Of course it is a nucleus and focus of crime.	犯罪の核になるのも当然だな。
Every good stone is.	あらゆる貴石がそう。
They are the devil's pet baits.	悪魔が愛用する餌なんだよ。
In the larger and older jewels every facet may stand for a bloody deed.	大きな、古い宝石ほど、一面一面が血塗られているのかもしれない。
This stone is not yet twenty years old.	この石は世に出てまだ20年にもならない。
It was found in the banks of the Amoy River in southem China and is remarkable in having every characteristic of the carbuncle, save that it is blue in shade instead of ruby red.	中国南部のアモイ川の土手で発見され、カーバンクルとしてのあらゆる特徴を持ちながら、青く翳っていて、ルビーのような赤色をしていないという点で注目を集めた。
In spite of its youth, it has already a sinister history.	まだ世に出て日が浅いというのに、すでに不吉な経歴を持っている。
There have been two murders,	殺人2回。
a vitriol-throwing,	硫酸騒動1回。
a suicide,	自殺1回。
and several robberies	窃盗数回。
brought about for the sake of this forty-grain weight of crystallized charcoal.	これだけの事件が、この重さ40グレインの透きとおった炭のために起きている。
Who would think that so pretty a toy would be a purveyor to the gallows and the prison?	こんな可憐なおもちゃが、絞首台と刑務所の御用商人だなんて、誰も考えまい。
I'll lock it up in my strong box now and drop a line to the Countess to say that we have it."	さ、金庫の中に閉じ込めて、ぼくらの手元にあると伯爵婦人に一筆したためよう」
"Do you think that this man Horner is innocent?"	「この男、ホーナーは無罪だと考えるのかい？」
"I cannot tell."	「さあね」
"Well, then, do you imagine that this other one, Henry Baker, had anything to do with the matter?"	「それじゃあさ、もうひとりの男、ヘンリー・ベイカーは何か関係があると思う？」
"It is, I think, much more likely that Henry Baker is an absolutely innocent man,	「ぼくの考えでは、ヘンリー・ベイカーは無関係な人物という可能性がきわめて高い。
who had no idea that the bird which he was carrying was of considerably more value than if it were made of solid gold.	この男は、自分が運んでいる鳥が純金製の鳥よりもはるかに価値があるのに、それを知らなかった。
That, however, I shall determine by a very simple test if we have an answer to our advertisement."	まあそれはね、広告に反応があったときにごく簡単なテストをして決めるつもりだけど」
"And you can do nothing until then?"	「じゃあ、それまで何もできないと？」
"Nothing."	「なんにもね」
"In that case I shall continue my professional round.	「だったら、ぼくは往診の続きをやる。
But I shall come back in the evening at the hour you have mentioned,	でも、夕方、例の時間には戻ってくるよ。
for I should like to see the solution of so tangled a business."	もつれからまる事件の解決を目の当たりにしたいからね」
"Very glad to see you.	「喜んでお迎えしますとも。
I dine at seven.	ここの夕食は7時。
There is a woodcock, I believe.	山鴫だよ、きっと。
By the way, in view of recent occurrences, perhaps I ought to ask Mrs. Hudson to examine its crop."	そうか、近頃の風潮を考えると、ミセス・ハドスンにそいつの餌袋を調べてくれと頼んでおくべきかな」
I had been delayed at a case, and it was a little after half-past six when I found myself in Baker Street once more.	ある件に時間がかかってしまい、再びベイカー街にもどってきたときは、6時半を少し回っていた。
As I approached the house I saw a tall man in a Scotch bonnet with a coat which was buttoned up to his chin waiting outside in the bright semicircle which was thrown from the fanlight.	家に近づくと、外でスコッチ帽をかぶった背の高い男が、コートのボタンを顎のところまで閉め、窓からこぼれる半円形の光の中でドアが開くのを待っているのが見えた。
Just as l arrived the door was opened, and we were shown up together to Holmes's room.	ちょうど私がついたときにドアが開き、我々は同時にホームズの部屋に姿を現した。
"Mr. Henry Baker, I believe,"	「ミスター・ヘンリー・ベイカー、ですね」
said he, rising from his armchair and greeting his visitor	ホームズが肱掛椅子から立ちあがり、リラックスした優しげな雰囲気で挨拶をした。
with the easy air of geniality which he could so readily assume.	ホームズはすばやくこの雰囲気をつくることができるのだ。
"Pray take this chair by the fire, Mr. Baker.	「どうぞ暖炉のそばの椅子に、ミスター・ベイカー。
It is a cold night, and I observe that your circulation is more adapted for summer than for winter.	今日は冷えますし、どうやら、顔色からお察しして、冬よりも夏のほうが楽なのでしょう？
Ah, Watson, you have just come at the right time.	やあワトスン、時間ぎりぎりにきたんだね。
Is that your hat, Mr. Baker?"	……さて、あれはあなたの帽子ですか、ミスター・ベイカー？」
"Yes, sir,	「そうです。
that is undoubtedly my hat."	間違いなく私の帽子です」
He was a large man with rounded shoulders, a massive head, and a broad, intelligent face, sloping down to a pointed beard of grizzled brown.	ヘンリー・ベイカーは肩の丸い大柄な男で、頭が大きく、広々とした知性的な顔立ちをしており、先の尖った茶色い顎鬚には白いものがまじっている。
A touch of red in nose and cheeks, with a slight tremor of his extended hand, recalled Holmes's surmise as to his habits.	鼻と頬にはやや赤みがさし、伸ばした手を微妙に震わせているあたりが、彼の習慣に関するホームズの推測を思い起こさせた。
His rusty black frock-coat was buttoned right up in front, with the collar turned up,	色あせた黒いフロックコートのボタンをすっかり留めて、襟を立てている。
and his lank wrists protruded from his sleeves without a sign of cuff or shirt.	袖口からのぞくやせた手首を見ると、カフスをつけていたり、ワイシャツを着ていたりするようすはない。
He spoke in a slow staccato fashion, choosing his words with care, and gave the impression generally of a man of learning and letters who had had ill-usage at the hands of fortune.	慎重に言葉を選びつつ、ゆっくりと途切れ途切れに話したが、全体として、学問や教養のある人間であり、運命の手に翻弄されてきた男なのだという印象を受けた。
"We have retained these things for some days,"	「しばらくお預かりしていました」
said Holmes,	とホームズ。
"because we expected to see an advertisement from you giving your address.	「持ち主が広告を出して住所を教えてくれるだろうと思っていましたから。
I am at a loss to know now why you did not advertise."	よく分かりませんね、どうして広告を出さなかったんですか？」
Our visitor gave a rather shamefaced laugh.	客人はやや恥ずかしそうに笑った。
"Shillings have not been so plentiful with me as they once were,"	「何シリングというのはけっこうな額ですから。昔と違って」
he remarked.	とベイカー。
"I had no doubt that the gang of roughs who assaulted me had carried off both my hat and the bird.	「私を襲った乱暴な連中が帽子も鳥も持っていったんだと思っていました。
I did not care to spend more money in a hopeless attempt at recovering them."	見つかるあてのないものにこれ以上金を失いたくなかったんです」
"Very naturally.	「なるほど、ごもっともです。
By the way, about the bird, we were compelled to eat it."	そうそう、鳥のことですが、やむをえず食べてしまいました」
"To eat it!"	「食べてしまった！」
Our visitor half rose from his chair in his excitement.	客人は興奮して椅子から腰を浮かした。
"Yes, it would have been of no use to anyone had we not done so.	「はい、そうしないと無駄になってしまったでしょう。
But I presume that this other goose upon the sideboard, which is about the same weight and perfectly fresh, will answer your purpose equally well?"	ですが、どうでしょう、ここの食器棚の上にある鵞鳥なら、重さも同じくらいで申し分ない鮮度ですから、あなたの目的にも沿えますよね？」
"Oh, certainly, certainly,"	「ああ、もちろんです、もちろんですとも」
answered Mr. Baker with a sigh of relief.	ミスター・ベイカーは安堵のため息を漏らした。
"Of course, we still have the feathers, legs, crop, and so on of your own bird, so if you wish--"	「もちろん、まだ羽根や足や餌袋などは残してありますから、もしお望みでしたら――」
The man burst into a hearty laugh.	男は腹の底からの笑い声を轟かせた。
"They might be useful to me as relics of my adventure,"	「我が冒険の記念物として役に立つかもしれませんね」
said he,	とベイカー。
"but beyond that I can hardly see what use the disjecta membra of my late acquaintance are going to be to me.	「ですが、それ以上、この知人の悼ましき遺骸の使い道はなさそうです。
No, sir, I think that, with your permission, I will confine my attentions to the excellent bird which I perceive upon the sideboard."	いえいえ、私としては、食器棚の上に見えるあのすばらしい鳥の世話だけさせていただきたく思います」
Sherlock Holmes glanced sharply across at me with a slight shrug of his shoulders.	シャーロック・ホームズはすばやく私と目を交わし、肩をすくめた。
"There is your hat, then, and there your bird,"	「帽子はそこに、それから、鳥はあそこにあります」
said he.	とホームズ。
"By the way, would it bore you to tell me where you got the other one from?	「ところで、どこであの、最初の鵞鳥を手に入れたのか教えていただくわけにはいきませんか？
I am somewhat of a fowl fancier,	私も多少鳥にはうるさくて。
and I have seldom seen a better grown goose."	それに、あれ以上に見事に育った鵞鳥なんてそうそう目にしません」
"Certainly, sir,"	「もちろん、かまいませんとも」
said Baker, who had risen and tucked his newly gained property under his arm.	と言うとベイカーは、立ちあがって新たに獲得した財産を脇に抱え込んだ。
"There are a few of us who frequent the Alpha Inn, near the Museum	「私はよく、同僚たちと博物館に近いアルファ・インで飲むんです
--we are to be found in the Museum itself during the day,	――ええ、日中は博物館の中にいますよ。
you understand.	お分かりですか。
This year our good host, Windigate by name, instituted a goose club, by which, on consideration of some few pence every week, we were each to receive a bird at Christmas.	今年、そこの親父さんが、ウィンディゲイトという名前なんですが、鵞鳥クラブなるものをこしらえまして、それで、毎週数ペンス積み立てるだけで、クリスマスに鵞鳥が1羽ずつ手に入るというんです。
My pence were duly paid, and the rest is familiar to you.	私はきちんと支払いました、後のことはそちらもよくご存知でしょう。
I am much indebted to you, sir,	非常に助かりました。
for a Scotch bonnet is fitted neither to my years nor my gravity."	スコッチ帽は似合いませんからね、齢にも、重みにも」
With a comical pomposity of manner he bowed solemnly to both of us and strode off upon his way.	そう言うと、滑稽なほど大げさな態度で我々におじぎをし、大股で部屋から出ていった。
"So much for Mr. Henry Baker,"	「ミスター・ヘンリー・ベイカーについては以上」
said Holmes when he had closed the door behind him.	とホームズが、ドアを後ろ手に閉めて言った。
"It is quite certain that he knows nothing whatever about the matter.	「あの男が事件についてなんにも知らないのはまったく疑いの余地もない。
Are you hungry, Watson?"	腹は減っているかい、ワトスン？」
"Not particularly."	「特には」
"Then I suggest that we turn our dinner into a supper and follow up this clew while it is still hot."	「じゃあ、夕食を夜食に変更して、今のうちに、この手がかりをとことん追ってみないか」
"By all means."	「ぜひそうしよう」
It was a bitter night,	身を刺すような夜だった。
so we drew on our ulsters and wrapped cravats about our throats.	我々は外套をまとい、首にマフラーを巻いて出た。
Outside, the stars were shining coldly in a cloudless sky, and the breath of the passers-by blew out into smoke like so many pistol shots.	外では、雲ひとつない空の下で星々が冷たく輝いており、道行く人々の息は白い煙となって吹きちぎれ、まるで銃を乱射しているかのようだった。
Our footfalls rang out crisply and loudly as we swung through the doctors' quarter, Wimpole Street, Harley Street, and so through Wigmore Street into Oxford Street.	我々の乾いた足音が、医療区、ウィンポール街、ハーレー街を通り、ウィグモア街を抜け、オクスフォード街へと響き渡っていった。
In a quarter of an hour we were in Bloomsbury at the Alpha Inn, which is a small public-house at the corner of one of the streets which runs down into Holborn.	15分後に、ブルームスバリーのアルファ・インという、ホールボーン街に下る通りの角に建てられた小さな酒場にたどりついた。
Holmes pushed openthe door of the private bar and ordered two glasses of beer from the ruddy-faced, white-aproned landlord.	ホームズはドアを押し開けると、白いエプロンをした赤ら顔の主人にビールを2杯頼んだ。
"Your beer should be excellent if it is as good as your geese,"	「ビールもすばらしいんだろうね、ここの鵞鳥みたいに」
said he.	とホームズ。
"My geese!"	「ここの鵞鳥？」
The man seemed surprised.	男は驚いたようだ。
"Yes.	「うん。
I was speaking only half an hour ago to Mr. Henry Baker,	ほんの30分前にミスター・ヘンリー・ベイカーとお話ししてたんだよ。
who was a member of your goose club."	鵞鳥クラブのメンバーの」
"Ah!	「あ！
yes, I see.	そうです、分かりました。
But you see, sir, them's not our geese."	でもお分かりでしょう、あれはここのじゃないんですよ」
"Indeed!	「そうなのか！
Whose, then?"	じゃあ、どこのやつ？」
"Well, I got the two dozen from a salesman in Covent Garden."	「ええっと、コヴェント・ガーデンの販売員から2ダース仕入れましたよ」
"Indeed?	「そう？
I know some of them.	知ってる販売員もいるんだけどな。
Which was it?"	どこだったんだろう？」
"Breckinridge is his name."	「ブリッキンリッジっていう人なんですが」
"Ah!	「うーん、
I don't know him.	その人は知らないな。
Well, here's your good health landlord, and prosperity to your house.	さ、ご主人の健康と店の繁盛に、乾杯。
Good-night.	おやすみなさい」
"Now for Mr. Breckinridge,"	「お次はミスター・ブリッキンリッジだ」
he continued, buttoning up his coat as we came out into the frosty air.	凍えるような空の下に出て、コートのボタンをとめながら、ホームズは続けた。
"Remember, Watson	「忘れないでくれよ、ワトスン。
that though we have so homely a thing as a goose at one end of this chain, we have at the other a man who will certainly get seven years' penal servitude	ぼくらが握っているこの鎖、片端は鵞鳥というほのぼのしたものだけど、その逆の端には確実に7年の懲役を受ける男が繋がれているんだ。
unless we can establish his innocence.	ぼくらがその無罪を立証してやらないかぎり。
It is possible that our inquiry may but confirm his guilt but, in any case, we have a line of investigation which has been missed by the police, and which a singular chance has placed in our hands.	ぼくらの捜査も彼の有罪を確かめるだけに終わるかもしれないけど、ともかく、我々がつかんだ線は、警察が見逃している、まったくの偶然からぼくらの手に飛びこんできたものなんだ。
Let us follow it out to the bitter end.	徹底的にやってやろうじゃないか、最後の最後まで。
Faces to the south, then, and quick march!"	南向け南、早足進め！」
We passed across Holborn, down Endell Street, and so through a zigzag of slums to Covent Garden Market.	ホルボーン街を横切り、エンデル街をくだり、曲がりくねったスラムを抜けてコヴェントガーデン市場に出た。
One of the largest stalls bore the name of Breckinridge upon it, and the proprietor a horsy-looking man, with a sharp face and trim side-whiskers was helping a boy to put up the shutters.	規模としては最大級の露店の仕切りにブリッキンリッジという名前がくりぬかれており、整えられた頬髯と彫りの深い顔をした馬のような持ち主が、シャッターを下ろそうとしている下働きを手伝っていた。
"Good-evening.	「こんばんは。
It's a cold night,"	今日の夜は冷えるね」
said Holmes.	とホームズ。
The salesman nodded and shot a questioning glance at my companion.	男はうなずきながら、詮索するような視線をホームズに投げかけた。
"Sold out of geese,	「鵞鳥は売りきれ、か。
I see,"	なるほど」
continued Holmes, pointing at the bare slabs of marble.	ホームズは、むきだしになっている大理石の石板を指差した。
"Let you have five hundred to-morrow morning."	「明日の朝なら500羽でも用立てるよ」
"That's no good."	「それじゃあだめなんだ」
"Well, there are some on the stall with the gas-flare."	「たぶん、あのガスの灯りがついている露店にはまだあるけど」
"Ah, but I was recommended to you."	「うーん、だけど君のところをすすめられたんだよ」
"Who by?"	「誰から？」
"The landlord of the Alpha."	「アルファの主人から」
"Oh, yes;	「ああ、なるほど。
I sent him a couple of dozen."	あそこには2ダース届けたな」
"Fine birds they were, too.	「すばらしい鳥だったね、あれも。
Now where did you get them from?"	ところで、あれはどこから仕入れたんだい？」
To my surprise the question provoked a burst of anger from the salesman.	驚いたことに、この質問は販売員の激しい怒りを買ったらしい。
"Now, then, mister,"	「なあ、ちょっとあんた」
said he, with his head cocked and his arms akimbo,	男は顔を起こし、両手を腰に当てた。
"what are you driving at?	「なんのつもりだ？
Let's have it straight, now."	はっきりさせようじゃないか」
"It is straight enough.	「十分はっきりしているよ。
I should like to know who sold you the geese which you supplied to the Alpha."	アルファに卸したあの鵞鳥を売ったのは誰なのか、知りたいんだよ」
"Well then, I shan't tell you.	「ああなるほど、じゃあ教えるつもりはない。
So now!"	ほら行った！」
"Oh, it is a matter of no importance;	「んー、たいしたことじゃないのにな。
but I don't know why you should be so warm over such a trifle."	でも、こんなつまらないことに、なんでそう熱くなるんだい」
"Warm!	「熱いって！
You'd be as warm, maybe, if you were as pestered as I am.	あんただって熱くなるさ、こんなにしつこく尋ねられれば。
When I pay good money for a good article	十分な金を出し、いい品を仕入れる。
there should be an end of the business;	そこで取引は終わりってもんだ。
but it's 'Where are the geese?' and 'Who did you sell the geese to?' and 'What will you take for the geese?'	『あの鵞鳥、どこだ？』だの『あの鵞鳥、誰に売った？』だの『あの鵞鳥、いくらで売る？』だの。
One would think they were the only geese in the world, to hear the fuss that is made over them."	あれが世界で唯一の鵞鳥どもなんだろうよ、連中の騒ぎ方といったら」
"Well, I have no connection with any other people who have been making inquiries,"	「なるほど、でもぼくは誰とも関係ないよ、前に尋ねてきた人の誰とも」
said Holmes carelessly.	とホームズはのんきに言った。
"If you won't tell us the bet is off, that is all.	「教えて貰えなければ賭けが流れる、それだけのこと。
But I'm always ready to back my opinion on a matter of fowls, and I have a fiver on it that the bird I ate is country bred."	鳥についての意見にはいつでも賭ける覚悟があってね、それで5ポンド、こないだ食べた
"Well, then, you've lost your fiver, for it's town bred,"	「ああ、じゃああんたは5ポンドなくしたよ、あれは街の鳥だ」
snapped the salesman.	男は手厳しい調子で答えた。
"It's nothing of the kind."	「そんなんじゃないだろう」
"I say it is."	「そうだって」
"I don't believe it."	「信じないね」
"D'you think you know more about fowls than I, who have handled them ever since I was a nipper?	「オレより鳥のことに詳しいっていうのかい、ガキのころから鳥を扱ってきたこのオレよりも？
I tell you, all those birds that went to the Alpha were town bred."	絶対、アルファにやった鳥は全部街育ちだよ」
"You'll never persuade me to believe that."	「いくら言われても信じないよ」
"Will you bet, then?"	「じゃあ、賭けるか？」
"It's merely taking your money, for I know that I am right.	「君の金をとってしまうだけだよ、こっちが正しいって知っているんだから。
But I'll have a sovereign on with you, just to teach you not to be obstinate."	よし、1ソヴリン貰おうか、君に強情はよくないって教えてやろう」
The salesman chuckled grimly.	男は薄笑いを浮かべた。
"Bring me the books, Bill," said he.	「帳簿を持ってこい、ビル」
The small boy brought round a small thin volume and a great greasy-backed one, laying them out together beneath the hanging lamp.	小さな少年が小さな薄い帳簿と、背表紙の脂ぎった帳簿とを持ってきて、ぶらさがっているランプの下にまとめて置いた。
"Now then, Mr. Cocksure,"	「さあ、うぬぼれ屋さん」
said the salesman,	と男は言った。
"I thought that I was out of geese, but before I finish you'll find that there is still one left in my shop.	「鵞鳥は切らしてしまったと思っていたがね、あんた、最後までお目にかける前に、店の中に1匹残っているのを見つけそうだ。
You see this little book?"	この小さな帳簿は分かるね？」
"Well?"	「で？」
"That's the list of the folk from whom I buy.	「仕入先のリストだよ。
D'you see?	分かるね？
Well, then, here on this page are the country folk, and the numbers after their names are where their accounts are in the big ledger.	さあ、それでは、このページが田舎の仕入先でございますよ、名前の後ろにある数字は、大きい方の台帳のどこに明細を載せているか、でございます。
Now, then!	さあ次は！
You see this other page in red ink?	この赤いインクで書かれたページは分かるね？
Well, that is a list of my town suppliers.	これが街中の仕入先のリスト。
Now, look at that third name.	さあ、3番目の名前を。
Just read it out to me."	ちょっと読み上げていただきましょうか」
"Mrs. Oakshott, 117, Brixton Road--249,"	「ミセス・オークショット、ブリクストン街117――249」
read Holmes.	ホームズが読み上げた。
"Quite so.	「よくできました。
Now turn that up in the ledger."	台帳に移りましょうか」
Holmes turned to the page indicated.	ホームズは指示されているページを開いた。
"Here you are, 'Mrs. Oakshott, 117, Brixton Road, egg and poultry supplier."	「ここだね、『ミセス・オークショット、ブリクストン街117、鶏卵・鶏肉』」
"Now, then, what's the last entry?"	「ではでは、最後の取引は？」
"'December 22d. Twenty-four geese at 7s. 6d.'"	「『12月22日、鵞鳥24、7シリング6ペンス』」
"Quite so.	「よくできました。
There you are. And underneath?"	その下には？」
"'Sold to Mr. Windigate of the Alpha, at 12s.'"	「『売却、アルファのミスター・ウィンゲート、12シリング』」
"What have you to say now?"	「他に言うことがあるかい？」
Sherlock Holmes looked deeply chagrined.	シャーロック・ホームズはひどく悔しそうに見えた。
He drew a sovereign from his pocket and threw it down upon the slab, turning away with the air of a man whose disgust is too deep for words.	ソヴリン金貨を1枚、ポケットから取り出して仕切りに叩き付け、口もききたくないといった雰囲気で、店から離れていった。
A few yards off he stopped under a lamp-post and laughed in the hearty,	数ヤード離れた街灯の下で立ち止まり、心の底から笑った。
noiseless fashion which was peculiar to him.	声を立てない、ホームズ特有の笑い方で。
"When you see a man with whiskers of that cut and the 'Pink 'un' protruding out of his pocket, you can always draw him by a bet,"	「頬髯をああカットして、ポケットから『ピンカン』（競馬新聞、らしい）を覗かせている男に会ったときはね、いつだって賭けで吊れるものだよ」
said he.	とホームズ。
"I daresay that if I had put 100 pounds down in front of him, that man would not have given me such complete information as was drawn from him by the idea that he was doing me on a wager.	「おそらく、目の前に100ポンド積まれても、あの男はこれほど、ぼくとささやかな賭けをしているときほどには、完璧な情報を教えてくれなかっただろうな。
Well, Watson, we are, I fancy, nearing the end of our quest,	さ、ワトスン、きっと、ぼくらの探索も終わりに近づいてきた。
and the only point which remains to be determined is whether we should go on to this Mrs. Oakshott to-night, or whether we should reserve it for to-morrow.	あと決めなきゃいけないのは、今夜、ミセス・オークショットに会いに行くべきか、それとも明日にとっておくべきか、それだけだ。
It is clear from what that surly fellow said that there are others besides ourselves who are anxious about the matter, and I should--"	この問題を気にかけている人間が他にいるってあの男は言っていたから、ぼくとしては――」
His remarks were suddenly cut short by a loud hubbub which broke out from the stall which we had just left.	その言葉は不意に、ちょうど今出てきた露店から聞こえてきた大きな騒音によって途切れた。
Turning round we saw a little rat-faced fellow standing in the centre of the circle of yellow light which was thrown by the swinging lamp, while Breckinridge, the salesman, framed in the door of his stall, was shaking his fists fiercely at the cringing figure.	振り返ると、街灯が照らす黄色い灯りの中央に、鼠顔の小男が立っておfり、一方、ブリッキンリッジが露店の戸口に立ちはだかって、すくみ上がった人影に向かって拳をわななかせている。
"I've had enough of you and your geese,"	「あんたも、あんたの鵞鳥とやらももうたくさんだ！」
he shouted.	とブリッキンリッジが叫んだ。
"I wish you were all at the devil together.	「あんたらみんな、揃って悪魔に食われちまえ！
If you come pestering me any more with your silly talk I'll set the dog at you.	まだしつこく馬鹿馬鹿しい話を聞かせようってんなら、犬をけしかけるぞ！
You bring Mrs. Oakshott here and I'll answer her,	ミセス・オークショットを連れてきてみろ、あの人になら答えてやるとも。
but what have you to do with it?	だがあんたになんの関係がある？
Did I buy the geese off you?"	あんたがあの鵞鳥どもを売ってくれたってのか？」
"No;	「違います、
but one of them was mine all the same,"	でも1羽は本当に私のものだったんです」
whined the little man.	と小男が哀れな声を出した。
"Well, then, ask Mrs. Oakshott for it."	「だったらミセス・オークショットに聞いてこい」
"She told me to ask you."	「あの人はあなたに聞けって」
"Well, you can ask the King of Proosia, for all I care.	「じゃあプロシアの王さまにでも聞くんだな、知ったことか。
I've had enough of it.	もうたくさんだ。
Get out of this!"	とっとと失せろ！」
He rushed fiercely forward, and the inquirer flitted away into the darkness.	ブリッキンリッジが威勢よく足を踏み出したので、相手はあわてて暗闇の中へ逃げ去っていった。
"Ha!	「ほう！
this may save us a visit to Brixton Road,"	こいつはブリクストン街を訪ねる手間が省けたよ」
whispered Holmes.	とホームズが囁いた。
"Come with me, and we will see what is to be made of this fellow."	「ついてきてくれ、この人物から何が分かるか確かめよう」
Striding through the scattered knots of people who lounged round the flaring stalls, my companion speedily overtook the little man and touched him upon the shoulder.	明々とした露店回りの群集を大股ですり抜けたホームズは、すぐにその小男に追いついて軽く肩を叩いた。
He sprang round, and I could see in the gas-light that every vestige of color had been driven from his face.	男が驚いて振り返り、あらゆる色の影を失った顔がガス灯に照らし出された。
"Who are you, then?	「どちらさまですか？
What do you want?"	ご用は？」
he asked in a quavering voice.	男は震える声で尋ねた。
"You will excuse me,"	「すみません」
said Holmes blandly,	ホームズは暖かい声で答えた。
"but I could not help overhearing the questions which you put to the salesman just now.	「あの店員とのやりとりが、ふと耳に入ってきたものですから。
I think that I could be of assistance to you."	ひょっとしたらお役に立てるかもしれません」
"You?	「あなたが？
Who are you?	どちらさまですか？
How could you know anything of the matter?"	このことを何か知っているんですか？どうして？」
"My name is Sherlock Holmes.	「私はシャーロック・ホームズといいます。
It is my business to know what other people don't know."	人が知らないことを知る、それが私の仕事です」
"But you can know nothing of this?"	「でも、このことは何も知らないはずですけど？」
"Excuse me, I know everything of it.	「すみません、すべてを知っているんですよ。
You are endeavoring to trace some geese which were sold by Mrs. Oakshott, of Brixton Road, to a salesman named Breckinridge, by him in turn to Mr. Windigate, of the Alpha, and by him to his club, of which Mr. Henry Baker is a member."	あなたが探している鵞鳥は、ブリクストン街のミセス・オークショットから売りに出され、ブリッキンリッジという名の販売員が買い取り、そこからアルファのミスター・ウィンディゲイトの手に移り、そして、あそこのクラブのメンバー、ミスター・ヘンリー・ベイカーに渡されました」
"Oh, sir, you are the very man whom I have longed to meet,"	「ああ、あなたが、あなたこそまさにずっと私が探していたような方です」
cried the little fellow with outstretched hands and quivering fingers.	小男は両手を差し伸べ、指先を震わせながら叫んだ。
"I can hardly explain to you how interested I am in this matter."	「口では説明できません、この問題がどれほど大事かなんて」
Sherlock Holmes hailed a four-wheeler which was passing.	シャーロック・ホームズは通りかかった四輪馬車を呼びとめた。
"In that case we had better discuss it in a cosy room	「どちらかと言えば、心地よい部屋の方がゆっくりお話できるでしょうね。
rather than in this wind-swept market-place,"	この吹きさらしの市場よりも」
said he.	とホームズ。
"But pray tell me, before we go farther,	「でもその前に、どうか教えてください。
who it is that I have the pleasure of assisting."	私はどなたをお助けしようとしているんですか？」
The man hesitated for an instant.	男は一瞬ためらった。
"My name is John Robinson,"	「私はジョン・ロビンソンといいます」
he answered with a sidelong glance.	と、横目でうかがいながら答えた。
"No, no;	「いえいえ、
the real name,"	本名をね」
said Holmes sweetly.	とホームズが優しく言った。
"It is always awkward doing business with an alias."	「偽名で仕事をするのは非常にやりづらいものですよ」
A flush sprang to the white cheeks of the stranger.	見知らぬ男の白い頬に赤みが走った。
"Well then,"	「ええ、では」
said he,	と彼。
"my real name is James Ryder."	「本名はジェイムズ・ライダーです」
"Precisely so.	「そう、まったくそのとおりです。
Head attendant at the Hotel Cosmopolitan.	ホテル・コスモポリタンの係員長。
Pray step into the cab, and I shall soon be able to tell you everything which you would wish to know."	どうか馬車にお乗りください、お望みの件はすべて教えて差し上げましょう」
The little man stood glancing from one to the other of us	小男は我々をすばやく見比べた。
with half-frightened, half-hopeful eyes, as one who is not sure whether he is on the verge of a windfall or of a catastrophe.	なかば恐怖し、なかば希望を抱くその瞳は、自分が破局の縁にいるのか、幸運の麓にいるのか判断しかねているようすだった。
Then he stepped into the cab, and in half an hour we were back in the sitting-room at Baker Street.	そして、彼は馬車に乗りこみ、30分後、我々はベイカー街の部屋に戻ってきた。
Nothing had been said during our drive, but the high, thin breathing of our new companion, and the claspings and unclaspings of his hands, spoke of the nervous tension within him.	馬車の中では一言も発せられなかったが、ホームズの、高鳴ったか細い呼吸や、閉じたり開いたりする両手が、彼の精神的な昂ぶりを物語っていた。
"Here we are!"	「つきましたよ！」
said Holmes cheerily as we filed into the room.	我々が部屋に入ると、ホームズは陽気な声を上げた。
"The fire looks very seasonable in this weather.	「こんな日には暖炉がきわめてふさわしく見えますね。
You look cold, Mr. Ryder.	寒いんですか、ミスター・ライダー。
Pray take the basket-chair.	どうぞ、あの肱掛椅子に。
I will just put on my slippers before we settle this little matter of yours.	スリッパに履き替えます、それからあなたのささやかな問題を解決しましょう。
Now, then!	よし、では！
You want to know what became of those geese?"	あの鵞鳥たちがどうなったのか、知りたいのですね？」
"Yes, sir."	「ええ、そうです」
"Or rather, I fancy, of that goose.	「つまり、もっと正確に言えば、きっと、あの鵞鳥のことを。
It was one bird, I imagine in which you were interested	ただ1羽の鳥です、あなたが関心を持っているやつは。
--white, with a black bar across the tail."	そう――白くて、尻尾に黒い線が入っているような」
Ryder quivered with emotion.	ライダーは興奮に身を震わせ、
"Oh, sir,"	「おお！」
he cried,	と叫んだ。
"can you tell me where it went to?"	「教えてください、あれはどこへ行ってしまったのです？」
"It came here."	「ここにきました」
"Here?"	「ここに？」
"Yes,	「ええ。
and a most remarkable bird it proved.	なるほど、じつに忘れがたい鳥でしたよ。
I don't wonder that you should take an interest in it.	関心をお寄せになるのも当然です、なんの不思議もありません。
It laid an egg after it was dead	死後、卵を一つ生みましたよ
--the bonniest, brightest little blue egg that ever was seen.	――今まで見た中で、もっとも堅く、もっとも鮮やかな、青い小さな卵をね。
I have it here in my museum."	ここにある私のささやかな博物館に収めてあります」
Our visitor staggered to his feet and clutched the mantelpiece with his right hand.	客人はよろよろと立ちあがり、右手でマントルピースを掴んだ。
Holmes unlocked his strong-box and held up the blue carbuncle, which shone out like a star, with a cold brilliant, many-pointed radiance.	ホームズが小さな金庫の鍵を外し、ブルー・カーバンクルを掲げると、宝石はまるで星のように多面的な輝きと玲瓏なきらめきを放った。
Ryder stood glaring with a drawn face, uncertain whether to claim or to disown it.	立ったまま、食い入るように見つめるライダーの顔は、手を伸ばすか、しらばっくれるか、どちらにすべきか分からないという面持ちだ。
"The game's up, Ryder,"	「終わったよ、ライダー」
said Holmes quietly.	とホームズが静かに言った。
"Hold up, man, or you'll be into the fire!	「しっかりしろ、おい、暖炉の中に落ちるぞ！
Give him an arm back into his chair, Watson.	腕を貸して椅子に座らせるんだ、ワトスン。
He's not got blood enough to go in for felony with impunity.	罪をしらばっくれるには血の巡りが悪すぎるな。
Give him a dash of brandy.	ブランデーをやってくれ。
So!	そうだ。
Now he looks a little more human.	少しは人間らしくなった。
What a shrimp it is, to be sure!"	つまらないやつだ、まったく！」
For a moment he had staggered and nearly fallen, but the brandy brought a tinge of color into his cheeks, and he sat staring with frightened eyes at his accuser.	ライダーは、少しの間、いまにも倒れそうにふらついたが、ブランデーのおかげで頬に血の気がさし、座り込んだまま告発人を恐怖の眼差しで見つめた。
"I have almost every link in my hands, and all the proofs which I could possibly need, so there is little which you need tell me.	「大筋は分かっているし、必要になりそうな証拠も全部握っているから、きみから聞く必要のある話はほとんどない。
Still, that little may as well be cleared up to make the case complete.	それでも、そのほとんどない話を聞いて事件を完璧に整理しておくのもいいな。
You had heard, Ryder, of this blue stone of the Countess of Morcar's?"	聞いていたんだろう、ライダー、モーカー伯爵婦人の青い宝石のことを？」
"It was Catherine Cusack who told me of it,"	「教えてくれたのはキャサリン・キュザックです」
said he in a crackling voice.	ライダーはひび割れた声で言った。
"I see	「なるほど
--her ladyship's waiting-maid.	――レディに仕えるメイドからか。
Well, the temptation of sudden wealth so easily acquired was too much for you,	簡単に富が手に入るという降ってわいたような誘惑にきみは耐えられなかった。
as it has been for better men before you;	もっと立派な人たちでも、たとえばぼくらだってそうかもしれない。
but you were not very scrupulous in the means you used.	だが、やり方が実に汚い。
It seems to me, Ryder, that there is the making of a very pretty villain in you.	ぼくはな、ライダー、きみの中にきわめてひどい悪党の姿を認めるね。
You knew that this man Horner, the plumber, had been concerned in some such matter before, and that suspicion would rest the more readily upon him.	きみはこの、配管工ホーナーが以前、同種の事件に関わったことがあり、容疑が彼のほうにこそ向けられやすいことを知っていた。
What did you do, then?	そして、君は何をやってくれたんだ、ええ？
You made some small job in my lady's room	レディの部屋にちょっとした細工をして
--you and your confederate Cusack	――キュザックと共謀したんだな
--and you managed that he should be the man sent for.	――この男を送りこんでのけた。
Then, when he had left, you rifled the jewel-case, raised the alarm, and had this unfortunate man arrested.	そして彼が出ていった後に宝石箱を荒し、警察に通報してこの不運な男を逮捕させた。
You then--"	それから――」
Ryder threw himself down suddenly upon the rug and clutched at my companion's knees.	ライダーは絨毯の上に身を投げだし、ホームズの膝にすがった。
"For God's sake, have mercy!"	「お願いです、どうかご慈悲を！」
he shrieked.	金切り声。
"Think of my father!	「父を思いやってください、
of my mother!	母を思いやってください！
It would break their hearts.	2人とも心を痛めることでしょう。
I never went wrong before!	悪事を働いたのはこれがはじめてなんです！
I never will again.	もう二度といたしません、
I swear it.	誓います。
I'll swear it on a Bible.	聖書に誓います。
Oh, don't bring it into court!	どうか、裁判だけは！
For Christ's sake, don't!"	頼みますから、連れていかないでください！」
"Get back into your chair!"	「椅子にもどれ！」
said Holmes sternly.	とホームズは厳しく言い放った。
"It is very well to cringe and crawl now, but you thought little enough of this poor Horner in the dock for a crime of which he knew nothing."	「はいつくばって尻尾を振るのも結構、だが、かわいそうに、身に覚えのない罪で繋がれているホーナーのことをちっとも考えてないんだな」
"I will fly, Mr. Holmes.	「消えます、ミスター・ホームズ、
I will leave the country, sir.	この国を出ましょう。
Then the charge against him will break down."	そうすれば告発は崩れます」
"Hum!	「はん！
We will talk about that.	それは僕らが決めてやる。
And now let us hear a true account of the next act.	とりあえず、そこからの行動について本当のことを聞かせてもらおうか。
How came the stone into the goose, and how came the goose into the open market?	どういうわけで鵞鳥に宝石をしこみ、どういうわけでその鵞鳥が市場に出回ったんだ？
Tell us the truth, for there lies your only hope of safety."	本当のことを言え、そこに君の身の安全はかかっているんだぞ」
Ryder passed his tongue over his parched lips.	ライダーはからからに乾いた唇をなめた。
"I will tell you it just as it happened, sir," said he.	「お話しますとも、ただ起きたままのことを。
"When Horner had been arrested, it seemed to me that it would be best for me to get away with the stone at once,	ホーナーが逮捕された後も、いったん宝石をどこかに隠しておくのがいちばんだと思えました。
for I did not know at what moment the police might not take it into their heads to search me and my room.	というのは、警察が、いつ何時私の身体や私の部屋を捜索する気になるか、分かったものじゃなかったからです。
There was no place about the hotel where it would be safe.	ホテル回りには安全そうな場所がありません。
I went out, as if on some commission, and I made for my sister's house.	私は仕事を受けたふりをして外出し、姉の家に立ち寄りました。
She had married a man named Oakshott, and lived in Brixton Road, where she fattened fowls for the market.	姉はオークショットという人と結婚し、ブリクストン街で暮らしていて、そこで鳥を太らせては市場に送っています。
All the way there every man I met seemed to me to be a policeman or a detective;	途中、道行く人々がみな警官か刑事なんじゃないかと思えまして、
and, for all that it was a cold night, the sweat was pouring down my face before I came to the Brixton Road.	それで、寒い夜だったというのに、ブリクストン街につかないうちから、顔から汗を流していました。
My sister asked me what was the matter, and why I was so pale;	姉は、何があったのか、そんなに青ざめている理由は何かと聞きました。
but I told her that I had been upset by the jewel robbery at the hotel.	ただ私は、ホテルで宝石泥棒があって落ちつかないんだと答えておきました。
Then I went into the back yard and smoked a pipe and wondered what it would be best to do.	それから裏庭に出て、パイプをふかしながら、何をするのがいちばんか、と頭を悩ませました。
"I had a frienad once called Maudsley,	「むかし、モーズリーという友だちがいました。
who went to the bad, and has just been serving his time in Pentonville.	彼は悪い道に踏み込んでしまって、ペンタルヴィルでお勤めをはたしてきたばかりです。
One day he had met me, and fell into talk about the ways of thieves, and how they could get rid of what they stole.	ある日、モーズリーに会ったとき、泥棒の手口の話となり、連中がどうやって盗んだものを処理するのか、聞いたことがありました。
I knew that he would be true to me, for I knew one or two things about him;	モーズリーが私に歯向かわないのは分かっていました、あいつについては2、3知ってることがありましたからね。
so I made up my mind to go right on to Kilburn, where he lived, and take him into my confidence.	そんなわけで、まっすぐキルボーンへ、彼の住むところに行って、秘密を打ち明けようと決めました。
He would show me how to turn the stone into money.	この宝石を金に替える方法を教えてもらおうと思って。
But how to get to him in safety?	でも、安全にたどりつくには？
I thought of the agonies I had gone through in coming from the hotel.	ホテルからここまでくるときの苦しみを思い出しました。
I might at any moment be seized and searched, and there would be the stone in my waistcoat pocket.	いつ急に捕まえられて調べられてもおかしくありません、そしてベストのポケットには問題の宝石が入っているんです。
I was leaning against the wall at the time and looking at the geese which were waddling about round my feet, and suddenly an idea came into my head	壁にもたれかかって、鵞鳥が足元をよたよた歩きまわるのを見ていたら、不意にあるアイデアが頭の中に浮かんだんです。
which showed me how I could beat the best detective that ever lived.	史上最高の捜査官でも出しぬけると思いました。
"My sister had told me some weeks before that I might have the pick of her geese for a Christmas present,	「数週間前、姉からクリスマスプレゼントとして、選んだ鵞鳥を贈ると言われていました。
and I knew that she was always as good as her word.	姉はいつも約束を守る人です。
I would take my goose now, and in it I would carry my stone to Kilburn.	私は、今その鵞鳥を選んで、中に宝石をしこんでキルバーンまで運べばいいと思いました。
There was a little shed in the yard, and behind this I drove one of the birds	庭には小さな小屋がありまして、その裏に1羽を追いこみました
--a fine big one, white, with a barred tail.	――みごとに太った、白くて、尾に筋が入っているやつです。
I caught it, and prying its bill open, I thrust the stone down its throat as far as my finger could reach.	そいつを捕まえて、くちばしをこじ開けて、宝石を喉の奥に、指の届くところまで押しこみました。
The bird gave a gulp, and I felt the stone pass along its gullet and down into its crop.	うまく飲みこみましたので、のどを触ってみると、食堂を通って餌袋の中に入ったのが分かりました。
But the creature flapped and struggled, and out came my sister to know what was the matter.	ただ、そいつ暴れたり羽ばたいたりしたもので、姉が何事かと思って出てきました。
As I turned to speak to her the brute broke loose and fluttered off among the others.	そっちに向き直ったとたん、鵞鳥は私の腕から逃れてほかの連中の間に駈けこんでいきました。
"'Whatever were you doing with that bird, Jem?' says she.	「『あの鳥に何をやってたんだい、ジェム？』
"'Well,' said I, 'you said you'd give me one for Christmas, and I was feeling which was the fattest.'	「『ほら、クリスマスに1羽くれるって言ってたから、どれがいちばん太ってるか触
"'Oh,' says she, 'we've set yours aside for you	「『おや、あんたのは別にしといたんだけど
--Jem's bird, we call it.	――ジェムの鳥って呼んでね。
It's the big white one over yonder.	大きくて白い――ああ、ちょうどあそこに見えてるやつ。
There's twenty-six of them, which makes one for you, and one for us, and two dozen for the market.'	ここには26羽いてね、1羽はあんたの、1羽はうちの、残りの2ダースを市場に出すんだよ』
"'Thank you, Maggie,'  says I;	「『ありがとう、マギー。
'but if it is all the same to you, I'd rather have that one I was handling just now.'	だけど、もし問題ないなら、さっきのやつの方がいいな』
"'The other is a good three pound heavier,' said she,	「『あっちのほうが3ポンドは重いよ。
'and we fattened it expressly for you.'	それに、あんたのだからって特に太らせたんだけど』
"'Never mind.	「『いいんだ。
I'll have the other, and I'll take it now,' said I.	さっきのをもらう、いますぐ連れていくよ』
"'Oh, just as you like,' said she,	「『ま、好きにするといい』
a little huffed.	むっとしたようです。
'Which is it you want, then?'	『で、欲しいのはどれ？』
"'That white one with the barred tail, right in the middle of the flock.'	「『あの、白くて尾に筋が入ったやつ、群れの真中らへんの右にいる』
"'Oh, very well.	「『ああ、いいとも。
Kill it and take it with you.'	絞めてから持っていきな』
"Well, I did what she said, Mr. Holmes,	「私は言われた通りにしました、ミスター・ホームズ。
and I carried the bird all the way to Kilburn.	そして、キルバーンまで運んだんです。
I told my pal what I had done,	相棒にこの話をしました。
for he was a man that it was easy to tell a thing like that to.	こういう話を気楽に聞かせられる相手でしたから。
He laughed until he choked,	あいつは大笑いして息をつまらるほどでした。
we got a knife and opened the goose.	それから私たちはナイフをとって鵞鳥を開きました。
My heart turned to water,	興奮が一気に冷めました。
for there was no sign of the stone,	なぜって、石が見当たらないんです。
and I knew that some terrible mistake had occurred.	何かひどい手違いが起きたんだと思いました。
I left the bird rushed back to my sister's, and hurried into the back yard.	急いで、その鵞鳥を置いたまま姉の家に戻り、裏庭に駈けこみました。
There was not a bird to be seen there.	鵞鳥は1羽も見当たりません。
"'Where are they all, Maggie?'	「『みんなどこにいるんだ、マギー？』
I cried.	私は悲鳴をあげました。
"'Gone to the dealer's, Jem.'	「『もう卸してしまったよ、ジェム』
"'Which dealer's?'	「『どこに？』
"'Breckinridge, of Covent Garden.'	「『ブリッキンリッジのところ、コヴェント・ガーデンの』
"'But was there another with a barred tail?' I asked,	「『それでさ、もう1羽、尾に筋が入ったやつがいなかった？
'the same as the one I chose?'	僕が選んだのと同じようなやつが？』
"'Yes, Jem;	「『うん、ジェム。
there were two barred-tailed ones, and I could never tell them apart.'	そういうのが2羽いたよ、あたしもぜんぜん見分けがつかなかったねえ』
"Well, then, of course I saw it all, and I ran off as hard as my feet would carry me to this man Breckinridge;	「そう、それで、もちろんすべてを理解し、全力でこのブリッキンリッジという男のところまで走りました。
but he had sold the lot at once, and not one word would he tell me as to where they had gone.	ところが、彼は一度にまとめて売ってしまっていて、一言だってどこにやったのか教えてくれないのです。
You heard him yourselves to-night.	ご自身、今夜お聞きになったことでしょう。
Well, he has always answered me like that.	いつもあの調子だったんです。
My sister thinks that I am going mad.	姉は私が狂ってしまったんだと思っています。
Sometimes I think that I am myself.	ときどき、私自身にもそう思えます。
And now--and now I am myself a branded thief,	それに――それに、今やこの私は札の泥棒です。
without ever having touched the wealth for which I sold my character.	しかも、人格を売ってまで手にしようとした富に手を触れることはないのです。
God help me!	神さま、お助けください！
God help me!"	どうか、私をお助けください！」
He burst into convulsive sobbing, with his face buried in his hands.	彼は両手に顔をうずめ、激しく嗚咽しはじめた。
There was a long silence, broken only by his heavy breathing and by the measured tapping of Sherlock Holmes's finger-tips upon the edge of the table.	長い沈黙があり、ただ、ライダーの荒い息遣いと、ホームズの指先がテーブルを規則正しく叩く音だけが、静寂を破りつづけた。
Then my friend rose and threw open the door.	まもなく、ホームズは立ちあがって、ドアを開け放った。
"Get out!" said he.	「失せろ！」
"What, sir!	「いまなんと！
Oh, Heaven bless you!"	おお、神さま、このお方に祝福を！」
"No more words.	「言葉はもういい、
Get out!"	失せろ！」
And no more words were needed.	そして、言葉はもう必要とされなかった。
There was a rush, a clatter upon the stairs, the bang of a door, and the crisp rattle of running footfalls from the street.	ただ、出口に殺到する音、階段のきしむ音、ドアを叩きつける音が響き、続いて、氷と砂利を踏みしめて走る音が通りから聞こえてきた。
"After all, Watson,"	「つまりさ、ワトスン」
said Holmes, reaching up his hand for his clay pipe,	とホームズは陶製のパイプに手を伸ばしながら言った。
"I am not retained by the police to supply their deficiencies.	「僕は警察に雇われて彼らの不足分を補っているわけじゃないんだ。
If Horner were in danger it would be another thing;	もしホーナーが危険だったんならまた別だったろうけど、
but this fellow will not appear against him, and the case must collapse.	ライダーがホーナーに不利な証言をすることはもうないだろうし、訴えも崩れていくに違いない。
I suppose that I am commuting a felony.	僕は重罪を減刑してやっているんだろうか。
but it is just possible that I am saving a soul.	でも、人の心を救ったというのはちょっとありえそうなことだよ。
This fellow will not go wrong again;	この男は2度と間違った道に踏み込むことはないだろう、
he is too terribly frightened.	ひどく脅かされたからね。
Send him to jail now, and you make him a jail-bird for life.	刑務所に送ってみろ、きっと檻の鳥として一生を過ごすことになっただろう。
Besides, it is the season of forgiveness.	今は罪を赦す季節だ。
Chance has put in our way a most singular and whimsical problem, and its solution is its own reward.	偶然に吹き寄せられてくる奇抜で奇妙な事件は、解決そのものが報酬というものだね。
If you will have the goodness to touch the bell, Doctor,	ドクター、呼び鈴を鳴らす元気はあるかい？
we will begin another investigation,	じゃあ、次の捜査をはじめよう。
in which, also a bird will be the chief feature."	こいつも、1羽の鳥が主役だよ」
