The Adventure of the Norwood Builder	ノーウッドの建築家ノーウッドの建築家
Arthur Conan Doyle	アーサー・コナン・ドイル
``From the point of view of the criminal expert,''	「犯罪の専門家として言わせてもらえば」
said Mr. Sherlock Holmes,	と、ミスター・シャーロック・ホームズは言った。
``London has become a singularly uninteresting city since the death of the late lamented Professor Moriarty.''	「ロンドンは、モリアーティ教授の逝去以来、じつにつまらない街になったものだ」
``I can hardly think that you would find many decent citizens to agree with you,''	「数多いまともな市民が君に賛成するとは、とうてい思えないね」
I answered.	と、私は答えた。
``Well, well, I must not be selfish,''	「まあよし、勝手を言ってはならないか」
said he, with a smile, as he pushed back his chair from the breakfast-table.	と微笑みながら、ホームズは朝食のテーブルから椅子を引いた。
``The community is certainly the gainer, and no one the loser,	「社会は得をし、損をしたものは誰もいない。
save the poor out-of-work specialist, whose occupation has gone.	ひとり、失業した専門家を除けばね。
With that man in the field, one's morning paper presented infinite possibilities.	あの男が活動していれば、朝刊は無限の可能性を与えてくれるものだった。
Often it was only the smallest trace, Watson, the faintest indication, and yet it was enough to tell me that the great malignant brain was there,	ときに、それはごくごく小さな痕跡や、ごくごくかすかな兆候でしかなかったけれど、それでも十分、卓越した悪辣な頭脳の存在を僕に知らせてくれた。
as the gentlest tremors of the edges of the web remind one of the foul spider which lurks in the centre.	巣の縁でのかすかな振動が、巣の中央に潜む汚らわしい蜘蛛の1匹を暴きだすように。
Petty thefts, wanton assaults, purposeless outrage	けちな窃盗事件、理不尽な強盗事件、無益な傷害事件
-- to the man who held the clue all could be worked into one connected whole.	――手がかりを握るその男にとって、すべてをひとつの穴に結びつけることができた。
To the scientific student of the higher criminal world, no capital in Europe offered the advantages which London then possessed.	高等犯罪界の科学的学徒にとって、ロンドンは、ヨーロッパのどの首都よりも先進性を持つ街だった。
But now -- ''	だが今や――」
He shrugged his shoulders in humorous deprecation of the state of things which he had himself done so much to produce.	ホームズは肩をすくめ、自身が尽力して生みだしたこの現状を、滑稽に非難してみせた。
At the time of which I speak, Holmes had been back for some months, and I at his request had sold my practice and returned to share the old quarters in Baker Street.	この話は、ホームズが戻って数ヶ月経ったころのことで、私もまた、ホームズの要求に応じて診療所を売り払い、ベイカー街にある昔馴染みのあの部屋に戻っていた。
A young doctor, named Vemer, had purchased my small Kensington practice,	診療所を買い取ったのはヴァーナーという名前の若い医者だった。
and given with astonishingly little demur the highest price that I ventured to ask	私があえて提示したきわめて高い価格を、こっちが驚いてしまうほど文句をつけずに支払った
-- an incident which only explained itself some years later, when I found that Vemer was a distant relation of Holmes,	――数年後、ヴァーナーがホームズの遠縁にあたることを知り、事情が飲み込めた。
and that it was my friend who had really found the money.	実際に金を積んだのは、我が友だったのだ。
Our months of partnership had not been so uneventful as he had stated,	ここ数ヶ月の共同生活はホームズが言うほどに暇だったわけではない。
for I find, on looking over my notes, that this period includes the case of the papers of ex-President Murillo, and also the shocking affair of the Dutch steamship Friesland,	この期間につけたノートをめくってみれば、前大統領ムリロの文書事件が収められているし、あのオランダ汽船フリースランド事件という衝撃的な事件もある。
which so nearly cost us both our lives.	後者の事件では、我々まであやうく命を落としそうになったのだ。
His cold and proud nature was always averse, however, from anything in the shape of public applause,	ホームズは冷淡で高慢な性格をしていたから、いかなる形であれ大衆の賞賛を嫌っていた。
and he bound me in the most stringent terms to say no further word of himself, his methods, or his successes	それで、ホームズ自身について、ホームズの手口について、ホームズの成功について、これ以上言葉を費やしてはならないと、かなり厳しく私を束縛していた
-- a prohibition which, as I have explained, has only now been removed.	――以前も説明したとおり、禁令はいまになって解除されたのである。
Mr. Sherlock Holmes was leaning back in his chair after his whimsical protest, and was unfolding his morning paper in a leisurely fashion, when our attention was arrested by a tremendous ring at the bell,	ミスター・シャーロック・ホームズが、先の奇抜な主張を終えて椅子に持たれかかり、ゆとりにあふれる態度で新聞を広げようとしていたそのとき、呼び鈴が大音量で鳴り響いて我々の気をひいた。
followed immediately by a hollow drumming sound,	乱打音が響いてくる。
as if someone were beating on the outer door with his fist.	どうやら、誰かがドアを拳で叩いているようだ。
As it opened	ドアが開かれる音。
there came a tumultuous rush into the hall,	騒々しく駈けこむ音。
rapid feet clattered up the stair,	猛スピードで階段を踏み鳴らす音。
and an instant later a wild-eyed and frantic young man,	一瞬の後、目を血走らせた半狂乱の若い男が室内に飛びこんできた。
pale, dishevelled, and palpitating, burst into the room.	顔は青ざめ、服装は乱れ、息を切らしている。
He looked from one to the other of us, and under our gaze of inquiry he became conscious that some apology was needed for this unceremonious entry.	我々をかわるがわる見た男は、我々の問いかけるような眼差しを受け、この形式を外した入室を謝罪する必要があることに気がついたようだ。
``I'm sorry, Mr. Holmes,''	「もうしわけありません、ミスター・ホームズ」
he cried.	男は叫んだ。
``You mustn't blame me.	「責めないでください。
I am nearly mad.	気が変になりそうなんです。
Mr. Holmes, I am the unhappy John Hector McFarlane.''	ミスター・ホームズ、私が、不幸なるジョン・ヘクター・マクファーレンです」
He made the announcement	男はそう宣言した。
as if the name alone would explain both his visit and its manner, but I could see by my companion's unresponsive face, that it meant no more to him than to me.	まるでその名前だけで訪問の理由も態度の原因も説明できそうなようすだったが、ホームズの表情に変化がないのを見ると、その名前はホームズにとっても意味のないものだったらしい。
``Have a cigarette, Mr. McFarlane,''	「煙草でもどうぞ、ミスター・マクファーレン」
said he, pushing his case across.	と、自分のケースを押しやりながらホームズが言った。
``I am sure that, with your symptoms, my friend Dr. Watson here would prescribe a sedative.	「その症状からして、きっと、我が友ドクター・ワトスンから鎮静剤を処方してもらえることでしょう。
The weather has been so very warm these last few days.	ここ数日、暑苦しい日が続きますしね。
Now, if you feel a little more composed, I should be glad if you would sit down in that chair, and tell us very slowly and quietly who you are, and what it is that you want.	どうです、少しでも落ちついたようでしたら、あちらの椅子に腰を下ろして、ゆっくりと、穏やかに、あなたがどなたか、何をお望みなのかを教えていただけると嬉しいのですが。
You mentioned your name, as if I should recognize it, but I assure you that, beyond the obvious facts that you are a bachelor, a solicitor, a Freemason, and an asthmatic, I know nothing whatever about you.''	まるで私がその名前を知っているはずだという口ぶりですが、あなたが独身で、事務弁護士で、フリーメーソンのメンバーで、喘息持ちだという事実以外、まったく何も知らないのです」
Familiar as I was with my friend's methods, it was not difficult for me to follow his deductions,	ホームズの手口にはなじんでいたので、その推論をたどるのは難しくなかった。
and to observe the untidiness of attire, the sheaf of legal papers, the watch-charm, and the breathing	服装の乱れ、法律文書の束、時計の飾り、呼吸。
which had prompted them.	推論は、これらの観察から導き出されたのだ。
Our client, however, stared in amazement.	しかし、依頼人は驚きを込めてホームズを見つめた。
``Yes, I am all that, Mr. Holmes;	「はい、すべてそのとおりです、ミスター・ホームズ。
and, in addition, I am the most unfortunate man at this moment in London.	おまけに、私はいまこのときロンドン一不運な男です。
For heaven's sake, don't abandon me, Mr. Holmes!	お願いします、私を見捨てないでください、ミスター・ホームズ！
If they come to arrest me before I have finished my story, make them give me time, so that I may tell you the whole truth.	もし話を終える前に私が逮捕されそうになったら、本当のことをみんな話してしまうまで待つように説得してください。
I could go to jail happy if I knew that you were working for me outside.''	留置所行きはかまいません、外であなたが動いてくださるのさえ知っていれば」
``Arrest you!''	「逮捕ですか！」
said Holmes.	とホームズ。
``This is really most grati -- most interesting.	「これはまた実にすばら――実に困ったことですね。
On what charge do you expect to be arrested?''	何の容疑で逮捕されるとお考えなのですか？」
``Upon the charge of murdering Mr. Jonas Oldacre, of Lower Norwood.''	「ロワーノーウッドのミスター・ジョナス・オールデイカー殺害の容疑で」
My companion's expressive face showed a sympathy which was not, I am afraid, entirely unmixed with satisfaction.	ホームズの表情には同情が見られたが、困ったことに、その顔に満足がかけらも混じっていないとは言いがたい。
``Dear me,''	「おやおや」
said he,	とホームズ。
``it was only this moment at breakfast that I was saying to my friend, Dr. Watson, that sensational cases had disappeared out of our papers.''	「たったいま、朝食の席でドクター・ワトスンに言っていたところでしたよ、センセーショナルな事件が新聞からなくなったとね」
Our visitor stretched forward a quivering hand and picked up the Daily Telegraph, which still lay upon Holmes's knee.	客人は震える手を伸ばしてデイリーテレグラフを、ホームズの膝の上から取り上げた。
``If you had looked at it, sir, you would have seen at a glance what the errand is on which I have come to you this morning.	「もしこれをごらんになっていたら、今朝の用件も一目で分かっていただけましたのに。
I feel as if my name and my misfortune must be in every man's mouth.''	誰もがみな、私の名前と不運を口にしているように感じているのです」
He turned it over to expose the central page.	そう言いながら、真中付近のページを開いた。
``Here it is, and with your permission I will read it to you.	「これです、もしよろしければ私がお読みしましょう。
Listen to this, Mr. Holmes.	お聞きください、ミスター・ホームズ。
The headlines are:	ヘッドラインは
`Mysterious Affair at Lower Norwood.	『ロワーノーウッドの怪事件。
Disappearance of a Well Known Builder.	有名建築家失踪。
Suspicion of Murder and Arson.	殺人、および放火の疑い。
A Clue to the Criminal.'	犯罪の手がかり』
That is the clue which they are already following, Mr. Holmes,	彼らは手がかりを掴んでいます、ミスター・ホームズ。
and I know that it leads infallibly to me.	そこから私が割り出されるのは分かりきっています。
I have been followed from London Bridge Station, and I am sure that they are only waiting for the warrant to arrest me.	ロンドンブリッジ駅から尾行がつきましたし、きっと、ただ私を逮捕する令状がとれるのを待っているだけなんです。
It will break my mother's heart -- it will break her heart!''	母は――母は心を痛めることでしょう！」
He wrung his hands in an agony of apprehension, and swayed backward and forward in his chair.	客人は先々のことに思いに悩んで両手を組み合わせると、後ろに倒れこんで椅子に収まった。
I looked with interest upon this man, who was accused of being the perpetrator of a crime of violence.	暴力的犯罪の当事者として告発されたこの男を、私は興味深く眺めた。
He was flaxen-haired and handsome, in a washed-out negative fashion,	やつれた陰気な様子が見うけられるが、麻栗色の髪と整った顔立ちをしている。
with frightened blue eyes,	おびえきった青い瞳。
and a clean-shaven face,	きれいに剃られた顔。
with a weak, sensitive mouth.	弱々しい、神経質そうな口元。
His age may have been about twenty-seven, his dress and bearing that of a gentleman.	年のころは27といったところか、服装も態度も紳士のそれだった。
From the pocket of his light summer overcoat protruded the bundle of endorsed papers which proclaimed his profession.	サマー・オーバーのポケットから、所有者の職業を物語る裏書用紙の束がのぞいている。
``We must use what time we have,''	「残された時間を活かさなければ」
said Holmes.	とホームズ。
``Watson, would you have the kindness to take the paper and to read the paragraph in question?''	「ワトスン、その新聞の、問題の記事を読んでもらえないか？」
Underneath the vigorous headlines which our client had quoted, I read the following suggestive narrative:	客人が引用した活力あるヘッドラインの下に続いた、示唆に富む記事を私は読み上げた。
``Late last night, or early this morning, an incident occurred at Lower Norwood	昨夜遅く、あるいは本日未明、ロワーノーウッドで事件が発生した。
which points, it is feared, to a serious crime.	重大な犯罪の可能性が懸念されている。
Mr. Jonas Oldacre is a well known resident of that suburb, where he has carried on his business as a builder for many years.	ミスター・ジョナス・オールデイカー（52）はこの郊外の有名な住人であり、長年、この地方で建築家としての業務に携わっている。
Mr. Oldacre is a bachelor, fifty-two years of age, and lives in Deep Dene House, at the Sydenham end of the road of that name.	氏は独身であり、ディープ・ディーン道路の端のシデナムにあるディープ・ディーン・ハウスで暮らしていた。
He has had the reputation of being a man of eccentric habits, secretive and retiring.	奇人、秘密主義、非社交人物としても有名。
For some years he has practically withdrawn from the business, in which he is said to have massed considerable wealth.	ここ数年、実質的には事業から撤退していたが、すでに相当の財産を築いていたと言われている。
A small timber-yard still exists, however, at the back of the house, and last night, about twelve o'clock, an alarm was given that one of the stacks was on fire.	しかしながら、住居の裏に小さな木材置場が依然として存在しており、昨晩12時ごろ、木材から火が出ているという通報があった。
The engines were soon upon the spot, but the dry wood burned with great fury, and it was impossible to arrest the conflagration until the stack had been entirely consumed.	消防局がすぐに駈けつけたが、乾いた木材は猛烈な勢いで燃えあがり、すべてが完全に燃え尽きるまで止めることはできなかった。
Up to this point the incident bore the appearance of an ordinary accident, but fresh indications seem to point to serious crime.	ここまでは一見、ありふれた退屈な事件のようであったが、重大犯罪を示す痕跡が明らかになった。
Surprise was expressed at the absence of the master of the establishment from the scene of the fire, and an inquiry followed, which showed that he had disappeared from the house.	この火災の現場に施設の所有者が見当たらないことに驚きの声が上がり、聴取の結果、住宅から姿を消してしまったことが判明した。
An examination of his room revealed that the bed had not been slept in, that a safe which stood in it was open, that a number of important papers were scattered about the room,	室内を調査すると、ベッドに入った跡はなく、金庫が開かれており、重要書類が部屋中に散らばっていた。
and finally, that there were signs of a murderous struggle, slight traces of blood being found within the room,	そのうえ、殺意に満ちた格闘が行われた跡や血痕が部屋中で見つかり、柄に血痕のあるオークのステッキが発見された。
and an oaken walking-stick, which also showed stains of blood upon the handle.	昨晩遅く、寝室に客を迎えたということで、発見されたステッキの所有者はこの人物であると確認された。
It is known that Mr. Jonas Oldacre had received a late visitor in his bedroom upon that night, and the stick found has been identified as the property of this person, who is a young London solicitor named John Hector McFarlane, junior partner of Graham and McFarlane, of 426 Gresham Buildings, E. C.	ロンドン事務弁護士ジョン・ヘクター・マクファーレン、西中央区グレシャム・ビルディングス426のグレアム・アンド・マクファーレンに籍をおく人物である。
The police believe that they have evidence in their possession which supplies a very convincing motive for the crime, and altogether it cannot be doubted that sensational developments will follow.	警察は犯罪への強い動機を裏付ける証拠を握っていると考えており、センセーショナルな展開が続くことに疑問の余地はない。
-- It is rumoured as we go to press that Mr. John Hector McFarlane has actually been arrested on the charge of the murder of Mr. Jonas Oldacre.	――脱稿後、ミスター・ジョン・ヘクター・マクファーレンはすでに、ミスター・ジョナス・オールデイカー殺害の容疑で逮捕されたという噂が飛びこんできた。
It is at least certain that a warrant has been issued.	少なくとも、令状が発行されていることは間違いない。
There have been further and sinister developments in the investigation at Norwood.	ノーウッド事件は、さらなる不吉な展開を迎えそうだ。
Besides the signs of a struggle in the room of the unfortunate builder it is now known that the French windows of his bedroom ( which is on the ground floor ) were found to be open, that there were marks as if some bulky object had been dragged across to the wood-pile, and, finally, it is asserted that charred remains have been found among the charcoal ashes of the fire.	不運な建築家の部屋に見られた格闘の跡に加えて、寝室（1階）のフランス窓が開け放たれていたこと、何かかさばるものを木材置場へ引きずった跡があること、そして、黒焦げの物質が火災の現場から発見されたらしいことが、現在までに判明している。
The police theory is that a most sensational crime has been committed,	警察は被害者がきわめてセンセーショナルな犯罪に巻き込まれたという見解を持っている。
that the victim was clubbed to death in his own bedroom, his papers rifled, and his dead body dragged across to the wood-stack, which was then ignited so as to hide all traces of the crime.	犯人は、寝室で被害者を撲殺し、書類を奪いとり、遺体を木材置場まで運び込んで、犯罪の痕跡をすべてを焼却しようとしたとのことだ。
The conduct of the criminal investigation has been left in the experienced hands of Inspector Lestrade, of Scotland Yard, who is following up the clues with his accustomed energy and sagacity. ``	調査はスコットランドヤードのベテラン刑事、レストレイド警部の手に委ねられ、警部は例のごとく活力と聡明さをもって手がかりを追っている。
Sherlock Holmes listened with closed eyes and fingertips together to this remarkable account.	シャーロック・ホームズは、目を閉ざし、指先をつき合わせて、この驚くべき記事に耳を傾けていた。
``The case has certainly some points of interest,''	「たしかに、興味深い点もありますね」
said he, in his languid fashion.	と、ホームズはこともなげに言った。
``May I ask, in the first place, Mr. McFarlane, how it is that you are still at liberty,	「まずですよ、ミスター・マクファーレン、どうして今もまだ自由の身でいるのですか？
since there appears to be enough evidence to justify your arrest?''	逮捕されるのに十分な証拠があるように思えますが」
``I live at Torrington Lodge, Blackheath, with my parents, Mr. Holmes	「私はブラックヒースのトリングトン・ロッジに両親と暮らしています。
but last night, having to do business very late with Mr. Jonas Oldacre, I stayed at an hotel in Norwood, and came to my business from there.	ですが昨日の夜は、ミスター・ジョナス・オールデイカーと遅くまで仕事をしなければならなかったものですから、ノーウッドのホテルに泊まりました。
I knew nothing of this affair until I was in the train,	事件のことは、事務所に帰る列車の中で知りました。
when I read what you have just heard.	いまあなたが耳にした記事を読んだときに。
I at once saw the horrible danger of my position, and I hurried to put the case into your hands.	それと同時に、私が恐ろしく危険な立場にいることに気付き、事件をあなたの手に委ねようと急いでやってきたのです。
I have no doubt that I should have been arrested either at my city office or at my home.	事務所や家にいたとしたら、とっくに逮捕されていたに違いありません。
A man followed me from London Bridge Station, and I have no doubt Great heaven!	男が1人、ロンドン・ブリッジ駅から尾行してきました、あれは間違いなく
what is that?''	――む、これはいったい？」
It was a clang of the bell, followed instantly by heavy steps upon the stair.	呼び鈴が鳴り響き、つづいて階段をのぼる重々しい足音が聞こえてきた。
A moment later, our old friend Lestrade appeared in the doorway.	一瞬の間があって、我々にとって昔馴染みの友であるレストレイドが戸口に現れた。
Over his shoulder I caught a glimpse of one or two uniformed policemen outside.	その肩の向こうから、外にいる1人か2人の制服警官の視線を感じた。
``Mr. John Hector McFarlane?''	「ミスター・ジョン・ヘクター・マクファーレン？」
said Lestrade.	と、レストレイドは言った。
Our unfortunate client rose with a ghastly face.	我々の不運な依頼人は、幽鬼のように青ざめていた。
``I arrest you for the wilful murder of Mr. Jonas Oldacre, of Lower Norwood.''	「ロワーノーウッドのミスター・ジョナス・オールデイカー殺害容疑で逮捕する」
McFarlane turned to us with a gesture of despair, and sank into his chair once more like one who is crushed.	マクファーレンは我々に絶望の身振りを示すと、崩れこむようにもういちど椅子に座りこんだ。
``One moment.	「待ってくれ、レストレイド」
Lestrade,''	とホームズ。
``Half an hour more or less can make no difference to you,	「30分前後の遅れが出ても違いはないだろう。
and the gentleman was about to give us an account of this very interesting affair,	こちらの方は、このきわめて面白い事件について説明をしてくれるところだったんだ。
which might aid us in clearing it up.''	それを聞けば、事件を整理するのに役立つと思うよ」
``I think there will be no difficulty in clearing it up,''	「事件の整理は、何ら支障もなく行えると考えますが」
said Lestrade, grimly.	とレストレイドは苦々しげに言った。
``None the less, with your permission, I should be much interested to hear his account.''	「それでもやはりね、もし君さえよければ、この方の説明を聞いてみたいんだよ」
``Well, Mr. Holmes, it is difficult for me to refuse you anything,	「ま、ミスター・ホームズ、あなたの申し出を拒絶するわけにはいきませんね。
for you have been of use to the force once or twice in the past, and we owe you a good turn at Scotland Yard,''	以前も若干警察の役に立ってくださったことですし、我々スコットランドヤードも大きな借りを作っていますから」
said Lestrade.	とレストレイド。
``At the same time I must remain with my prisoner	「ただし、私も容疑者と一緒に残らねばなりません。
and I am bound to warn him that anything he may say will appear in evidence against him.''	職務上、警告しておきますが、容疑者の発言は、容疑に対する証拠として扱われるでしょう」
``I wish nothing better,''	「それでかまいません」
said our client.	と依頼人は言った。
``All I ask is that you should hear and recognize the absolute truth.''	「ただ、真実に耳を傾け、真実を認識していただきたいだけです」
Lestrade looked at his watch.	レストレイドは自分の時計に目をやった。
``I'll give you half an hour,'' said he.	「30分、譲りましょう」
``I must explain first,'' said McFarlane,	「まず最初にお断りしますが、
``that I knew nothing of Mr. Jonas Oldacre.	私はミスター・ジョナス・オールデイカーをまったく知りませんでした。
His name was familiar to me, for many years ago my parents were acquainted with him, but they drifted apart.	何年も昔、両親の知人だったということで名前は聞いていましたが、今はもう両親とのつきあいもありません。
I was very much surprised, therefore, when yesterday, about three o'clock in the afternoon, he walked into my office in the city.	ですから、昨日の午後3時ごろ、ミスター・オールデイカーが事務所にきたときには驚きました。
But I was still more astonished when he told me the object of his visit.	訪問の理由を伺うと、さらに驚かされました。
He had in his hand several sheets of a notebook, covered with scribbled writing -- here they are -- and he laid them on my table.	あの方は、数枚の走り書きを――これです――テーブルに出しました。
```Here is my will,'	「『これは、私の遺言書です』
said he.	とあの方は言います。
`I want you, Mr. McFarlane, to cast it into proper legal shape.	『ミスター・マクファーレン、これを法的な形式に整えて欲しい。
I will sit here while you do so.'	作業中、ここに座って待ちますから』
``I set myself to copy it,	「私はさっそく写本を作ることにしました。
and you can imagine my astonishment when I found that, with some reservations, he had left all his property to me.	ところが読んでみると、条件つきで、その財産すべてを、私に遺すというのです。
He was a strange little ferret-like man, with white eyelashes,	ミスター・オールデイカーは体の小さい風変わりな人物で、白い睫毛をしたフェレットのようでした。
and when I looked up at him I found his keen gray eyes fixed upon me with an amused expression.	目を上げると、鋭い灰色の瞳が私のほうを楽しそうに見つめています。
I could hardly believe my own senses as I read the terms of the will,	遺言書の内容を読んでも、私には自分の感覚を信じられませんでした。
but he explained that he was a bachelor with hardly any living relation,	説明によると、あの方は独身であり、親類もほとんど死んでしまった。
that he had known my parents in his youth,	私の両親とは若い頃の知り合いだった。
and that he had always heard of me as a very deserving young man,	常々、私がとても立派な若者であると聞いている。
and was assured that his money would be in worthy hands.	そして、自分の財産を価値のある人間の手に収めてもらいたいのだ、と。
Of course, I could only stammer out my thanks.	当然、私には感謝の言葉をどもりながら繰り返すことしかできませんでした。
The will was duly finished, signed, and witnessed by my clerk.	仕上がった遺言書に、署名と、事務員による連署が行われました。
This is it on the blue paper, and these slips, as I have explained, are the rough draft.	この青い書類がそうです、それからこちらが、ご説明したとおり、下書きです。
Mr. Jonas Oldacre then informed me that there were a number of documents -- building leases, title-deeds, mortgages, scrip, and so forth -- which it was necessary that I should see and understand.	ミスター・ジョナス・オールデイカーは、建物の賃貸契約書や、権利証書や、抵当証書や、仮証書類などといった書類が山ほどあるので、一度目を通して理解しておいて欲しいと言いました。
He said that his mind would not be easy until the whole thing was settled, and he begged me to come out to his house at Norwood that night, bringing the will with me, and to arrange matters.	一切が落ちつくまで安心できないそうで、その夜に、遺言書をもって、ノーウッドの家に足を運び、問題をまとめようと頼まれました。
`Remember, my boy, not one word to your parents about the affair	『そうそう、きみ、ご両親には一言も漏らさないように。
until everything is settled.	何もかもが落ちつくまでね。
We will keep it as a little surprise for them.'	ちょっと驚かせてやれるようにな』
He was very insistent upon this point, and made me promise it faithfully.	あの方はこの点を強く言い張り、私に堅く約束させました。
``You can imagine, Mr. Holmes, that I was not in a humour to refuse him anything that he might ask.	「想像できるでしょう、ミスター・ホームズ、あの方が求めることを拒否できるような気分ではなかったのです。
He was my benefactor,	恩人です。
and all my desire was to carry out his wishes in every particular.	私はただ、あの方の希望にあらゆる点でお応えしたかったのです。
I sent a telegram home, therefore, to say that I had important business on hand, and that it was impossible for me to say how late I might be.	ですから私は、重要な仕事ができたのでどれくらい遅くなるか分からないと、家に電報を打ちました。
Mr. Oldacre had told me that he would like me to have supper with him at nine, as he might not be home before that hour.	ミスター・オールデイカーは9時に家で一緒に夕食をとりたいが、その時間まで家にはいないと言いました。
I had some difficulty in finding his house, however, and it was nearly half-past before I reached it.	もっとも、あの方の家を見つけるのにちょっとてこずりまして、30分ほど遅刻しました。
I found him -- ''	あの方が――」
``One moment!''	「待ってください！」
said Holmes.	とホームズ。
``Who opened the door?''	「誰がドアを開けましたか？」
``A middle-aged woman,	「中年の女性が。
who was, I suppose, his housekeeper.''	たぶん、家政婦なんだと思います」
``And it was she, I presume, who mentioned your name?''	「推測ですが、その女性から、あなたのお名前を口にしましたね？」
``Exactly,''	「そのとおりです」
said McFarlane.	とマクファーレン。
``Pray proceed.''	「続きをどうぞ」
McFarlane wiped his damp brow, and then continued his narrative:	マクファーレンは額ににじんだ汗をぬぐうと、話を続けた――
``I was shown by this woman into a sitting-room,	「その女性は、私を居間にとおしました。
where a frugal supper was laid out.	質素な夕食が準備されています。
Afterwards, Mr. Jonas Oldacre led me into his bedroom, in which there stood a heavy safe.	食後、ミスター・ジョナス・オールデイカーについて寝室に入ったところ、室内には大きな金庫が置いてありました。
This he opened and took out a mass of documents, which we went over together.	あの方が金庫を開いて大量の書類を取り出しましたので、2人で調べ始めました。
It was between eleven and twelve when we finished.	終わったのは11時台だったと思います。
He remarked that we must not disturb the housekeeper.	家政婦の手は煩わせられないということで、
He showed me out through his own French window,	フランス窓から帰るように指示しました。
which had been open all this time.''	窓はずっと開けられていました」
``Was the blind down?''	「ブラインドは降りていましたか？」
asked Holmes.	とホームズが聞いた。
``I will not be sure, but I believe that it was only half down.	「自信はありませんが、半分だけ降ろしてあったような気がします。
Yes,	いや、間違いありません。
I remember how he pulled it up in order to swing open the window.	あの方が窓を押し開こうと、ブラインドを引き上げているところを思い出しました。
I could not find my stick, and he said,	ステッキが見つかりませんでしたが、
`Never mind, my boy,	『気にすることはないよ、きみ。
I shall see a good deal of you now, I hope, and I will keep your stick until you come back to claim it.'	きっと、また何度も会うことになるだろうから、今度会うときまで預かっておくさ』
I left him there,	私は帰りました。
the safe open, and the papers made up in packets upon the table.	そのとき、金庫は開けっ放しで、書類はまとめてテーブルの上に置いてありました。
It was so late that I could not get back to Blackheath, so I spent the night at the Anerley Arms,	ブラックヒースに帰れる時刻ではありませんでしたから、アナリー・アームズで一泊しました。
and I knew nothing more until I read of this horrible affair in the morning.''	今朝の恐ろしい事件のことは、朝刊を読むまで何も知りませんでした」
``Anything more that you would like to ask, Mr. Holmes?''	レストレイドは、この注目すべき解説を聞きながら、2、3度、眉を釣りあげたが、ここでようやく口を開いた。
said Lestrade, whose eyebrows had gone up once or twice during this remarkable explanation.	「他に何か聞いておきたいことはありますか、ミスター・ホームズ？」
``Not until I have been to Blackheath.''	「ブラックヒースに行ってみるまでは何とも」
``You mean to Norwood,''	「ノーウッドじゃないですか」
said Lestrade.	とレストレイド。
``Oh, yes,	「ああ、そうか。
no doubt that is what I must have meant,''	確かにそれですよ」
said Holmes, with his enigmatical smile.	とホームズが謎めいた微笑を浮かべて言った。
Lestrade had learned by more experiences than he would care to acknowledge that that razor-like brain could cut through that	ホームズの剃刀のような頭脳は、レストレイドの理解の及ばないところまで、事実を鋭く切り取ることができる。
which was impenetrable to him.	レストレイドはそれを、口で言う以上に、経験から学んでいた。
I saw him look curiously at my companion.	レストレイドはホームズを興味深げに眺めた。
``I think I should like to have a word with you presently, Mr. Sherlock Holmes,''	「少しお話を伺っておくほうがよさそうですね、ミスター・シャーロック・ホームズ」
said he.	とレストレイド。
``Now, Mr. McFarlane, two of my constables are at the door, and there is a four-wheeler waiting.''	「さて、ミスター・マクファーレン、戸口に警官を2人、外に四輪を待たせてある」
The wretched young man arose, and with a last beseeching glance at us walked from the room.	哀れな若者は立ちあがり、嘆願するような視線を我々に向けると、部屋から出ていった。
The officers conducted him to the cab, but Lestrade remained.	警官はマクファーレンをつれて馬車に乗りこんだが、レストレイドは後に残った。
Holmes had picked up the pages which formed the rough draft of the will, and was looking at them with the keenest interest upon his face.	ホームズは、摘み上げた遺書の下書きを、熱心な興味に満ちた顔で見つめた。
``There are some points about that document, Lestrade,	「なかなか特徴のある文書だね、レストレイド。
are there not?''	どうだ？」
The official looked at them with a puzzled expression.	レストレイドは当惑した表情で書類を眺めた。
``I can read the first few lines,	「最初の数行は読めますね。
and these in the middle of the second page, and one or two at the end.	それに、2枚目の真中あたりと、最後の2、3行も。
Those are as clear as print,''	印刷のようにはっきりと。
``but the writing in between is very bad,	が、しかし、その間の筆跡はかなりひどいな。
and there are three places where I cannot read it at all.''	まったく読めない部分も3ヶ所」
``What do you make of that?'' said Holmes.	「そこから何を想像する？」
``Well, what do you make of it?''	「ふむ、そちらこそ何を？」
``That it was written in a train.	「列車の中で書かれたということさ。
The good writing represents stations, the bad writing movement, and the very bad writing passing over points.	きれいな筆跡は駅を、ひどい筆跡は進行中を、さらにひどい筆跡は転轍機の通過を表しているんだよ。
A scientific expert would pronounce at once that this was drawn up on a suburban line,	科学的専門家なら、この文書は郊外線で書かれたものだと断言するだろう。
since nowhere save in the immediate vicinity of a great city could there be so quick a succession of points.	大都市の周辺部以外に、これほど連続して転轍機が存在しているところはない。
Granting that his whole journey was occupied in drawing up the will,	この推理から、ミスター・オールデイカーは列車の旅の間中、遺言書を書きつづけたのだと思われる。
then the train was an express,	乗っていたのは急行だね。
only stopping once between Norwood and London Bridge.''	ノーウッド―ロンドンブリッジ間で一度しか停車していない」
Lestrade began to laugh.	レストレイドは笑い出した。
``You are too many for me when you begin to get on your theories.	「持論を進めだすとまったく手におえませんね、
Mr. Holmes,''	ミスター・ホームズ」
said he.	とレストレイド。
``How does this bear on the case?''	「それがこの事件にどう影響してくるんですか？」
``Well, it corroborates the young man's story	「そうだな、例の若者の話を補強してくれるね。
to the extent that the will was drawn up by Jonas Oldacre in his journey yesterday.	遺言書がジョナス・オールデイカーによって、昨日、道すがらに書かれたものだというところまで。
It is curious	好奇心をそそられるよ
-- is it not?	――そうだろう？
-- that a man should draw up so important a document in so haphazard a fashion.	――そういう大切な文書を、こんなでたらめな方法で書き上げるとはね。
It suggests that he did not think it was going to be of much practical importance.	どうやら、こいつが実際にたいへん重要なものになるなんて思っていなかったらしい。
If a man drew up a will which he did not intend ever to be effective, he might do it so.''	もし、発効させるつもりがない遺言書を書くんであれば、こんな真似をするかもしれないね」
``Well, he drew up his own death warrant at the same time,''	「まあ、この遺言書と一緒に、自分の死刑執行書を書いたということですよ」
said Lestrade.	とレストレイド。
``Oh, you think so?''	「ほう、君はそう思うかい？」
``Don't you?''	「そうでしょう？」
``Well, it is quite possible,	「なるほど、その可能性は高い。
but the case is not clear to me yet.''	だけどね、僕には事件がまだ明白じゃないんだ」
``Not clear?	「明白じゃない？
Well, if that isn't clear, what could be clear?	だいたい、これが明白でないとすると、いったい何をして明白というのです？
Here is a young man	ここに1人の男がいる。
who learns suddenly that, if a certain older man dies, he will succeed to a fortune.	ある老人が死ねば一財産を相続できるという情報が舞いこんできた。
What does he do?	彼はどうしますか？
He says nothing to anyone,	彼はそのことを誰にも言わない。
but he arranges	代わりに、こう企てるんですよ。
that he shall go out on some pretext to see his client that night.	夜、その老人に会うために出かける。
He waits until the only other person in the house is in bed, and then in the solitude of a man's room he murders him,	家の中にいるもう1人の人物が眠りにつくまで待ち、部屋で老人を殺害する。
burns his body in the wood-pile,	遺体は木材置場で焼き払う。
and departs to a neighbouring hotel.	そして、現場を去り、近くのホテルに泊まる。
The blood-stains in the room and also on the stick are very slight.	部屋の中や、ステッキについた血痕はごくわずか。
It is probable that he imagined his crime to be a bloodless one,	被害者に外傷を残さなかったと思っていたのかもしれない。
and hoped that if the body were consumed it would hide all traces of the method of his death	死体が痛んでしまえば、死因を判定する痕跡も見つからないだろう
-- traces which, for some reason, must have pointed to him.	――何らかの理由で彼が犯人だと指し示す痕跡をね。
Is not all this obvious?''	みんな、明らかなことでしょう？」
``It strikes me, my good Lestrade, as being just a trifle too obvious,''	「胸を打たれるよ、レストレイドくん、あまりにも明らかすぎる些事として」
said Holmes.	とホームズ。
``You do not add imagination to your other great qualities, but if you could for one moment put yourself in the place of this young man,	「君は自分のすばらしい特性の中に、想像力を付け加えようとしないけどね、少しの間、この若者の立場に身を重ねてみるんだ。
would you choose the very night after the will had been made to commit your crime?	君は、問題の遺言書が書かれたその日の夜をだよ、犯行の日時として選ぶのかい？
Would it not seem dangerous to you to make so very close a relation between the two incidents?	この2つの出来事を、そんなに連続して起こすことに危険を感じないのかい？
Again,	まだある。
would you choose an occasion when you are known to be in the house, when a servant has let you in?	君が家の中にいることを誰かに知られているとき、使用人が君を迎え入れたとき、そんなときをチャンスと考えるのかい？
And, finally, would you take the great pains to conceal the body, and yet leave your own stick as a sign that you were the criminal?	おまけに、死体の始末にかなり骨を折っておきながら、自分のステッキを証拠として残していくのかい？
Confess, Lestrade, that all this is very unlikely.''	白状するんだね、レストレイド、どれもまったくありえそうにないって」
``As to the stick, Mr. Holmes, you know as well as I do that a criminal is often flurried, and does such things, which a cool man would avoid.	「ステッキについて言えば、ミスター・ホームズ、ご承知のとおり、犯罪者はときに混乱のあまり、冷静な人間ならやらないようなことをやってしまうものですよ。
He was very likely afraid to go back to the room.	容疑者は部屋に戻るのが怖かったんです。
Give me another theory that would fit the facts.''	他に事実とぴったり合う理論があるのなら、ぜひどうぞ」
``I could very easily give you half a dozen,''	「簡単に半ダースは並べられるよ」
said Holmes.	とホームズ。
``Here, for example, is a very possible	「たとえばさ、こういう話だって可能性がある。
and even probable one.	いや、十分に可能だね。
I make you a free present of it.	無償のプレゼントにしておくよ。
The older man is showing documents which are of evident value.	老人が、見るからに値打ちものと分かる書類を広げている。
A passing tramp sees them through the window,	通りすがりの浮浪者が窓からそれを見る。
the blind of which is only half down.	ブラインドは半分しか降りていない。
Exit the solicitor.	弁護士退出。
Enter the tramp!	浮浪者侵入！
He seizes a stick, which he observes there, kills Oldacre,	そして、目についたステッキを握りしめ、オールデイカーを殺害。
and departs after burning the body.''	死体を焼いて立ち去る」
``Why should the tramp burn the body?''	「なぜ浮浪者は死体を焼かねばならないんですか？」
``For the matter of that, why should McFarlane?''	「その点、マクファーレンはなぜ？」
``To hide some evidence.''	「証拠隠滅のため」
``Possibly the tramp wanted to hide that any murder at all had been committed.''	「浮浪者も殺人の痕跡をすべて隠滅したかったんだろうさ」
``And why did the tramp take nothing?''	「それに、浮浪者はなぜ何もとっていかなかったんですか？」
``Because they were papers that he could not negotiate.''	「なぜなら彼には換金できない書類だったから」
Lestrade shook his head,	レストレイドは首を横に振った。
though it seemed to me that his manner was less absolutely assured than before.	さっきまでの絶対的な自信はややゆらいだようではあったが。
``Well, Mr. Sherlock Holmes, you may look for your tramp,	「それじゃあ、ミスター・シャーロック・ホームズ、浮浪者とやらを探してみるんですね。
and while you are finding him we will hold on to our man.	その間に、我々はあの男の線で調べつづけますから。
The future will show which is right.	時がくればどっちが正しいか判明するでしょう。
Just notice this point, Mr. Holmes:	この点は言っておきますよ、ミスター・ホームズ。
that so far as we know, none of the papers were removed,	我々の知るかぎり、書類は1枚も持ち出されていません。
and that the prisoner is the one man in the world who had no reason for removing them,	そして、容疑者は世界でただひとり、書類を持ち出す必要がない人物です。
since he was heir-at-law, and would come into them in any case.''	彼は法定相続人であり、いかなる場合もすべてを手にするんですから」
My friend seemed struck by this remark.	この言葉はこたえたらしい。
``I don't mean to deny that the evidence is in some ways very strongly in favour of your theory,'' said he.	「いや、その証拠がそれなりに君の考えに味方するってことを否定するつもりはないんだ。
``I only wish to point out that there are other theories possible.	ただ、別の考え方もありえるんじゃないかと言っておきたかっだだけでね。
As you say, the future will decide.	君の言うとおり、時が判定を下してくれるだろう。
Good-morning!	ごきげんよう！
I dare say that in the course of the day I shall drop in at Norwood and see how you are getting on.''	とりあえず、今日中にノーウッドによって、捜査がどれくらい進んだかを見にいくよ」
When the detective departed, my friend rose and made his preparations for the day's work	レストレイドが出ていくと、ホームズは立ち上がり、今日の活動のための準備をした。
with the alert air of a man who has a congenial task before him.	好みの仕事を目前にした人間に見られる、きびきびした様子で。
``My first movement, Watson,''	「捜査の初動は」
said he, as he bustled into his frockcoat,	と、フロックコートをすばやく身につけながら言った。
``must, as I said, be in the direction of Blackheath.''	「言ったとおり、ブラックヒース方面だよ、ワトスン」
``And why not Norwood?''	「なぜノーウッドじゃないんだい？」
``Because we have in this case one singular incident coming close to the heels of another singular incident.	「この事件は、2つの奇妙な事件が密接に連なったものだからだよ。
The police are making the mistake of concentrating their attention upon the second, because it happens to be the one which is actually criminal.	警察は、第二の事件が現に犯罪だからといって、そちらばかりに注目するという誤りを犯している。
But it is evident to me that the logical way to approach the case is to begin by trying to throw some light upon the first incident	だけど、論理的にこの事件に取りかかるには、第一の事件に光を投げかけないといけないんだ。
-- the curious will, so suddenly made, and to so unexpected an heir.	第一の事件とは何か
It may do something to simplify what followed.	そのあたりを明らかにしておけば、後の事件も多少分かりやすくなるかもしれない。
No, my dear fellow, I don't think you can help me.	いや、ワトスンくん、君が手を借せることはないと思う。
There is no prospect of danger,	いや、危険の見通しもないし。
or I should not dream of stirring out without you.	危なそうだったら、君をおいて動き回るなんて夢にも見ないよ。
I trust that when I see you in the evening, I will be able to report that I have been able to do something for this unfortunate youngster, who has thrown himself upon my protection.''	きっと、夕方に顔を合わせたときは、僕に保護を求めてきた不運なる若人のために何か報告できると思うよ」
It was late when my friend returned,	ホームズの帰りは遅かった。
and I could see, by a glance at his haggard and anxious face, that the high hopes with which he had started had not been fulfilled.	やつれた、不満そうな表情からして、捜査開始時に抱いていた高い期待は果たされなかったのだと見うけられる。
For an hour he droned away upon his violin, endeavouring to soothe his own ruffled spirits.	一時間ほど、苛立つ心を慰めようとバイオリンを唸らせていたが、
At last he flung down the instrument, and plunged into a detailed account of his misadventures.	やがて放り出すと、急に失敗談を細部に渡って話し始めた。
``It's all going wrong, Watson	「何もかもが失敗だ、ワトスン
-- all as wrong as it can go.	――あらゆる手がこよなく失敗する。
I kept a bold face before Lestrade, but, upon my soul, I believe that for once the fellow is on the right track and we are on the wrong.	レストレイドの前では図太い態度を崩さなかったけど、驚くなかれ、今度ばかりはあいつの線が正しくて、僕のは間違っているんだと信じるよ。
All my instincts are one way,	僕のあらゆる勘が、ひとつの流れを描いている。
and all the facts are the other,	そして、事実はすべて逆をいっている。
and I much fear that British juries have not yet attained that pitch of intelligence when they will give the preference to my theories over Lestrade's facts.''	きわめて残念なことだけど、イギリスの陪審員が知性の頂点をきわめて、レストレイドの事実より僕の推理の方を好んでくれるようになるのはまだ先のことだろうね」
``Did you go to Blackheath?''	「ブラックヒースに行ったのか？」
``Yes, Watson,	「そうとも、ワトスン。
I went there, and I found very quickly that the late lamented Oldacre was a pretty considerable blackguard.	故オールデイカーはかなりの悪党だったことがすぐに分かったよ。
The father was away in search of his son.	父親は息子を探しに出かけていた。
The mother was at home	母親は家にいた
-- a little, fluffy, blue-eyed person, in a tremor of fear and indignation.	――頭の軽そうな、青い目をした小柄な人でね、不安と憤慨に体中を震わせていた。
Of course, she would not admit even the possibility of his guilt.	息子が犯人なはずがないって決めつけててさ。
But she would not express either surprise or regret over the fate of Oldacre.	だけど、オールデイカーの不幸については、驚きも嘆きも表さなかった。
On the contrary, she spoke of him with such bitterness	それとは逆に、たいへんな手厳しさでオールデイカーをやっつけるんだよ。
that she was unconsciously considerably strengthening the case of the police for, of course, if her son had heard her speak of the man in this fashion, it would predispose him towards hatred and violence.	あれを息子の耳にふきこんでいたとしたら、その心情は憎悪と暴力に向けて傾いていったに違いない。
`He was more like a malignant and cunning ape than a human being,'	『あの男は人間というより狡猾な猿です』
said she,	と母親は言う。
`and he always was, ever since he was a young man.'	『いつだってそうでした、若いころからずっと今まで』
```You knew him at that time?' said I.	「『その頃から彼を知っていると？』
'' `Yes, I knew him well,	「『ええ、よく知っていますとも。
in fact, he was an old suitor of mine.	実は、昔の求婚者なんです。
Thank heaven	神よ、感謝いたします。
that I had the sense to turn away from him and to marry a better,	彼から目を背け、よりよい人と結婚する判断力を私にお与えくださったことに。
if poorer, man.	たとえ、その人が彼より貧しくとも。
I was engaged to him.	彼とは婚約していました、ミスター・ホームズ。
Mr. Holmes, when I heard a shocking story	そのころ、ひどい話を耳に挟んだんです。
of how he had turned a cat loose in an aviary, and I was so horrified at his brutal cruelty that I would have nothing more to do with him.'	何でも、鳥たちの檻に猫を放ったとか言う話で、私はあまりの冷酷無慈悲さに怖くなりましたから、彼とはそれ以上つきあわないことにしたんです』
```Well,' said I,	「『なるほど。
`at least he has forgiven you now,	何はともあれ、ミスター・オールデイカーはあなたのことをお許しのようですね。
since he has left all his property to your son.'	全財産を息子さんに遺そうというのですから』
```Neither my son nor I want anything from Jonas Oldacre,	「『私も息子も、なにひとつジョナス・オールデイカーから受け取りたくはありません。
dead or alive!'	死後も生前も！』
she cried, with a proper spirit.	と気高い心意気を叫ぶんだ。
`There is a God in heaven, Mr. Holmes,	『天には神さまがおられます、ミスター・ホームズ。
and that same God who has punished that wicked man will show, in His own good time, that my son's hands are guiltless of his blood.'	悪人に天罰を下した神さまが、折りを見て、息子の手があの男の血で汚れていないことも証明くださいます』
``Well, I tried one or two leads, but could get at nothing which would help our hypothesis,	「それで、少しカマをかけてみたけど、我々の仮説に役立ちそうなものは得られなかった。
and several points which would make against it.	それどころか、いくつか仮説に異を唱える点すらあったよ。
I gave it up at last, and off I went to Norwood.	結局、あきらめてノーウッドに向かった。
``This place, Deep Dene House, is a big modern villa of staring brick,	「ディープ・ディーン・ハウスというところは大きな煉瓦造りの邸だった。
standing back in its own grounds, with a laurel-clumped lawn in front of it.	この現代風の建物は敷地内の奥に居座っていて、門前に広がる芝生には月桂樹の木立があった。
To the right and some distance back from the road was the timber-yard which had been the scene of the fire.	右手の、やや道から離れたところには、火災の現場となった木材置場がある。
Here's a rough plan on a leaf of my notebook.	これだ、手帳を1枚破ってだいたいの図を書いておいたよ。
This window on the left is the one which opens into Oldacre's room.	左にあるこの窓が、オールデイカーの部屋に通じている。
You can look into it from the road, you see.	見てのとおり、道から部屋の中を覗きこめるんだ。
That is about the only bit of consolation I have had to-day.	これが、今日僕が手にした唯一の慰めだね。
Lestrade was not there, but his head constable did the honours.	レストレイドはいなかったけど、巡査長が代役の栄誉を担っていた。
They had just found a great treasure-trove.	ちょうど重大な発見をしたところだったらしい。
They had spent the morning raking among the ashes of the burned wood-pile, and besides the charred organic remains they had secured several discoloured metal discs.	連中、朝から燃え尽きた木材の灰を掻きまわし続けて、炭化した有機物と、色が落ちた円形の金属をいくつか手に入れたんだ。
I examined them with care, and there was no doubt that they were trouser buttons.	僕が調べてみると、それがズボンのボタンに間違いない。
I even distinguished that one of them was marked with the name of `Hyams,'	うちひとつからは、『ハイアムス』の名前が入ったマークを見て取ることができた。
who was Oldacre's tailor.	オールデイカーの仕立て屋の名前だ。
I then worked the lawn very carefully for signs and traces, but this drought has made everything as hard as iron.	それから、芝生の上に痕跡が残されていないかていねいに取り組んだけど、連日の日照りが何でも鉄のように堅くしてしまっていた。
Nothing was to be seen save	何も見つかるわけがない。
that some body or bundle had been dragged through a low privet hedge which is in a line with the wood-pile.	人か何かを引きずって、木材と平行に植えられているイボタノキの垣根を抜けた跡があっただけだ。
All that, of course, fits in with the official theory.	言うまでもなく、こいつはレストレイドの見解を裏づけている。
I crawled about the lawn with an August sun on my back, but I got up at the end of an hour no wiser than before.	8月の太陽を背にして芝生の上を這いずり回ったけど、1時間後、何の新事実もえられないまま起き上がった。
``Well, after this fiasco I went into the bedroom and examined that also.	「さて、この大失敗の後、寝室に入ってここも調べてみた。
The blood-stains were very slight, mere smears and discolourations, but undoubtedly fresh.	血痕はきわめて薄く、単なるしみや変色のようにも見えたけど、確かに最近のものだった。
The stick had been removed, but there also the marks were slight.	ステッキは動かされていたけど、そこにも薄い血痕があった。
There is no doubt about the stick belonging to our client.	このステッキが依頼人の所有物であるのは疑う余地もない。
He admits it.	依頼人がそうだと認めている。
Footmarks of both men could be made out on the carpet, but none of any third person,	両人の足跡が絨毯の上に残されていたけど、第三の人物の足跡はない。
which again is a trick for the other side.	ここもまた、向こう側の勝ちだ。
They were piling up their score all the time and we were at a standstill.	警察は得点を重ね続け、僕らは行き詰まっている。
``Only one little gleam of hope did I get	「手にしたのは、ただ一条の希望の光
-- and yet it amounted to nothing.	――無にも等しい微かな光とはいえ。
I examined the contents of the safe, most of which had been taken out and left on the table.	金庫の中身は、大部分がテーブルの上に出されていた。
The papers had been made up into sealed envelopes, one or two of which had been opened by the police.	調べてみると、書類は封筒に入れて封をされており、ごく一部は警察によって開かれていた。
They were not, so far as I could judge, of any great value, nor did the bank-book show that Mr. Oldacre was in such very affluent circumstances.	僕の見たかぎりでは、あまり価値のあるものではなかったし、預金通帳を見ても、ミスター・オールデイカーが言われるほど豊かな境遇にあった様子はない。
But it seemed to me that all the papers were not there.	でも、どうやらすべての書類がそこにあったわけではなさそうだ。
There were allusions to some deeds	間接的な証拠から他にも権利書があるはずなんだが
-- possibly the more valuable	――もっと価値のあるやつだ
-- which I could not find.	――見つけきれなかった。
This, of course, if we could definitely prove it, would turn Lestrade's argument against himself;	もちろんこのことは、もし証明できれば、レストレイド説をレストレイド自身にはねかえしてくれるだろう。
for who would steal a thing if he knew that he would shortly inherit it?	すぐに相続できると知っているものを誰が盗もうか？　とね。
``Finally, having drawn every other cover and picked up no scent, I tried my luck with the housekeeper.	「結局、ほかの藪にはぜんぶ飛びこみ、獲物の気配がないことを確認したから、家政婦に賭けてみた。
Mrs. Lexington is her name -- a little, dark, silent person, with suspicious and sidelong eyes.	名前はミセス・レキシントン、小柄で陰気で無口な人物で、疑り深そうな目つきをしている。
She could tell us something if she would	口で言う以上に何かを知っていた
-- I am convinced of it.	――僕はそう確信している。
But she was as close as wax.	だけど、石のように無口な女だった。
Yes, she had let Mr. McFarlane in at half-past nine.	いわく――9時半すぎにミスター・マクファーレンをお通しした。
She wished her hand had withered before she had done so.	自分の手がその前に萎びてしまえばよかったのに。
She had gone to bed at half-past ten.	10時半すぎに横になった。
Her room was at the other end of the house, and she could hear nothing of what passed.	部屋は家の反対側にあり、物音は聞こえなかった。
Mr. McFarlane had left his hat, and to the best of her belief his stick, in the hall.	ミスター・マクファーレンは帽子と、信じるかぎりではステッキをホールに置いていった。
She had been awakened by the alarm of fire.	火事騒ぎで目を覚ました。
Her poor, dear master had certainly been murdered.	哀れにも、大切な旦那さまは殺されたのだ。
Had he any enemies?	敵の存在は？
Well, every man had enemies,	そう、人は誰でも敵を抱えているという。
but Mr. Oldacre kept himself very much to himself, and only met people in the way of business.	でもミスター・オールデイカーは人付き合いを避けていたし、会う人も仕事関係の人だけだった。
She had seen the buttons, and was sure that they belonged to the clothes which he had worn last night.	ボタンを見ると、確かに昨日着ていた服についていたものだ。
The wood-pile was very dry, for it had not rained for a month.	木材は、1ヶ月も雨がないものだから、かなり乾いていた。
It burned like tinder, and by the time she reached the spot, nothing could be seen but flames.	火口のように燃え上がって、現場に着いたときには炎以外には何も見えなかった。
She and all the firemen smelled the burned flesh from inside it.	消防の人と同じく、肉が焼ける匂いをかいだ。
She knew nothing of the papers, nor of Mr. Oldacre's private affairs.	書類についても、オールデイカーの個人的な仕事も、まったく知らない――だそうだ。
``So, my dear Watson, there's my report of a failure.	「というわけで、ワトスンくん、失敗の報告は以上。
And yet	それでも
-- and yet -- ''	――それでもね――」
he clenched his thin hands in a paroxysm of conviction	――ホームズは細い手を信念の激情に握り締めた
-- ``I know it's all wrong.	――「何もかもが間違っている。
I feel it in my bones.	確かにそう感じる。
There is something that has not come out, and that housekeeper knows it.	まだ明らかになっていないことがあって、あの家政婦がそれを知っている。
There was a sort of sulky defiance in her eyes, which only goes with guilty knowledge.	瞳の中にあった陰鬱な抵抗の光、あれはやましいことを知っている人間の目つきだ。
However, there's no good talking any more about it, Watson;	とは言え、これ以上ここで喋りつづけたって、どうにかなるものじゃないね、ワトスン。
but unless some lucky chance comes our way I fear that the Norwood Disappearance Case will not figure in that chronicle of our successes	ただ、幸運でもつかまないかぎり、ノーウッド失踪事件は僕らの成功話として描かれることはないだろうな。
which I foresee that a patient public will sooner or later have to endure.''	僕には我慢強い大衆がさらに待たされることになるのが目に見えるようだ」
``Surely,''	「そうだなあ」
said I,	と私。
``the man's appearance would go far with any jury?''	「あの男の外見は陪審員を動かすのでは？」
``That is a dangerous argument, my dear Watson.	「それは危険な意見だよ、ワトスンくん。
You remember that terrible murderer, Bert Stevens,	凶悪殺人犯バート・スティーブンスを覚えているね？
who wanted us to get him off in '87?	87年に自分から手をひけと言ってきたあの男を。
Was there ever a more mild-mannered, Sunday-school young man?''	今回の依頼人よりも穏やかな物腰で、日曜学校の若者のようだっただろう？」
``It is true.''	「なるほど」
``Unless we succeed in establishing an alternative theory, this man is lost.	「取って代わる理論を確立できないかぎり、この男は負ける。
You can hardly find a flaw in the case which can now be presented against him, and all further investigation has served to strengthen it.	今のところ、彼の容疑からはほとんど欠点が見つからないだろうし、捜査も向こうの主張を強化するのに役立つばかりだ。
By the way, there is one curious little point about those papers which may serve us as the starting-point for an inquiry.	ところで、あの書類については、ひとつ、僕らの役に立ちそうな面白い部分があってね。
On looking over the bank-book I found that the low state of the balance was principally due to large checks which have been made out during the last year to Mr. Cornelius.	通帳を調べると、残高が少ないのは、昨年中、ミスター・コーネリアスに多額の小切手を切っているのが主な原因らしい。
I confess that I should be interested to know who this Mr. Cornelius may be with whom a retired builder has had such very large transactions.	引退した建築家との間に多額の取引を行っているミスター・コーネリアスとはいかなる人物か、正直に言って、ぜひ知りたいところだね。
Is it possible that he has had a hand in the affair?	この男が事件に絡んでくる可能性はあるだろうか？
Cornelius might be a broker, but we have found no scrip to correspond with these large payments.	コーネリアスは仲買人かもしれないけど、こういった多額の支払に該当する書類はまったく見つかっていないんだ。
Failing any other indication, my researches must now take the direction of an inquiry at the bank	ほかの手がかりはみんな駄目だった以上、捜査の方向を、銀行の調査に向けるしかない。
for the gentleman who has cashed these checks.	誰がこの小切手を現金化しているのか問い合わせてみるよ。
But I fear, my dear fellow,	ただ心配だね、ワトスン。
that our case will end ingloriously by Lestrade hanging our client,	僕らの主張が無様な結果に終わりそうな気がする。
which will certainly be a triumph for Scotland Yard.''	レストレイドが依頼人を絞首台に送りこんで、スコットランドヤードの大勝利ってわけさ」
I do not know how far Sherlock Holmes took any sleep that night,	この夜、シャーロック・ホームズが睡眠をとったのかどうかすら、私には分からない。
but when I came down to breakfast I found him pale and harassed,	私が朝食に下りてきてたときにはもう、青白い、憔悴した姿がそこにあった。
his bright eyes the brighter for the dark shadows round them.	その瞳は、黒い隈のせいで、普段よりも明るく輝いて見えた。
The carpet round his chair was littered with cigarette-ends and with the early editions of the morning papers.	椅子まわりの絨毯には、煙草の吸殻や、さまざまな朝刊の早版が散らばっている。
An open telegram lay upon the table.	電報が1通、テーブルの上に広げてあった。
``What do you think of this, Watson?''	「こいつをどう思う、ワトスン？」
he asked, tossing it across.	ホームズはその電報を弾いてよこした。
It was from Norwood,	発信地はノーウッド。
and ran as follows:	中身は――
Important fresh evidence to hand.	「ジュウダイナ　シンショウコ　ハッケン．
McFarlane's guilt definitely established.	マクファーレンノ　ユウザイ　カクテイセリ．
Advise you to abandon case.	チュウコクスル　ジケンヲ　ホウキセヨ．
LESTRADE.	――レストレイド」
``This sounds serious,''	「これは痛いね」
said I.	と私。
``It is Lestrade's little cock-a-doodle of victory,''	「レストレイド鳥のつまらん勝鬨さ」
Holmes answered, with a bitter smile.	ホームズは冷笑した。
``And yet it may be premature to abandon the case.	「事件を放棄するのは後でもいいだろう。
After all, important fresh evidence is a two-edged thing,	重大な新証拠ってのは諸刃の剣なんだ。
and may possibly cut in a very different direction to that which Lestrade imagines.	もしかすると、レストレイドがまったく想像だにしない方向に切りこむかもしれない。
Take your breakfast, Watson,	朝食をすませるんだ、ワトスン。
and we will go out together and see what we can do.	そして、何ができるのかを2人で見にいこう。
I feel as if I shall need your company and your moral support to-day.''	今日は、君の精神的支援が必要になりそうな感じがするんでね」
My friend had no breakfast himself,	ホームズは朝食をとらなかった。
for it was one of his peculiarities that in his more intense moments he would permit himself no food, and I have known him presume upon his iron strength until he has fainted from pure inanition.	これはホームズの特徴のひとつで、情熱が活動期に入ると食事をとろうとしなくなり、まったくの栄養失調で倒れるまで、自分の鋼のような強さを利用しつくしたこともあったのだ。
``At present I cannot spare energy and nerve force for digestion,''	「今、気力や精神力を消化などに使えるものか」
he would say in answer to my medical remonstrances.	私の医学的な注意に対して、ホームズはそう答えるだろう。
I was not surprised, therefore, when this morning he left his untouched meal behind him, and started with me for Norwood.	この日も、ホームズは朝食に手をつけないままノーウッドに出発した。
A crowd of morbid sightseers were still gathered round Deep Dene House,	いまだに、不健全な見物客がディープ・ディーン・ハウス周辺に群れをなしていた。
which was just such a suburban villa as I had pictured.	ディープ・ディーン・ハウス自体は、私が胸に描いていたような邸だった。
Within the gates Lestrade met us, his face flushed with victory, his manner grossly triumphant.	門の内側では、レストレイドが、顔に勝利の色をみなぎらせ、見るからに勝ち誇った態度で我々を出迎えた。
``Well, Mr. Holmes, have you proved us to be wrong yet?	「それで、ミスター・ホームズ、我々の誤りを立証できましたか？
Have you found your tramp?''	浮浪者とやらはみつかりましたか？」
he cried.	レストレイドは喚いた。
``I have formed no conclusion whatever,''	「僕はまだ結論を出したことなどないよ、どういう結論も」
my companion answered.	とホームズ。
``But we formed ours yesterday,	「ところが、我々は昨日、結論を下しましたよ。
and now it proves to be correct,	そして今や、それが正しいと証明されています。
so you must acknowledge that we have been a little in front of you this time, Mr. Holmes.''	ですから、今回は我々が少しばかり先んじていたと、認めてもらわねばなりませんよ、ミスター・ホームズ」
``You certainly have the air of something unusual having occurred,'' said Holmes.	「その様子では、きっと何か変わったことでもあったんだね」
Lestrade laughed loudly.	レストレイドは大声で笑い始めた。
``You don't like being beaten any more than the rest of us do,''	「この中の誰よりも負けず嫌いなんですね」
said he.	とレストレイド。
``A man can't expect always to have it his own way,	「人は常に自分の道を行けるとはかぎらない。
can he, Dr. Watson?	そうですよね、ドクター・ワトスン？
Step this way, if you please, gentlemen,	みなさま、もしよろしければこちらへお進みください。
and I think I can convince you once for all that it was John McFarlane who did this crime.''	犯人はジョン・マクファーレンその人であることを、きっぱりとお見せいたしましょう」
He led us through the passage and out into a dark hall beyond.	我々はレストレイドに随って通路を抜け、薄暗いホールに出た。
``This is where young McFarlane must have come out to get his hat after the crime was done,''	「ここは、若きマクファーレンが犯行後に帽子を取りにきた場所でございます」
said he.	とレストレイド。
``Now look at this.''	「では、こちらをご覧あれ」
With dramatic suddenness he struck a match, and by its light exposed a stain of blood upon the whitewashed wall.	レストレイドは、この芝居がかったタイミングでマッチをすると、漆喰の壁に残された血痕を照らし出した。
As he held the match nearer, I saw that it was more than a stain.	レストレイドがマッチを近づけるにつれて、それが単なる血痕以上のものであることが分かった。
It was the well-marked print of a thumb.	それは、しっかりと押された親指の指紋だった。
``Look at that with your magnifying glass, Mr. Holmes.''	「拡大鏡でご覧ください、ミスター・ホームズ」
``Yes, I am doing so.''	「ええ、そういたしますとも」
``You are aware that no two thumb-marks are alike?''	「同じ指紋が二つとないのはご承知でしょうね？」
``I have heard something of the kind.''	「そういうふうに聞いてるよ」
``Well, then, will you please compare that print	「さてさてそれでは、この蝋の上の指紋とお比べ願えましょうか？
with this wax impression of young McFarlane's right thumb, taken by my orders this morning?''	今朝、私が命じて取らせておいた、若きマクファーレンの右親指の指紋にございます」
As he held the waxen print close to the blood-stain, it did not take a magnifying glass to see that the two were undoubtedly from the same thumb.	レストレイドが蝋を血痕に近づけると、拡大鏡を使うまでもなく、2つの指紋が同一の指からとられたものだと見て取ることができた。
It was evident to me that our unfortunate client was lost.	不運な依頼人の敗北が明らかになったのだ。
``That is final,''	「これで決まりです」
said Lestrade.	とレストレイド。
``Yes, that is final,''	「うん、これで決まりだな」
I involuntarily echoed.	と私も和した。
``It is final,''	「それで決まったよ」
said Holmes.	とホームズ。
Something in his tone caught my ear, and I turned to look at him.	どこか耳に引っかかる声音だったので、ホームズのほうに振り返った。
An extraordinary change had come over his face.	表情に大きな変化が訪れていた。
It was writhing with inward merriment.	浮かれ騒ぐ心に身悶えしている。
His two eyes were shining like stars.	両眼は星のように輝いていた。
It seemed to me that he was making desperate efforts to restrain a convulsive attack of laughter.	押し寄せる笑いの発作を、必死の努力で抑えているようだ。
``Dear me! Dear me!''	「いやいやまったく！」
he said at last.	やがてホームズは口を開いた。
``Well, now, who would have thought it?	「そうとも、いったい何を考えてきたんだろう？
And how deceptive appearances may be, to be sure!	見た目なんてごまかしばかりだ、確かにね！
Such a nice young man to look at!	りっぱな若者のようだったのに！
It is a lesson to us not to trust our own judgment,	これはね、自分の判断を信頼するなという教訓だよ。
is it not, Lestrade?''	そうだろう、レストレイド？」
``Yes, some of us are a little too much inclined to be cocksure, Mr. Holmes,''	「ええ、我々の中には少しばかり自信過剰な人もいますしね、ミスター・ホームズ」
said Lestrade.	とレストレイド。
The man's insolence was maddening, but we could not resent it.	その横柄な態度が苛立たしいが、我々には返す言葉もない。
``What a providential thing that this young man should press his right thumb against the wall in taking his hat from the peg!	「若者が帽子を釘から外しながら、右の親指を壁に押し付ける。
Such a very natural action, too, if you come to think if it.''	自然な動作でもあるよ、ここに立って考えてみれば」
Holmes was outwardly calm, but his whole body gave a wriggle of suppressed excitement as he spoke.	ホームズは一見すると冷静だったが、話しながら、興奮を抑えこむように全身をそわそわさせていた。
``By the way, Lestrade, who made this remarkable discovery?''	「ところでレストレイド、この注目すべき発見をしたのは誰だ？」
``It was the housekeeper, Mrs. Lexington,	「家政婦のミセス・レキシントンです。
who drew the night constable's attention to it.''	夜勤の警官に知らせてくれました」
``Where was the night constable?''	「その警官はどこに？」
``He remained on guard in the bedroom where the crime was committed,	「残って犯行現場である寝室の警備に入っています。
so as to see that nothing was touched.''	誰も手を触れないように」
``But why didn't the police see this mark yesterday?''	「でも、どうして警察は昨日のうちに気がつかなかったんだ？」
``Well, we had no particular reason to make a careful examination of the hall.	「まあ、ホールを注意深く調べる理由は特にありませんでしたからね。
Besides, it's not in a very prominent place, as you see.''	ご覧のとおり、非常に目立つ場所というわけではありませんし」
``No, no	「そうか。
-- of course not.	そうとも、そのとおりだ。
I suppose there is no doubt that the mark was there yesterday?''	問題の指紋が昨日からそこにあったのは間違いないだろうね？」
Lestrade looked at Holmes	レストレイドはホームズを見た。
as if he thought he was going out of his mind.	まるで、気が狂ったのだとでも思っているかのような目つきだった。
I confess that I was myself surprised both at his hilarious manner and at his rather wild observation.	正直に言って、私自身も、ホームズの浮かれた態度やでたらめな発言に呆れていた。
``I don't know whether you think that McFarlane came out of jail in the dead of the night in order to strengthen the evidence against himself,'' said Lestrade.	「マクファーレンが自分に不利な証拠を追加するために、夜、留置所を抜け出してきたとでも思うんですか？
``I leave it to any expert in the world whether that is not the mark of his thumb.''	指紋がマクファーレンのものではないのか、世界中のどの専門家にだって任せられますよ」
``It is unquestionably the mark of his thumb.''	「間違いなく彼の指紋だけどね」
``There, that's enough,'' said Lestrade.	「じゃあ、それで十分です。
``I am a practical man, Mr. Holmes,	私は現実的な人間です、ミスター・ホームズ。
and when I have got my evidence I come to my conclusions.	証拠を握ったときは、結論を下すのですよ。
If you have anything to say, you will find me writing my report in the sitting-room.''	また何か言いたいことあるんでしたら、私は居間で報告書を書いていますから」
Holmes had recovered his equanimity, though I still seemed to detect gleams of amusement in his expression.	ホームズは落ち着きを取り戻していたが、それでも表情にはかすかな喜色を浮かべていた。
``Dear me, this is a very sad development, Watson, is it not?'' said he.	「まったく、実に残念な展開だね、ワトスン？
``And yet there are singular points about it which hold out some hopes for our client.''	それでも、依頼人の希望を繋ぐ奇妙な点もあるよ」
``I am delighted to hear it,''	「聞かせてもらえると嬉しいね」
said I, heartily.	と、私は心から言った。
``I was afraid it was all up with him.''	「もう終わりかと思っていた」
``I would hardly go so far as to say that, my dear Watson.	「まだ何とも言いがたいところでね、ワトスンくん。
The fact is that there is one really serious flaw in this evidence to which our friend attaches so much importance.''	実のところ、レストレイドがたいそう重要視しているあの証拠には、本当に重大な欠点があるんだ」
``Indeed, Holmes!	「そうなのかい、ホームズ！
What is it?''	いったいどんな？」
``Only this:	「ただね、僕は知っているんだよ。
that I know that that mark was not there when I examined the hall yesterday.	あの血痕は、昨日ホールを調べたときにはなかったと、知っているんだ。
And now, Watson, let us have a little stroll round in the sunshine.''	さ、ワトスン、日向をちょっと散歩しよう」
With a confused brain, but with a heart into which some warmth of hope was returning, I accompanied my friend in a walk round the garden.	2人で庭を歩き回った。
Holmes took each face of the house in turn, and examined it with great interest.	ホームズは家をいろんな向きから、興味深そうに調べた。
He then led the way inside, and went over the whole building from basement to attic.	それから道を通って中に入って、地下室から屋根裏部屋まで見て回った。
Most of the rooms were unfurnished, but none the less Holmes inspected them all minutely.	ほとんどの部屋には家具が置かれていなかったが、それでもホームズはあらゆる部屋を細々と調べていった。
Finally, on the top corridor, which ran outside three untenanted bedrooms, he again was seized with a spasm of merriment.	最後に、使われていない寝室が3つある最上階の廊下にくると、ホームズは再び先ほどの発作に襲われた。
``There are really some very unique features about this case, Watson,'' said he.	「この事件には、まったく、実にユニークな特徴があるね、ワトスン。
``I think it is time now that we took our friend Lestrade into our confidence.	レストレイドくんに僕らの秘密を打ち明けてやるときだと思う。
He has had his little smile at our expense, and perhaps we may do as much by him,	僕らをだしにほくそえんできたから、同じだけのことをしてやってもいいだろう。
if my reading of this problem proves to be correct.	もし僕の読みが正しかったと分かればね。
Yes, yes, I think I see how we should approach it.''	ああそうだ、こうやればよさそうだな」
The Scotland Yard inspector was still writing in the parlour when Holmes interrupted him.	スコットランドヤードの警部は、まだ応接室で書類を書いていたが、そこにホームズが割りこんだ。
``I understood that you were writing a report of this case,'' said he.	「なるほど、この事件の報告書を書いているんだね」
``So I am.''	「そうですよ」
``Don't you think it may be a little premature?	「まだちょっと早いと思わないか？
I can't help thinking that your evidence is not complete.''	僕は、その証拠が完璧ではないと思わずにはいられないよ」
Lestrade knew my friend too well to disregard his words.	レストレイドは非常によくホームズの事を知っていたので、その言葉を無視できなかった。
He laid down his pen and looked curiously at him.	ペンを置き、興味深そうにホームズを眺めた。
``What do you mean, Mr. Holmes?''	「どういう意味ですか、ミスター・ホームズ？」
``Only that there is an important witness whom you have not seen.''	「ただ、君がまだ会っていない重要な証人が1人いるということだよ」
``Can you produce him?''	「連れてこられますか？」
``I think I can.''	「たぶんね」
``Then do so.''	「では連れてきてください」
``I will do my best.	「ベストを尽すよ。
How many constables have you?''	部下は何人いる？」
``There are three within call.''	「呼び声が聞こえるところに3人」
``Excellent!''	「完璧だ！」
said Holmes.	と、ホームズ。
``May I ask if they are all large, able-bodied men with powerful voices?''	「3人とも頑丈で大柄な警官で、力強い声をしているのか、聞いてみてもいいかな？」
``I have no doubt they are,	「そうですとも。
though I fail to see what their voices have to do with it.''	部下の声がどう何になるのかは分かりかねますがね」
``Perhaps I can help you to see that	「まあ、分かってもらえると思うよ。
and one or two other things as well,''	2、3のおまけつきでね」
said Holmes.	とホームズ。
``Kindly summon your men, and I will try.''	「どうぞ、部下を呼んでください、やってみせましょう」
Five minutes later, three policemen had assembled in the hall.	5分後、3人の警官がホールに揃った。
``In the outhouse you will find a considerable quantity of straw,''	「納屋にかなりの藁があるはずです」
said Holmes.	とホームズ。
``I will ask you to carry in two bundles of it.	「2束、もってきていただくようお願いしましょうか。
I think it will be of the greatest assistance in producing the witness whom I require.	あの証人を連れてくるのにもっとも役に立つ小道具でありましょうからね。
Thank you very much.	どうもありがとうございます。
I believe you have some matches in your pocket, Watson.	ポケットにマッチはあるかい、ワトスン。
Now, Mr. Lestrade, I will ask you all to accompany me to the top landing.''	さあ、ミスター・レストレイド、上の踊り場までお越し願いましょうか」
As I have said, there was a broad corridor there, which ran outside three empty bedrooms.	前にも言ったとおり、最上階には広い廊下があり、内側に空の寝室が3つ並んでいた。
At one end of the corridor we were all marshalled by Sherlock Holmes, the constables grinning and Lestrade staring at my friend with amazement, expectation, and derision chasing each other across his features.	廊下の端で、我々はみなシャーロック・ホームズの指揮の元に整列させられたが、警官たちはにやにや笑っているし、レストレイドの瞳の中では、驚き、期待、嘲笑がお互いに追いかけあいをしていた。
Holmes stood before us with the air of a conjurer who is performing a trick.	ホームズは、トリックを実演中の奇術師のような雰囲気で我々の前に立った。
``Would you kindly send one of your constables for two buckets of water?	「部下の方お1人を、バケツに2杯分、水を汲みに出していただけますか？
Put the straw on the floor here, free from the wall on either side.	藁はここの床にどうぞ、壁から離して置いてください。
Now I think that we are all ready.''	さて、準備が完全に整いました」
Lestrade's face had begun to grow red and angry.	レストレイドは、顔を真っ赤にして怒り始めた。
``I don't know whether you are playing a game with us, Mr. Sherlock Holmes,'' said he.	「我々を相手にお遊びでもやっているんですか、ミスター・シャーロック・ホームズ。
``If you know anything, you can surely say it without all this tomfoolery.''	もし何かを知っているのでしたら、こんな馬鹿げた真似をせずに、それを言ってくれてもいいでしょう」
``I assure you, my good Lestrade, that I have an excellent reason for everything that I do.	「だからね、レストレイドくん、僕のやることにはすべて完璧な理由があるんだよ。
You may possibly remember that you chaffed me a little,	僕をちょっとばかり冷やかしたのを思い出してくれるかい？
some hours ago, when the sun seemed on your side of the hedge,	数時間前、太陽が君の方に出ていたように見えたときのことを。
so you must not grudge me a little pomp and ceremony now.	だったら、僕のちょっとした華麗な式典を静かに見ていてもらいたいね。
Might I ask you, Watson, to open that window,	頼めるかな、ワトスン、窓を開けて欲しい。
and then to put a match to the edge of the straw?''	それから、マッチで藁の端に火をつけてくれ」
I did so,	私はそうした。
and driven by the draught, a coil of gray smoke swirled down the corridor,	隙間風に吹かれて、灰色の煙が廊下に渦巻いた。
while the dry straw crackled and flamed.	その一方、乾いた藁が爆ぜながら炎を上げている。
``Now we must see if we can find this witness for you, Lestrade.	「さあ、証人を君の前に連れてこれるかどうか試さないとね、レストレイド。
Might I ask you all to join in the cry of `Fire!'?	みなさん、声を揃えて『火事だ！』と叫んでいただけますか？
Now then; one, two, three -- ''	ではいきましょう、ワン、ツー、スリー――」
``Fire!''	「火事だ！」
we all yelled.	我々は全員で怒鳴った。
``Thank you.	「恐縮です。
I will trouble you once again.''	もう一度お願いしましょうか」
``Fire!''	「火事だ！」
``Just once more, gentlemen, and all together.''	「もう一度だけ、みなさん、声を揃えて」
``Fire!''	「火事だ！」
The shout must have rung over Norwood.	この叫びはノーウッド中に響きわたったに違いない。
It had hardly died away when an amazing thing happened.	その声が消えないうちに、驚くべきことが起こった。
A door suddenly flew open out of what appeared to be solid wall at the end of the corridor, and a little, wizened man darted out of it like a rabbit out of its burrow.	突然、廊下の端、しっかりした壁のように見えたところから、ドアがさっと開いて、萎びた小男が巣からでる兎のように飛び出してきたのだ。
``Capital!''	「上出来だ！」
said Holmes, calmly.	と、ホームズは落ち着き払って言った。
``Watson, a bucket of water over the straw.	「ワトスン、藁に水を。
That will do!	それでいい！
Lestrade, allow me to present you with your principal missing witness, Mr. Jonas Oldacre.''	レストレイド、紹介させてくれ、こちらが問題の証人、ミスター・ジョナス・オールデイカーだ」
The detective stared at the newcomer with blank amazement.	警部は驚きのあまり新参者を凝然と見つめていた。
The latter was blinking in the bright light of the corridor, and peering at us and at the smouldering fire.	男は、明るい廊下に目をしばたかせ、我々と、くすぶる炎とをちらちら見ていた。
It was an odious face -- crafty, vicious, malignant, with shifty, light-gray eyes and white lashes.	落ち着きのない灰色の目に白い眉毛。
``What's this, then?''	「これはいったい？」
said Lestrade, at last.	やがて、レストレイドは口を開いた。
``What have you been doing all this time,	「いままで何をしていた？
eh?''	ええ？」
Oldacre gave an uneasy laugh,	オールデイカーは不安そうに笑い声を上げた。
shrinking back from the furious red face of the angry detective.	怒れる警部の真っ赤な顔にしりごみしながら。
``I have done no harm.''	「悪いことは何も」
``No harm?	「何もだと？
You have done your best to get an innocent man hanged.	無実の男を一人絞首刑にするのに、この上ないことをやってきたんだぞ。
If it wasn't for this gentleman here, I am not sure that you would not have succeeded.''	もしこの紳士がここにいなかったら、本当に成功したかもしれないんだぞ」
The wretched creature began to whimper.	悪人は哀れな声を上げ始めた。
``I am sure, sir, it was only my practical joke.''	「嘘じゃありません、これはただのプラクティカルジョークだったんです」
``Oh!	「ほう！
a joke, was it?	ジョークだと？
You won't find the laugh on your side, I promise you.	おまえの肩をもって笑ってくれるやつなどいないだろうよ、保証してやる。
Take him down, and keep him in the sitting-room until I come.	この男を居間に連れていけ、俺も後から行く。
Mr. Holmes,''	ミスター・ホームズ」
he continued, when they had gone,	レストレイドは、警官たちが降りていくのを待って話を続けた。
``I could not speak before the constables, but I don't mind saying, in the presence of Dr. Watson,	「警官の前では口にできませんでしたが、ドクター・ワトスンの前で言うのはかまいません。
that this is the brightest thing that you have done yet,	ええ、これまでで最高の仕事ですよ。
though it is a mystery to me how you did it.	どうやって知ったのかが謎とは言え。
You have saved an innocent man's life, and you have prevented a very grave scandal,	無実の男の命を救い、不祥事を防止してくださいました。
which would have ruined my reputation in the Force.''	警察での私の評判を滅茶苦茶にするところでした」
Holmes smiled, and clapped Lestrade upon the shoulder.	ホームズは微笑んで、レストレイドの肩を叩いた。
``Instead of being ruined, my good sir, you will find that your reputation has been enormously enhanced.	「大丈夫だよ、レストレイドくん、逆に君の評判は大幅に高まるだろう。
Just make a few alterations in that report which you were writing, and they will understand how hard it is to throw dust in the eyes of Inspector Lestrade.''	さっき書いていた報告書を少し書き換えるだけで、レストレイド警部の目をくらますのがどんなに難しいか分かるってわけだ」
``And you don't want your name to appear?''	「自分の名前を出してもらいたくないと？」
``Not at all.	「少しもね。
The work is its own reward.	仕事自体が報酬なんだ。
Perhaps I shall get the credit also at some distant day,	たぶん、そのうち僕も名声をえるだろうし。
when I permit my zealous historian to lay out his foolscap once more -- eh, Watson?	熱心な歴史家さんが原稿用紙（フールスカップ）を広げるのを認めたときに――ね、ワトスン？
Well, now, let us see where this rat has been lurking.''	じゃあ、あの鼠の隠れ家を見てみよう」
A lath-and-plaster partition had been run across the passage six feet from the end,	この部分には木摺と漆喰が施され、6フィート先の廊下の端で終わっている。
with a door cunningly concealed in it.	そこにドアがうまく隠されていた。
It was lit within by slits under the eaves.	庇の下にある隙間のおかげで明るかった。
A few articles of furniture and a supply of food and water were within, together with a number of books and papers.	中には家具が少しと、水や食糧の貯えがあり、同じく大量の本と書類もある。
``There's the advantage of being a builder,''	「ここに建築家であることの利点がある」
said Holmes, as we came out.	と、揃って外に出ながら、ホームズが言った。
``He was able to fix up his own little hiding-place without any confederate	「誰の手も借りずに、この小さな隠れ家をこしらえることが可能だった
-- save, of course, that precious housekeeper of his,	――ただし、もちろんあの重宝な家政婦は除く。
whom I should lose no time in adding to your bag, Lestrade.''	あの女も今すぐ押さえておくべきだろうね、レストレイド」
``I'll take your advice.	「ご忠告にしたがいましょう。
But how did you know of this place, Mr. Holmes?''	でも、どうやってこの場所が分かったんですか、ミスター・ホームズ？」
``I made up my mind that the fellow was in hiding in the house.	「僕はこの男が家の中に隠れていると判断した。
When I paced one corridor and found it six feet shorter than the corresponding one below,	この廊下の長さを測ると、下の廊下よりも６フィート短い。
it was pretty clear where he was.	それでこの男の居場所が分かったんだよ。
I thought he had not the nerve to lie quiet before an alarm of fire.	流石のこいつも、火事騒ぎを前にすれば大人しく寝転んでいられないだろうと思った。
We could, of course, have gone in and taken him, but it amused me to make him reveal himself.	もちろん、中に踏み込んで捕まえることもできたけど、本人から姿を見せてもらうのが僕には面白くてね。
Besides, I owed you a little mystification, Lestrade, for your chaff in the morning.''	それに、ちょっと君を戸惑わせてやりたかったのさ、レストレイド、今朝の冷やかしのお返しに」
``Well, sir, you certainly got equal with me on that.	「なるほど、確かに同じだけのお返しは受けましたよ。
But how in the world did you know that he was in the house at all?''	ですが、いったいどうしてあの男が家の中にいるんだと？」
``The thumb-mark, Lestrade.	「指紋だよ、レストレイド。
You said it was final;	君はこれで決まりだと言った。
and so it was, in a very different sense.	そうとも、だけど意味が全然違うんだ。
I knew it had not been there the day before.	僕はあの指紋が昨日はなかったと知っていた。
I pay a good deal of attention to matters of detail, as you may have observed, and I had examined the hall,	僕は、細かいところまで多大な注意を払うようにしているんだけど、君も目にしてきたかもしれないな、あのホールもよく調べておいたんだ。
and was sure that the wall was clear.	だから、壁に何もなかったのは間違いない。
Therefore, it had been put on during the night.''	そうすると、あの指紋は夜の間につけられている」
``But how?''	「でもどうやって？」
``Very simply.	「きわめて簡単に。
When those packets were sealed up, Jonas Oldacre got McFarlane to secure one of the seals by putting his thumb upon the soft wax.	あの封筒に封をするとき、ジョナス・オールデイカーがマクファーレンに固まっていない蝋を指で押させたんだろう。
It would be done so quickly and so naturally, that I daresay the young man himself has no recollection of it.	自然に、速やかに行われたので、マクファーレンは恐らく覚えていない。
Very likely it just so happened, and Oldacre had himself no notion of the use he would put it to.	偶然そうなった可能性もきわめて高いし、オールデイカーにもそれを利用するつもりはなかったんだと思う。
Brooding over the case in that den of his, it suddenly struck him what absolutely damning evidence he could make against McFarlane by using that thumb-mark.	巣の中で事件のことをじっくり考えていると、突如、指紋を使って作り出せる致命的な証拠を思いついた。
It was the simplest thing in the world for him	あの男にはまったく簡単なことだった。
to take a wax impression from the seal, to moisten it in as much blood as he could get from a pin-prick, and to put the mark upon the wall during the night,	封から蝋で型をとり、ピンの傷から採れるだけの血で湿らせ、夜間、壁の上に押しておく。
either with his own hand or with that of his housekeeper.	自分の手か、あるいは家政婦の手で。
If you examine among those documents which he took with him into his retreat, I will lay you a wager that you find the seal with the thumbmark upon it.''	避難所に持ちこんだ書類を調べれば、指紋が残された封が見つかるはずだ。
``Wonderful!''	「すばらしい！」
said Lestrade.	とレストレイド。
``Wonderful!	「すばらしい！
It's all as clear as crystal, as you put it.	ご説明のとおりです、みんなはっきり分かりましたよ。
But what is the object of this deep deception, Mr. Holmes?''	でも、この狡猾な詐欺の目的は何だったんですか、ミスター・ホームズ？」
It was amusing to me to see how the detective's overbearing manner had changed suddenly to that of a child asking questions of its teacher.	警部の威張りくさった態度が、突如、教師に疑問点を尋ねる子供の態度に変わったのが面白い。
``Well, I don't think that is very hard to explain.	「そうだね、説明はたいして難しくないと思うよ。
A very deep, malicious, vindictive person is the gentleman who is now waiting us downstairs.	下で僕らを待っている紳士は、きわめて狡猾で、悪質で、復讐心に満ちた人物だ。
You know that he was once refused by McFarlane's mother?	マクファーレンの母親から拒絶された話は知っているね？
You don't!	知らないのか！
I told you that you should go to Blackheath first and Norwood afterwards.	ノーウッドより前にブラックヒースに行くべきだと言っただろう。
Well, this injury, as he would consider it, has rankled in his wicked, scheming brain,	まあいい、この傷は、彼にはそう思えたんだろうけど、この陰謀家の頭脳を苦しめつづけた。
and all his life he has longed for vengeance,	彼は、毎日毎日、復讐を切望してきた。
but never seen his chance.	ところが、チャンスがない。
During the last year or two, things have gone against him -- secret speculation, I think -- and he finds himself in a bad way.	去年か一昨年、いろいろとうまくいかず――秘密の投資だね、たぶん――ひどい状態になった。
He determines to swindle his creditors, and for this purpose he pays large checks to a certain Mr. Cornelius,	債権者相手に詐欺を働くことに決めた彼は、多額の小切手をミスター・コーネリアスに切った。
who is, I imagine, himself under another name.	これはね、たぶん、オールデイカー自身の偽名だよ。
I have not traced these checks yet, but I have no doubt that they were banked under that name at some provincial town	小切手については、まだよく調べていないけど、どこか田舎街の銀行にコーネリアス名義で預金されているに違いない。
where Oldacre from time to time led a double existence.	ときどき、オールデイカーはその街で二重生活をしていたんだろうな。
He intended to change his name altogether, draw this money, and vanish, starting life again elsewhere.''	名前を変え、金を引き出してから、失踪して新しい生活をはじめるつもりだった」
``Well, that's likely enough.''	「なるほど、十分ありえることです」
``It would strike him that	「失踪すれば、自分の後を追う連中を振り切れるかもしれない。
in disappearing he might throw all pursuit off his track,	それと同時に、昔の恋人の一人息子によって殺害されたという印象を残せれば、彼女に手痛い復讐を下せる。
and at the same time have an ample and crushing revenge upon his old sweetheart, if he could give the impression that he had been murdered by her only child.	そう思いついたのさ。
It was a masterpiece of villainy, and he carried it out like a master.	悪事の芸術だよ、そしてオールデイカーは芸術家のようにそれを実行した。
The idea of the will, which would give an obvious motive for the crime,	犯行の動機がはっきりとあらわされている、あの遺言書。
the secret visit unknown to his own parents,	両親にも知らされない内密の訪問。
the retention of the stick,	残されたステッキ。
the blood,	血痕。
and the animal remains and buttons in the wood-pile,	木材の中のボタンと動物の亡骸。
all were admirable.	どのアイデアも賞賛に値する。
It was a net from which it seemed to me, a few hours ago, that there was no possible escape.	数時間前までは、どこにも逃げ道のありえない網のように思えたよ。
But he had not that supreme gift of the artist, the knowledge of when to stop.	だけど、あの男には、芸術家としての最後の才能、止めるべき時を知るという才能がなかったんだ。
He wished to improve that which was already perfect	すでに完璧なものを改善しようとし
-- to draw the rope tighter yet round the neck of his unfortunate victim	――不運な犠牲者の首を絞めあげるロープをさらに強く引こうとして
-- and so he ruined all.	――すべてを水の泡にしてしまった。
Let us descend, Lestrade.	下へ降りよう、レストレイド。
There are just one or two questions that I would ask him.''	少し聞いておきたいことがあるんだ」
The malignant creature was seated in his own parlour, with a policeman upon each side of him.	悪人は、二人の警官にはさまれて、自分の応接室に腰を下ろしていた。
``It was a joke, my good sir	「ジョークだったんです、警部さん。
-- a practical joke, nothing more,''	悪ふざけ、ただそれだけです」
he whined incessantly.	と、オールデイカーの哀れっぽい訴えはとめどない。
``I assure you, sir, that I simply concealed myself in order to see the effect of my disappearance,	「本当です、私が失踪したらどうなるのかを見たくて隠れていただけなんです。
and I am sure that you would not be so unjust as to imagine that I would have allowed any harm to befall poor young Mr. McFarlane.''	私が、あの若いミスター・マクファーレンを傷つけようとしたなんて想像するのは不公正です。
``That's for a jury to decide,''	「それは陪審員が決めることだ」
said Lestrade.	と、レストレイド。
``Anyhow, we shall have you on a charge of conspiracy, if not for attempted murder.''	「いずれにせよ、殺人未遂がだめなら共同謀議で告発してやる」
``And you'll probably find that your creditors will impound the banking account of Mr. Cornelius,''	「それから、おそらく債権者のみなさんはミスター・コーネリアスの口座を差し押さえることでしょうね」
said Holmes.	と、ホームズ。
The little man started, and turned his malignant eyes upon my friend.	小男はぎくりとして悪意に満ちた目をホームズに向けた。
``I have to thank you for a good deal,'' said he.	「大いに礼を言う必要がありますね。
``Perhaps I'll pay my debt some day.''	いずれ、このご恩はお返しいたしましょう」
Holmes smiled indulgently.	ホームズは穏やかに微笑んだ。
``I fancy that, for some few years, you will find your time very fully occupied,'' said he.	「たぶん、数年は非常にお忙しい体になられると思いますよ。
``By the way, what was it you put into the wood-pile besides your old trousers?	ところで、木材の間に忍ばせたのは、古いズボンと、何だったのですか？
A dead dog,	犬の死骸？
or rabbits,	それとも兎？
or what?	それとも？
You won't tell?	教えてくださらないんですか？
Dear me, how very unkind of you!	ああ、なんと不親切な！
Well, well, I daresay that a couple of rabbits would account both for the blood and for the charred ashes.	まあよし、とりあえず兎の2羽で、血痕と消し炭とを説明しておきましょう。
If ever you write an account, Watson, you can make rabbits serve your turn.''	文章にするときはさ、ワトスン、兎に働いてもらうんだね」
Copyright &copy; Arthur Conan Doyle 1903, expired. Copyright &copy; Kareha 2000-2001, waived.	原文：「The Return of Sherlock Holmes」所収「The Adventure of the Norwood Builder」
