THE MIND OF CROWDS	『群集心理』
THE ERA OF CROWDS	群集の時代
The great upheavals which precede changes of civilisations such as the fall of the Roman Empire and the foundation of the Arabian Empire, seem at first sight determined more especially by political transformations, foreign invasion, or the overthrow of dynasties.	ローマ帝国の崩壊やアラビア帝国の勃興といった文明の変化を予兆するような大きな変動は、一見しただけでは、政変や外国からの侵略、王朝の打倒といったものによって引き起こされれているかのように見える。
But a more attentive study of these events shows that behind their apparent causes the real cause is generally seen to be a profound modification in the ideas of the peoples.	しかしこれらの出来事をより注意深く調査すれば、それらの表面的な原因の背後に、民衆に関する思想についての根本的な修正という原因があったことが明らかになる。
The true historical upheavals are not those which astonish us by their grandeur and violence.	真の歴史変動というものは、その規模や暴力で私たちを驚かせるたぐいのものではない。
The only important changes whence the renewal of civilisations results, affect ideas, conceptions, and beliefs.	文明の結実を一新させる唯一重要な変化とは、それ以降の思想・概念・信念*1に影響をもたらすようなものだ。
The memorable events of history are the visible effects of the invisible changes of human thought.	記憶に値する歴史上の出来事とは、人間の思考という目に見えないものに変化を与え、そこからもたらされた、目に見える結果のことである。
The reason these great events are so rare is that there is nothing so stable in a race as the inherited groundwork of its thoughts.	このような出来事がまれにしか見られないのは、人間に引き継がれている思考の枠組みというものは種そのものと同様に安定しており、他に類するものがないからである。*2
The present epoch is one of these critical moments in which the thought of mankind is undergoing a process of transformation.	現代は、人類の思考が変換の過程を経ている重要な瞬間のうちの１つである。
Two fundamental factors are at the base of this transformation.	この変換の根本には、２つの基礎的な要因がある。
The first is the destruction of those religious, political, and social beliefs in which all the elements of our civilisation are rooted.	ひとつは、我々の文明の全ての要素が基礎付けられている、宗教的・政治的・社会的信念の破壊である。
The second is the creation of entirely new conditions of existence and thought as the result of modern scientific and industrial discoveries.	もうひとつは、現代科学と産業の諸発見の結果としてもたらされた、存在と思考の全く新しい状態の創造である。
The ideas of the past, although half destroyed, being still very powerful, and the ideas which are to replace them being still in process of formation, the modern age represents a period of transition and anarchy.	過去の思考は半ば崩壊したけれども、いまだ十分に力を保っており、それに替わるべき思想もいまだ形成段階で、現代は移行期・無秩序時代とも言える。
It is not easy to say as yet what will one day be evolved from this necessarily somewhat chaotic period.	したがって現時点でこの混沌とした状況から何が生まれ出てくるかを推定することは容易ではない。
What will be the fundamental ideas on which the societies that are to succeed our own will be built up?	来るべき社会はどのような基本的思想の上に立脚したものになるのだろうか？
We do not at present know.	それは今のところはわからない。
Still it is already clear that on whatever lines the societies of the future are organised, they will have to count with a new power, with the last surviving sovereign force of modern times, the power of crowds.	しかし、未来の社会がどのようなラインの上に引かれるものであっても、現代において最後まで生きのびるであろう主権者たる新たな勢力・群集の力を重視しなければならないことは明らかである。
On the ruins of so many ideas formerly considered beyond discussion, and to-day decayed or decaying, of so many sources of authority that successive revolutions have destroyed, this power, which alone has arisen in their stead, seems soon destined to absorb the others.	かつては正しいものとして扱われたが現在では滅びてしまった思想や、相次ぐ革命により倒された政権などの廃虚の上に、この新たな勢力・群集は立ち上がり、他の勢力をも呑み込もうとしている。
While all our ancient beliefs are tottering and disappearing, while the old pillars of society are giving way one by one, the power of the crowd is the only force that nothing menaces, and of which the prestige is continually on the increase.	古い信念が揺らぎ、消滅していき、社会の古い支柱が１つずつ置き換わっていきつつある中で、群集の勢力は何者をも恐れず、増加する一方である。
The age we are about to enter will in truth be the ERA OF CROWDS.	まさに「群集の時代」を迎えようとしているのだ。
Scarcely a century ago the traditional policy of European states and the rivalries of sovereigns were the principal factors that shaped events.	ほんの１世紀前*3では、ヨーロッパ諸国の伝統的な政策や国王らの抗争が[歴史的な]事象を引き起こす主要な要因となっていた。
The opinion of the masses scarcely counted, and most frequently indeed did not count at all.	群集の世論などというものはほとんど考慮されないか、全く考慮されなかった。
To-day it is the traditions which used to obtain in politics, and the individual tendencies and rivalries of rulers which do not count;	しかし今日では、個人の性向や支配者層の抗争などとるに足らない問題となり、
while, on the contrary, the voice of the masses has become preponderant.	逆に群集の声が優勢になってきている。
It is this voice that dictates their conduct to kings, whose endeavour is to take note of its utterances.	王侯に命令を下すのがこの[群集の]声であり、
The destinies of nations are elaborated at present in the heart of the masses, and no longer in the councils of princes.	現在では、国家の運命も群集によって作り上げられるものであり、もはや王子らの会議で決定するものではないのだ。
The entry of the popular classes into political life--that is to say, in reality, their progressive transformation into governing classes--is one of the most striking characteristics of our epoch of transition.	一般大衆*4が統治階級に進出しつつあるという事実が我々の時代の最も著しい特徴である。
The introduction of universal suffrage, which exercised for a long time but little influence, is not, as might be thought, the distinguishing feature of this transference of political power.	しかし、この政治権力の移動は普通選挙制度の導入そのものによってなされたわけではない。
The progressive growth of the power of the masses took place at first by the propagation of certain ideas, which have slowly implanted themselves in men's minds, and afterwards by the gradual association of individuals bent on bringing about the realisation of theoretical conceptions.	群集*5の力が急激に大きくなったのはある思想*6が人々の中に普及し、概念の実現のために個人どうしが群れた*7からである。
It is by association that crowds have come to procure ideas with respect to their interests which are very clearly defined if not particularly just,	群れることで、群集は自分たちの利益を尊重する概念−望んでいるまさにそのものでなくとも、極めて明確に思い描いているもの−を入手するに至った。
and have arrived at a consciousness of their strength.	そしてようやく［結束した］自分たちの強さに気づいたのだ。
The masses are founding syndicates before which the authorities capitulate one after the other;	群集は、いかなる権威も服従するシンジケートを作り上げた。
they are also founding labour unions, which in spite of all economic laws tend to regulate the conditions of labour and wages.	さらにどんな経済状態でも労働と賃金の関係を支配する労働組合も作り出した。
They return to assemblies in which the Government is vested, representatives utterly lacking initiative and independence, and reduced most often to nothing else than the spokesmen of the committees that have chosen them.	群集は政府が主催する集会に代表者を派遣するが、その代表者は自主性と独立性に欠けており、結局のところ自らを選出した委員会のスポークスマンでしかない。
To-day the claims of the masses are becoming more and more sharply defined,	今日では、群集の要求はかなり明確なものとなってきた。
and amount to nothing less than a determination to utterly destroy society as it now exists, with a view to making it hark back to that primitive communism which was the normal condition of all human groups before the dawn of civilisation.	文明成立以前の人間の状態である原始共産制にもどることを目指しているかのように、今ある社会を徹底的に破壊しようとしているのだ。*8
Limitations of the hours of labour, the nationalisation of mines, railways, factories, and the soil, the equal distribution of all products, the elimination of all the upper classes for the benefit of the popular classes, &c., such are these claims.	労働時間の制限、鉱山・鉄道・工場・土地の国有化、全ての生産物の平等な分配、一般大衆のための上流階級の廃止といったことが要求の内容である。
Little adapted to reasoning, crowds, on the contrary, are quick to act.	群集は、推論させるにはほとんど適さないが、行動となると迅速である。*9
As the result of their present organisation their strength has become immense.	現在の組織の結果として、群集の力は強大になった。
The dogmas whose birth we are witnessing will soon have the force of the old dogmas;  that is to say, the tyrannical and sovereign force of being above discussion.	我々がその誕生を目撃している新しい教義は、古い教義と同等の力−議論を制する専制的で絶対的な力−をもつことになるであろう。
The divine right of the masses is about to replace the divine right of kings.	群集への権利の神授説は、王権神授説にとって替わろうとしているのだ。
The writers who enjoy the favour of our middle classes, those who best represent their rather narrow ideas, their somewhat prescribed views, their rather superficial scepticism, and their at times somewhat excessive egoism, display profound alarm at this new power which they see growing;	中産階級というものは狭量な思想を持ち、決まりきったものの見方をし、表層的な懐疑主義に陥り、極端なエゴイズムになっているものだが、そういう彼らのお気に召すような文筆家は、新たな群集の勃興に警鐘を鳴らす。
and to combat the disorder in men's minds they are addressing despairing appeals to those moral forces of the Church for which they formerly professed so much disdain.	そして［中産階級の］人心の混乱を静めるために、一度は価値がないと見放したはずの教会の権威を持ち出して対処しようとしている。
They talk to us of the bankruptcy of science, go back in penitence to Rome, and remind us of the teachings of revealed truth.	さらに科学の破綻を示し、ローマ*10への恭順を説き、隠された真実の教説を想起させようとする。
These new converts forget that it is too late.	しかし、これらの新しい「改宗者」は、［自分たちのやっていることが］もはや後手になってしまっていることを忘れている。
Had they been really touched by grace, a like operation could not have the same influence on minds less concerned with the preoccupations which beset these recent adherents to religion.	仮にその改宗者たちが本当に恩寵に心を動かされたとしても、同じ教説を信じない者にとっては何とも感じることはないのだ。
The masses repudiate to-day the gods which their admonishers repudiated yesterday and helped to destroy.	これまで説諭者たちが否定し、破壊をすすめてきた神を、今度は群集が否定する。
There is no power, Divine or human, that can oblige a stream to flow back to its source.	神であれ人間であれ、川の流れを水源に戻すことなどできはしないのである。
There has been no bankruptcy of science, and science has had no share in the present intellectual anarchy, nor in the making of the new power which is springing up in the midst of this anarchy.	実際には科学は破綻していない*11し、現在の知的な無政府状態や［群集という］新たな勢力の勃興は無縁である。
Science promised us truth, or at least a knowledge of such relations as our intelligence can seize:	科学は我々に真実を約束した―少なくとも我々に関係する知識［の提供］を約束した。
it never promised us peace or happiness.	しかし、決して平和や幸福を約束したわけではない。
Sovereignly indifferent to our feelings, it is deaf to our lamentations.	我々の感情などには無関心なのだから、科学は我々の悲嘆に耳を貸さない。
It is for us to endeavour to live with science, since nothing can bring back the illusions it has destroyed.	科学が破壊した幻想はもはやとりもどすことは出来ないので、科学と共存するには我々のほうが努力するしかないのである。
Universal symptoms, visible in all nations, show us the rapid growth of the power of crowds, and do not admit of our supposing that it is destined to cease growing at an early date.	あらゆる国で見られる一般的な傾向として、群集の力が急激に成長しており、もはや早期に阻止することはできず、
Whatever fate it may reserve for us, we shall have to submit to it.	何が起ころうともその結果を受け入れるしかないであろう。
All reasoning against it is a mere vain war of words.	抵抗するのは無駄である。
Certainly it is possible that the advent to power of the masses marks one of the last stages of Western civilisation, a complete return to those periods of confused anarchy which seem always destined to precede the birth of every new society.	確かに群集の到来が西洋文明の最終段階をもたらし、全ての新社会誕生に先行するあの混乱した無政府状態の時代への完璧な回帰をもたらすことは可能である。
But may this result be prevented?	この結果は防ぐことができるのか？
Up to now these thoroughgoing destructions of a worn-out civilisation have constituted the most obvious task of the masses.	これまで、古い文明を徹底的に破壊することが、群集の最も明白な仕事であった。
It is not indeed to-day merely that this can be traced.	それが指摘されるのは今に始まったことではない。
History tells us, that from the moment when the moral forces on which a civilisation rested have lost their strength, its final dissolution is brought about by those unconscious and brutal crowds known, justifiably enough, as barbarians.	文明を支えている道徳が効力を失ったとき、無意識ではあるが残酷な群集によって最終的に破壊されるということを歴史が示している。
Civilisations as yet have only been created and directed by a small intellectual aristocracy, never by crowds.	文明は少数の知的な貴族によって創設され方向付けられてきたのであって、群集によってではない。
Crowds are only powerful for destruction.	群集のもたらすものは破壊のみである。*12
Their rule is always tantamount to a barbarian phase.	混乱が群集のルールである。
A civilisation involves fixed rules, discipline, a passing from the instinctive to the rational state, forethought for the future, an elevated degree of culture	文明には、固定的な規則や規律、本能的状態から理性的状態への移行、将来に対する見とおし、文化の高尚な段階というものが含まれているものである。
--all of them conditions that crowds, left to themselves, have invariably shown themselves incapable of realising.	しかしこれらは群集には及びもつかないことであろう。
In consequence of the purely destructive nature of their power crowds act like those microbes which hasten the dissolution of enfeebled or dead bodies.	群集は、その純粋に破壊的な力をもって、衰弱した肉体や死体の分解を早める微生物のようなものだ。
When the structure of a civilisation is rotten, it is always the masses that bring about its downfall.	文明の構造が腐敗したとき、崩壊に至らせるのが群集である。
It is at such a juncture that their chief mission is plainly visible, and that for a while the philosophy of number seems the only philosophy of history.	そのような局面こそが群集の使命が明白に現れるときであり、その間は、数の哲学が歴史の哲学になるのだ。
Is the same fate in store for our civilisation?	同じ運命が我々の文明を待ち受けているのであろうか？
There is ground to fear that this is the case, but we are not as yet in a position to be certain of it.	今のところは、それはわからない。
We have a very slight knowledge of these crowds which are beginning to be the object of so much discussion.	群集についての議論が始まったものの、実は我々はほとんど群集に関する知識がほとんどない。
Professional students of psychology, having lived far from them, have always ignored them,	心理学の専門家たちは群集とは別世界で生活しているがために、常に群集を無視してきた。
and when, as of late, they have turned their attention in this direction it has only been to consider the crimes crowds are capable of committing.	注意を払ったとしても群衆の犯罪という観点からであった。
Without a doubt criminal crowds exist,	確かに、犯罪的な群集というものは存在する。
but virtuous and heroic crowds, and crowds of many other kinds, are also to be met with.	一方で、群集にも高潔で英雄的なものも、その他の様々なタイプの群集が存在しうるのだ。
The crimes of crowds only constitute a particular phase of their psychology.	犯罪的な群集とは心理学上の特定の局面でしかない。
The mental constitution of crowds is not to be learnt merely by a study of their crimes, any more than that of an individual by a mere description of his vices.	個人の悪行だけからその人の精神状態を記述できないように、犯罪的な側面からだけでは群集の精神構造を分析することはできない。
However, in point of fact, all the world's masters, all the founders of religions or empires, the apostles of all beliefs, eminent statesmen, and, in a more modest sphere, the mere chiefs of small groups of men have always been unconscious psychologists, possessed of an instinctive and often very sure knowledge of the character of crowds,	世界の全ての支配者、全ての宗教の創唱者、全ての帝国の創始者、全ての信念の唱導者、著名な政治家から身近なところでは小さなグループのリーダーに至るまで、彼（女）らは無意識であるけれども常に心理学者であり、本能的に極めて正確に群集の性質を把握していたのだ。
and it is their accurate knowledge of this character that has enabled them to so easily establish their mastery.	その正確な知識のおかげでその地位を獲得できたのである。
Napoleon had a marvellous insight into the psychology of the masses of the country over which he reigned, but he, at times, completely misunderstood the psychology of crowds belonging to other races;[1]	ナポレオンは、自らの支配する領土（フランス）の群集の心理には長けていたが、それ以外の土地の群衆の性質に関してはまったくの誤解をしていた。[1]
and it is because he thus misunderstood it that he engaged in Spain, and notably in Russia, in conflicts in which his power received blows which were destined within a brief space of time to ruin it.	この誤解のためにスペインで、そして特にロシアで自らを破滅に導く戦争に突入していったのである。
A knowledge of the psychology of crowds is to-day the last resource of the statesman who wishes not to govern them--that is becoming a very difficult matter--but at any rate not to be too much governed by them.	現在では群集の心理学の知識は、群集を支配する―これは非常に難しくなっている―ためではなく、群集に支配されることを望まない政治家にとっての最後の資源となっている。
It is only by obtaining some sort of insight into the psychology of crowds that it can be understood how slight is the action upon them of laws and institutions, how powerless they are to hold any opinions other than those which are imposed upon them,	法律や制度と言うものがいかに群集に影響を与えないかということうや群集が押しつけられた意見とは違う意見をもつことの困難さを群集心理学は明らかにする。
and that it is not with rules based on theories of pure equity that they are to be led, but by seeking what produces an impression on them and what seduces them.	群集を動かすのは、純粋な平等の理論に基づいたルールではなく、印象であり、群集を魅惑するものなのだ。
For instance, should a legislator, wishing to impose a new tax, choose that which would be theoretically the most just?	たとえば、新しい課税を望む立法者は理論上最も公正な制度を選択すべきだろうか？
By no means.	そうではない。
In practice the most unjust may be the best for the masses.	実際、最も公正に欠くものでも、群集にとっては最良のものとなることがあるからだ。
Should it at the same time be the least obvious, and apparently the least burdensome, it will be the most easily tolerated.	新課税がほとんど目立たず、対した負担でないと見える場合がそうである。
It is for this reason that an indirect tax, however exorbitant it be, will always be accepted by the crowd,	この理由から、間接税は、それが法外なものであろうとも承認されるだろう。
because, being paid daily in fractions of a farthing on objects of consumption, it will not interfere with the habits of the crowd, and will pass unperceived.	というのも、日々の消費から少しずつ徴収されることになるので習慣を妨げないからだ。
Replace it by a proportional tax on wages or income of any other kind, to be paid in a lump sum, and were this new imposition theoretically ten times less burdensome than the other, it would give rise to unanimous protest.	ところがこれを賃金や所得への比例税という形で課税すると、その負担が１０倍軽くても、総反対を食らうことになるだろう。
This arises from the fact that a sum relatively high, which will appear immense, and will in consequence strike the imagination, has been substituted for the unperceived fractions of a farthing.	日々の少額の徴収が、大きな総額にとってかわるということである。
The new tax would only appear light had it been saved farthing by farthing,	この新しい税も、ほんの少しずつ徴収されたなら気にならないであろう。
but this economic proceeding involves an amount of foresight of which the masses are incapable.	このような経済的な方法は、群集が持ち合わせていない洞察力を必要とするのである。
The example which precedes is of the simplest.	先述の例は、その簡単な例であり、
Its appositeness will be easily perceived.	容易に理解されるだろう。
It did not escape the attention of such a psychologist as Napoleon, but our modern legislators, ignorant as they are of the characteristics of a crowd, are unable to appreciate it.	ナポレオンのような心理学者はそのことに気づいていたが、多くの立法者たちは群集の性質について無知であり、理解することが出来ないであろう。
Experience has not taught them as yet to a sufficient degree that men never shape their conduct upon the teaching of pure reason.	人間は純粋理性の命令にしたがって行動するわけではないと言うことを、経験から知ることはなかったのである。
Many other practical applications might be made of the psychology of crowds.	群集心理学の応用は他にも考えることができるだろう。
A knowledge of this science throws the most vivid light on a great number of historical and economic phenomena totally incomprehensible without it.	群集心理学の知識は、これまで不可解なものとして解明できなかった歴史的・経済的現象に分析の光を投げかける。
I shall have occasion to show that the reason why the most remarkable of modern historians, Taine, has at times so imperfectly understood the events of the great French Revolution is, that it never occurred to him to study the genius of crowds.	私は、注目に値する歴史家タン（Hippolyte Adolphe Taine ,1828-1893）がフランス革命の記述に関して理解が不充分であったのは、群集の天分についての理解が足りなかったためだと見ている。
He took as his guide in the study of this complicated period the descriptive method resorted to by naturalists;	彼のとって方法は博物学者の方法であり、
but the moral forces are almost absent in the case of the phenomena which naturalists have to study.	道徳の力に関する分析に欠けていたのだ。
Yet it is precisely these forces that constitute the true mainsprings of history.	まさに歴史を展開してゆく力を構成するものであるにもかかわらず、である。
In consequence, merely looked at from its practical side, the study of the psychology of crowds deserved to be attempted.	結論として、現実的な観点からは、群集心理の研究は取り組むべき価値があると思われる。
Were its interest that resulting from pure curiosity only, it would still merit attention.	仮にそれが単に純粋な好奇心に起因するものであったとしても、注意を払うに値するのではないだろうか。
It is as interesting to decipher the motives of the actions of men as to determine the characteristics of a mineral or a plant.	人間の行為の動機を探求することは、鉱物や植物の特徴を研究することと同程度に興味深いものなのだ。
Our study of the genius of crowds can merely be a brief synthesis, a simple summary of our investigations.	著者が行った群集の性質に関する研究は、仮説であり、概要に過ぎない。
Nothing more must be demanded of it than a few suggestive views.	[この著作においては]示唆的な視点をいくつか与えた程度であり、それ以上のことを求められるべきものではない。
Others will work the ground more thoroughly.	他の人々が徹底的に踏査していくであろう。
To-day we only touch the surface of a still almost virgin soil.	私たちは今のところ、未踏であった領域にほんの少し踏み込んだだけに過ぎない。
[1] His most subtle advisers, moreover, did not understand this psychology any better.	悪いことに、彼の側近は、さらにこのこの心理学を理解していなかった。
Talleyrand wrote him that "Spain would receive his soldiers as liberators."	タレーラン（Charles Maurice de Talleyrand-Perigord ,1754-1838）はナポレオンに「スペインはナポレオン軍を解放軍として歓迎するだろう」と書簡を送ったが、
It received them as beasts of prey.	実際にはスペインでは野獣扱いであった。
A psychologist acquainted with the hereditary instincts of the Spanish race would have easily foreseen this reception.	スペイン民族の本能に熟知した心理学者なら、この反応を予測できたであろう。（本文へ戻る↑）
BOOK I	第１編
THE MIND OF CROWDS	群集の精神
CHAPTER I	第１章：
GENERAL CHARACTERISTICS OF CROWDS.	群集の一般的な特徴
--PSYCHOLOGICAL LAW OF THEIR MENTAL UNITY.	群集の心理的一体化に関する心理学的法則
What constitutes a crowd from the psychological point of view	心理学的見地からの群集の構成
--A numerically strong agglomeration of individuals does not suffice to form a crowd	−単に数が集まるだけでは群集にはならない
--Special characteristics of psychological crowds	−心理的群集の特性
--The turning in a fixed direction of the ideas and sentiments of individuals composing such a crowd, and the disappearance of their personality	−群集を構成する個人の思想や情念が一方向に傾くことと個性の喪失
--The crowd is always dominated by considerations of which it is unconscious	−群集は常に無意識に思い描いているものに支配されている
--The disappearance of brain activity and the predominance of medullar activity	−思考停止と脊髄反射的反応の優越
--The lowering of the intelligence and the complete transformation of the sentiments	−知性の低下と情念の完全な転換
--The transformed sentiments may be better or worse than those of the individuals of which the crowd is composed	−それは群集を構成する個人の情念とは異なるものとなる
--A crowd is as easily heroic as criminal.	−群集は容易に英雄的にも犯罪的にもなる。
In its ordinary sense the word "crowd" means a gathering of individuals	通常の意味では「群集（crowd）」という言葉は個人の集合を意味する。
of whatever nationality, profession, or sex, and whatever be the chances that have brought them together.	国籍も職業も性別も問わないし、なぜ集まっているのかも問題ではない。
From the psychological point of view the expression "crowd" assumes quite a different signification.	しかし心理学的な見地からは「群集」という表現には際立った意味がこめられる。
Under certain given circumstances, and only under those circumstances, an agglomeration of men presents new characteristics very different from those of the individuals composing it.	それは、人々の集合がそれを構成する個人の特性とは異なる新しい特性を示す場合で、かつその場合に限られる。
The sentiments and ideas of all the persons in the gathering take one and the same direction, and their conscious personality vanishes.	その場合、集まっている人々の情念や思想が１つの方向に傾き、
A collective mind is formed, doubtless transitory, but presenting very clearly defined characteristics.	一時的ではあるが集合精神（collective mind）とも言うべき状態が形成され、非常に際立った性質をあらわすものである。
The gathering has thus become what, in the absence of a better expression, I will call an organised crowd, or, if the term is considered preferable, a psychological crowd.	この集団は、適当な呼び方がないので「組織化された群集（organised crowd）」とでも言っておくが−心理的群集（psychological crowd）と呼んでもいいが−、そういったものになるのである。
It forms a single being, and is subjected to the LAW OF THE MENTAL UNITY OF CROWDS.	それは単一の存在として、群集の心理的一体化に関する心理学的法則に従うものである。
It is evident that it is not by the mere fact of a number of individuals finding themselves accidentally side by side that they acquire the character of an organised crowd.	たまたま多くの個人が集まったからと言って、組織化された群集の性質を帯びると言うものでもない。
A thousand individuals accidentally gathered in a public place without any determined object in no way constitute a crowd from the psychological point of view.	たまたまどこかで１０００人の人が、これといった目的もなく集まっているからと言って、心理学的見地から見た群集を構成するわけではない。
To acquire the special characteristics of such a crowd, the influence is necessary of certain predisposing causes of which we shall have to determine the nature.	そのような特質を得るためにはある種の刺激が必要なのである。*1
The disappearance of conscious personality and the turning of feelings and thoughts in a definite direction, which are the primary characteristics of a crowd about to become organised, do not always involve the simultaneous presence of a number of individuals on one spot.	これは、群集が組織化されていく際の最初の特徴でもあるのだが、意識的な個人が消滅し、感情と思考があるきまった方向に向かうときには、必ずしも多数の個人が同じ場所にいる必要はない。
Thousands of isolated individuals may acquire at certain moments, and under the influence of certain violent emotions--such, for example, as a great national event--the characteristics of a psychological crowd.	全く別々のところにいる数千の個人どうしであっても心理的群集の性質を示すことがありうるのだ。
It will be sufficient in that case that a mere chance should bring them together for their acts to at once assume the characteristics peculiar to the acts of a crowd.	もしそのときたまたま集まる機会がありさえすれば、群集としての特質をあらわす行動にでるだろう。
At certain moments half a dozen men might constitute a psychological crowd, which may not happen in the case of hundreds of men gathered together by accident.	半ダースくらいの人数でも心理的群集としての振る舞いをすることもあれば、何百人が集まったところで何も起こらないこともある。
On the other hand, an entire nation, though there may be no visible agglomeration, may become a crowd under the action of certain influences.	一方、一国全体が、それとわかる集団を形成しなくとも、ある種の影響下で群集となってしまうこともあるだろう。
A psychological crowd once constituted, it acquires certain provisional but determinable general characteristics.	心理的群集というものは、一旦形成されてしまうと、一時的ではあるが確固とした一般的性質を帯びる。
To these general characteristics there are adjoined particular characteristics which vary according to the elements of which the crowd is composed, and may modify its mental constitution.	この一般的性質に、群集の構成や心理構造によって異なる特殊な性質が付け加わってゆく。
Psychological crowds, then, are susceptible of classification;	心理的群集は［その性質によって］分類することができる。*2
and when we come to occupy ourselves with this matter, we shall see that a heterogeneous crowd--that is, a crowd composed of dissimilar elements--presents certain characteristics in common with homogeneous crowds--that is, with crowds composed of elements more or less akin (sects, castes, and classes)--and side by side with these common characteristics particularities which permit of the two kinds of crowds being differentiated.	異なった構成要素からなる異質的な群集であっても、［同じ］党派や身分や階級などからなる群集と同じように共通の性質を持っているものだし、これら２つを区別する特殊な性質を示すこともできる。
But before occupying ourselves with the different categories of crowds, we must first of all examine the characteristics common to them all.	群集のそれぞれのカテゴリーを見ていく前に、まず、全ての群集に共通の性質を見ていくこととしよう。
We shall set to work like the naturalist, who begins by describing the general characteristics common to all the members of a family before concerning himself with the particular characteristics which allow the differentiation of the genera and species that the family includes.	博物学者［の手法］にならって、ある科（family）に属する構成要素に共通する一般的性質を記述し、次いでその科に含まれる属（genera）や種（spiecies）を区別する特徴について触れていくものとする。
It is not easy to describe the mind of crowds with exactness,	群集の精神を正確に記述するのは容易なことではない。
because its organisation varies not only according to race and composition, but also according to the nature and intensity of the exciting causes to which crowds are subjected.	その機構（しくみ）が出自や構成によって異なるだけでなく、群集が影響を受けている実際の要因の性質や強度によっても千変万化するからである。
The same difficulty, however, presents itself in the psychological study of an individual.	とはいうものの、個人の心理を研究する場合にも同様の困難は発生するものである。
It is only in novels that individuals are found to traverse their whole life with an unvarying character.	ある人物が不変の性質で全人生を貫くということは小説の中だけの話だ。
It is only the uniformity of the environment that creates the apparent uniformity of characters.	環境が変わらなければ見かけ上は性質も変わらないように見えるということだけである。
I have shown elsewhere that all mental constitutions contain possibilities of character which may be manifested in consequence of a sudden change of environment.	どんな精神構造でも、環境の激変によって現出する可能性を秘めているものだ。
This explains how it was that among the most savage members of the French Convention were to be found inoffensive citizens who, under ordinary circumstances, would have been peaceable notaries or virtuous magistrates.	このことは［フランス革命時に粛清の嵐が吹き荒れた］国民公会の中に、［革命が起こっていなければ］温和な公証人や有徳な行政官であったであろう人々が参加していたことでも説明ができるだろう。
The storm past, they resumed their normal character of quiet, law-abiding citizens.	革命の嵐が去ると彼等は普段の性質に戻った。
Napoleon found amongst them his most docile servants.	ナポレオンは彼等の中に従順な僕（しもべ）を見たのである。
It being impossible to study here all the successive degrees of organisation of crowds, we shall concern ourselves more especially with such crowds as have attained to the phase of complete organisation.	群集による組織の一連の段階の全てを研究することは不可能であるから、特にすっかり組織化された段階*3の群集に特に焦点をあてて見ていくこととしよう。
In this way we shall see what crowds may become, but not what they invariably are.	こうすることによって群集の常態がどのようなものであるかということではなく、いったいどのようなものに変化するかということが明らかになるであろう。
It is only in this advanced phase of organisation that certain new and special characteristics are superposed on the unvarying and dominant character of the race;	民族の不変で支配的な性質にある新しい特殊な性質が重なって現れるのは、組織化が進んだ段階においてのみである。
then takes place that turning already alluded to of all the feelings and thoughts of the collectivity in an identical direction.	そしてその状態から、既に先ほどほのめかしておいた、集団の感情や思考が一定の方向に向けられるという性質が現れるのである。
It is only under such circumstances, too, that what I have called above the PSYCHOLOGICAL LAW OF THE MENTAL UNITY OF CROWDS comes into play.	そしてその環境でおいてのみ、先ほど群集の心理的一体化に関する心理学的法則と呼んだものが作動するのである。*4
Among the psychological characteristics of crowds there are some that they may present in common with isolated individuals, and others, on the contrary, which are absolutely peculiar to them and are only to be met with in collectivities.	群集の心理学的な性質の中でそれぞれの個体に共通に現れる性質もあれば、反対に集団を構成した時にしか現れない性質もある。
It is these special characteristics that we shall study, first of all, in order to show their importance.	まずその重要性を明らかにするために、集団を構成した場合にのみ現れる特殊な性質を解明していこう。
The most striking peculiarity presented by a psychological crowd is the following:	心理学的群集に際立って現れる特徴とは、
Whoever be the individuals that compose it, however like or unlike be their mode of life, their occupations, their character, or their intelligence, the fact that they have been transformed into a crowd puts them in possession of a sort of collective mind which makes them feel, think, and act in a manner quite different from that in which each individual of them would feel, think, and act were he in a state of isolation.	群集を構成する個人の生活様式や職業・性格・知性がどのようなものであれ、それぞればらばらに居るときとは全く異なる様式で感じ、思考し行動するという事実である。
There are certain ideas and feelings which do not come into being, or do not transform themselves into acts except in the case of individuals forming a crowd.	個人が集団を形成した時にしか現れない思想や感情というものも存在する。
The psychological crowd is a provisional being formed of heterogeneous elements, which for a moment are combined, exactly as the cells which constitute a living body form by their reunion a new being which displays characteristics very different from those possessed by each of the cells singly.	心理学的群集は異質な要素がある瞬間に接合したような暫定的な存在（provisional being）であって、ちょうど生体を構成する細胞が１つ１つの細胞のもち性質とは非常に異なる性質を示す新たな生体を構成するために再結合するようなものである。
Contrary to an opinion which one is astonished to find coming from the pen of so acute a philosopher as Herbert Spencer, in the aggregate which constitutes a crowd there is in no sort a summing-up of or an average struck between its elements.	スペンサー（Herbert Spencer;1855-1893）のような哲学者が主張する意見とは異なり、群集を構成する集合体には各要素の総和や平均値というものは存在しない。
What really takes place is a combination followed by the creation of new characteristics,	まさに化学における結合反応で新化合物が生成するようなものだ。
just as in chemistry certain elements, when brought into contact--bases and acids, for example--combine to form a new body possessing properties quite different from those of the bodies that have served to form it.	たとえば塩基と酸が結合する前と後とではまるで異なる性質を持つようなものである。
It is easy to prove how much the individual forming part of a crowd differs from the isolated individual, but it is less easy to discover the causes of this difference.	群集を構成する個人がばらばらでいる時と異なる性質を示すことは容易であるが、その原因を明らかにすることは困難である。
To obtain at any rate a glimpse of them it is necessary in the first place to call to mind the truth established by modern psychology, that unconscious phenomena play an altogether preponderating part not only in organic life, but also in the operations of the intelligence.	この原因について細部にまでわたって理解するには、器官の作用のみならず意識の作用に関しても無意識現象が重要な働きをしているという現代心理学の真実をまず思い起こすべきであろう。
The conscious life of the mind is of small importance in comparison with its unconscious life.	無意識の作用のもとにある生活*5に比べれば、意識の作用のもとにある生活は対した重要性を持たない。
The most subtle analyst, the most acute observer, is scarcely successful in discovering more than a very small number of the unconscious motives that determine his conduct.	しかしどんな優秀な分析者・観察者であっても、自らの行為を決定する無意識的動機を発見、特定することはなかなか困難である。
Our conscious acts are the outcome of an unconscious substratum created in the mind in the main by hereditary influences.	我々の意識的行動ですら、主に遺伝的影響でもたらされる無意識的な基盤からもたらされるものなのである。
This substratum consists of the innumerable common characteristics handed down from generation to generation, which constitute the genius of a race.	そしてこの基盤は幾世代にもわたって伝えられてきた無数の共通の性質から構成されているのである。
Behind the avowed causes of our acts there undoubtedly lie secret causes that we do not avow, but behind these secret causes there are many others more secret still which we ourselves ignore.	我々の行動の背景には我々の気づき得ない原因が横たわっている。
The greater part of our daily actions are the result of hidden motives which escape our observation.	日常の行動の大部分が観察もできない隠された動機の結果なのである。
It is more especially with respect to those unconscious elements which constitute the genius of a race that all the individuals belonging to it resemble each other, while it is principally in respect to the conscious elements of their character--the fruit of education, and yet more of exceptional hereditary conditions--that they differ from each other.	ある民族に属する個人どうしが互いによく似ているのは民族の性質を決定する無意識的要素によるものであり、個々の人間に差異があるのは教育の成果や遺伝条件といった意識的要素によるものである。
Men the most unlike in the matter of their intelligence possess instincts, passions, and feelings that are very similar.	知性の面ではかなり異なる者どうしであったとしても、本能や情熱、感情という点から見れば大した差はない。
In the case of every thing that belongs to the realm of sentiment--religion, politics, morality, the affections and antipathies, &c.--the most eminent men seldom surpass the standard of the most ordinary individuals.	感情に関することがら、例えば宗教・政治・道徳・愛情・反感など*6は、どんなに優れた人が居たとしても常人のレベルを遥かに超越することなどできない。
From the intellectual point of view an abyss may exist between a great mathematician and his boot maker, but from the point of view of character the difference is most often slight or non-existent.	偉大な数学者とその数学者のはく靴をつくる職人とでは知性の面では大きな隔たりがある*7が、性質の面から言えば差は全くないか、あっても極めて少しである。
It is precisely these general qualities of character, governed by forces of which we are unconscious, and possessed by the majority of the normal individuals of a race in much the same degree--it is precisely these qualities, I say, that in crowds become common property.	この性質（性格）の一般的傾向は無意識の力によって支配されているものであり、１つの民族に属する標準的な個人が同程度に持っているもので、まさにこれが群集として共通に現れる性質なのである。
In the collective mind the intellectual aptitudes of the individuals, and in consequence their individuality, are weakened.	集団的精神の中では個人の知的な才能・個性は弱体化する。
The heterogeneous is swamped by the homogeneous, and the unconscious qualities obtain the upper hand.	同質性が異質性を凌駕し、無意識的性質が優性になるのだ。*8
This very fact that crowds possess in common ordinary qualities explains why they can never accomplish acts demanding a high degree of intelligence.	高度な知性が要求される行為を群集が為し得ないのは、まさに群集が凡庸な性質を共通に持っているという事実によるものである。
The decisions affecting matters of general interest come to by an assembly of men of distinction, but specialists in different walks of life, are not sensibly superior to the decisions that would be adopted by a gathering of imbeciles.	それぞれ分野の異なる専門家による一般的事項に関する会議の結論が、愚かな人々*9による会議の結論に比べて優れていると言うわけではない。
The truth is, they can only bring to bear in common on the work in hand those mediocre qualities which are the birthright of every average individual.	実際のところ、平均的個人が持って生まれた凡庸な性質で取り組むしかないのである。
In crowds it is stupidity and not mother-wit that is accumulated.	群集の中では蓄積されるのは持って生まれた才覚ではないのだ。
It is not all the world, as is so often repeated, that has more wit than Voltaire, but assuredly Voltaire that has more wit than all the world,	頻繁に繰り返されてきたことであるが、世界中の誰もがヴォルテール（Voltaire:本名 Francois Marie Arouet;1694 - 1778）ほど機知に富んではいない。
if by "all the world" crowds are to be understood.	もしこの「世界中」というのが群集を意味するのであれば、確かにそうなのだ。
If the individuals of a crowd confined themselves to putting in common the ordinary qualities of which each of them has his share, there would merely result the striking of an average, and not, as we have said is actually the case, the creation of new characteristics.	しかし、もし群集を構成するそれぞれが、［群集になることで］その平凡な性質を混合するだけのことであったなら、単に平均化という結果が得られるだけで、先ほどから見ている、新しい性質が発生することは説明されない。
How is it that these new characteristics are created?	ならば、この新しい性質はどうやって生まれてくるのか。
This is what we are now to investigate.	それを今から考えてみよう。
Different causes determine the appearance of these characteristics peculiar to crowds, and not possessed by isolated individuals.	隔絶された個人が持っていない性質で、群衆のみが持つ性質が出現するためには様々な要因が挙げられる。
The first is that the individual forming part of a crowd acquires, solely from numerical considerations, a sentiment of invincible power which allows him to yield to instincts which, had he been alone, he would perforce have kept under restraint.	１つめの要因は、もし１人でいたならばきっと抑制したであろうが、ただ群集の一部を構成しているというだけで、まるで無敵の力が本能を解き放つかのような意識にとらわれることである。
He will be the less disposed to check himself from the consideration that, a crowd being anonymous, and in consequence irresponsible, the sentiment of responsibility which always controls individuals disappears entirely.	群集が匿名となり、そのために責任の所在がわからなくなれば、群集を構成する個人は自らの行動に対する責任をとり、行動を制御する感覚が全く無くなってしまうのだ。
The second cause, which is contagion,	２つめの要因は伝染である。
also intervenes to etermine the manifestation in crowds of their special characteristics, and at the same time the trend they are to take.	群集を特徴付けるものであり、かつ同時に群集がとる傾向である。
Contagion is a phenomenon of which it is easy to establish the presence, but that it is not easy to explain.	この伝染という現象はよく見うけられるが、［それがなぜ起こるかについての］説明は容易ではない。
It must be classed among those phenomena of a hypnotic order, which we shall shortly study.	この現象は催眠術のようなものとは区別されねばならず、近いうちに解明されるべき課題である。
In a crowd every sentiment and act is contagious, and contagious to such a degree that an individual readily sacrifices his personal interest to the collective interest.	群集の中では感情も行動も伝染し、［群集の］集団的な利益のためには個人の利益が簡単に犠牲にされることもあるくらいだ。
This is an aptitude very contrary to his nature, and of which a man is scarcely capable, except when he makes part of a crowd.	これは個人の本性とは真っ向から対立し、群集の一部でいる時以外にはまず現れない性質である。
