The Adventure of the Solitary Cyclist	自転車嬢の危難自転車嬢の危難
Conan Doyle	コナン・ドイル
From the years 1894 to 1901 inclusive, Mr. Sherlock Holmes was a very busy man.	一八九四年から一九〇一年までの八年間は、シャーロック・ホームズは、とても多忙な身であった。
It is safe to say that there was no public case of any difficulty in which he was not consulted during those eight years, and there were hundreds of private cases, some of them of the most intricate and extraordinary character, in which he played a prominent part.	この八年間に、公の事件で重大なものは、一つとしてホームズのところに、持って来られなかったものはなかったし、またその外（ほか）に私的の事件で扱ったものは、無数で、その中（うち）でも、実に錯綜した難問題で、颯爽たる役目をやったものもたくさんあった。
Many startling successes and a few unavoidable failures were the outcome of this long period of continuous work.	この雑多の仕事の中では、もちろんその大部分は、赫々（かくかく）たる成功を収めているのであったが、しかしまたその二三のものでは、全く避けがたい、不可能な失敗に終ったものもあった。
As I have preserved very full notes of all these cases, and was myself personally engaged in many of them it may be imagined that it is no easy task to know which I should select to lay before the public.	こうして無数の興味ある事件の記録を、私は山積するほどたくわえてあるし、またその中の大部分には、私自身も関与しているので、まずどれから読者諸君の前に提供しようかと云うことは、私にとってはとても心迷いがされて、容易に決断のつかないことは想像してもらいたい。
I shall, however, preserve my former rule, and give the preference to those cases which derive their interest not so much from the brutality of the crime as from the ingenuity and dramatic quality of the solution.	しかし私はやはり、以前からの習慣を踏襲して、事件の選択方針としては、事件が残忍で興味があったと云うことよりも、むしろその解決方法が実に巧妙で劇的であったと云う見地からしてみたいと思う。
For this reason I will now lay before the reader the facts connected with Miss Violet Smith, the solitary cyclist of Charlington,	こう云う理由から私はまず読者諸君の前にチャーリントンの、一人歩きの自転車乗り嬢であった、ヴァイオレット・スミス嬢の事件を、持ち出そうと思う。
and the curious sequel of our investigation, which culminated in unexpected tragedy.	この事件は我々の探査が、意外から意外へと外（そ）れて、更に全く思いももうけなかった、悲劇のクライマックスを示した、全く意想外の興味ある事件だったものである。
It is true that the circumstance did not admit of any striking illustration of those powers for which my friend was famous, but there were some points about the case which made it stand out in those long records of crime from which I gather the material for these little narratives.	私の友人の有名を成さしめた事柄については、毎度お断りする通り、詳細に発表することは許されない事情にあるが、しかし私の浩翰（こうかん）な犯罪秘記の中（うち）でも、こうした小さな物語を書く上から云って、この事件は一段と際立った出色の点があると思われるのである。
On refering to my notebook for the year 1895, I find that it was upon Saturday, the 23d of April, that we first heard of Miss Violet Smith.	一八九五年の私の記録を開いてみると、私たちが初めて、ヴァイオレット・スミス嬢を知ったのは、四月二十三日土曜日と記されてある。
Her visit was, I remember, extremely unwelcome to Holmes,	私はこれを見て思い出すが、彼の女の来訪をシャーロック・ホームズは、ひどく歓迎しなかった。
for he was immersed at the moment in a very abstruse and complicated problem concerning the peculiar persecution to which John Vincent Harden, the well known tobacco millionaire, had been subjected.	と云うのは当時はホームズは、煙草成金として有名な、ジョン・ヴィセント・ハーデンに関する、とても錯綜した難かしい、脅迫事件に没頭していたのであった。
My friend, who loved above all things precision and concentration of thought, resented anything which distracted his attention from the matter in hand.	私の友人は、何よりもまず事物の正確と、思考の集中を愛するだけに、また、自分のやりかけている事に、横道から闖入されることも、ひどく嫌うのであった。
And yet without a harshness which was foreign to his nature, it was impossible to refuse to listen to the story of the young and beautiful woman, tall, graceful, and queenly, who presented herself at Baker Street late in the evening, and implored his assistance and advice.	ヴァイオレット・スミス嬢は、その夜おそく、ベーカー街にやって来たのであったが、この美しい背の高い、物腰の上品な、若い婦人に突然に来訪されて、その話を持ち出されて、懇ろに依頼されても、ホームズはその持前の柄にもなく、意外に不愛想であった。
It was vain to urge that his time was already fully occupied,	しかし彼はもう今は手一ぱいで、何も引き受ける余裕は無いと云うようなことを云っても、結局その美しい訪客にとっては、何の効果もなかった。
for the young lady had come with the determination to tell her story, and it was evident that nothing short of force could get her out of the room until she had done so.	もうどんなことがあっても、一通りの事情を話して、いやでも応でも、ホームズの助力を得ようと、その婦人は死に物狂いの決心をきめて来たので、引きずり出しでもすればともかく、さもなければ、もうとても追い返すことなどは出来そうも無い容子であった。
With a resigned air and a somewhat weary smile, Holmes begged the beautiful intruder to take a seat, and to inform us what it was that was troubling her.	それでとうとうホームズも根負けがしてしまって、はなはだ気の進まないような微笑を漏らしながら、とにかく一応その話をきこうと云うことで、その美しい訪客を椅子に招じたのであった。
``At least it cannot be your health,''	「とにかくお嬢さん、あなたはそんなに自転車に熱中しては、身体のためによくありませんよ」
said he, as his keen eyes darted over her:	ホームズは、例の鋭い視線を、その美しい訪客に一渡り投げかけた後に云った。
She glanced down in surprise at her own feet,	彼の女はハッと驚いて、自分の脚の方を見下した。
and I observed the slight roughening of the side of the sole caused by the friction of the edge of the pedal.	私もその方を見ると、靴の底の横の方が、ベタルのために軽くささくれ立っていた。
``Yes, I bicycle a good deal, Mr. Holmes, and that has something to do with my visit to you to-day.''	そうです、私は御覧の通り自転車に乗りますが、実は私が今夜お訪ねしましたのも、これに関連があるのでございますが、――」
My friend took the lady's ungloved hand, and examined it with as close an attention and as little sentiment as a scientist would show to a specimen.	私の友人はその若い婦人の、手袋を取っていた手をとって、あたかも科学者が標本でも観察する時のように、冷静に注意深く眺めた。
``You will excuse me.	「いや、失礼はお許し下さい。
I am sure. It is my business,''	どうもこれは私の商売柄なんで仕方がないのです」
said he, as he dropped it.	彼はその手を放しながら云った。
``I nearly fell into the error of supposing that you were typewriting.	「私は今もう少しであなたをタイプライターを打ってる人と間違えるところでしたが、
Of course, it is obvious that it is music.	もちろんあなたは、音楽家ですな。
You observe the spatulate finger-ends, Watson, which is common to both professions?	で、ワトソン君指先が箆（へら）のように平べったくなっているだろう、
There is a spirituality about the face, however''	――これがこの二つの職業には、共通の特徴なんだが、しかしこちらは表情に、霊感的なところがある」
-- she gently turned it towards the light	私の友人はこう云いながら、その婦人の顔を静かに、燈火（あかり）の方に向けた。
-- ``which the typewriter does not generate.	「これはタイピストには見られないものだ。
This lady is a musician.''	この御嬢さんは音楽家さ」
``Yes, Mr. Holmes, I teach music.''	「その通りでございます、ホームズ先生、私は音楽を教えておりますの」
``In the country, I presume,	「それも田舎ででしょう、
from your complexion.''	――あなたの御血色では、――」
``Yes, sir,	「そうです。
near Farnham, on the borders of Surrey.''	サーレーの外れの、ファーナムの近くでございます。」
``A beautiful neighbourhood,	「それはとても美しい近郊ですな。
and full of the most interesting association.	私どももあの地方にはたくさんの面白い聯想（れんそう）を持っていますよ。
You remember, Watson, that it was near there that we took Archie Stamford, the forger.	そらワトソン君、俺たちがあの文書偽造犯人の、アーチェ・スタンフォードを捕えたのは、あの近所だったよ。
Now, Miss Violet, what has happened to you, near Farnham, on the borders of Surrey?''	さてヴァイオレットさん、そのサーレーの外れのファーナムの近くに、どんなことがあったのですかお話し下さい」
The young lady, with great clearness and composure, made the following curious statement:	その若い美しい娘さんは、とてもよく落ついて明瞭に次のような奇妙な物語りを話し出した。
``My father is dead, Mr. Holmes.	「ホームズ先生、――父は亡くなりましたが、
He was James Smith, who conducted the orchestra at the old Imperial Theatre.	ジェームズ・スミスと申しまして、古い帝室劇場の、オーケストラのコンダクターをしておりました。
My mother and I were left without a relation in the world except one uncle Ralph Smith, who went to Africa twenty-five years ago, and we have never had a word from him since.	そして私は母と二人生きのこったのでございますが、私たちには、身寄りの者と云うものも無く、ただラルフ・スミスと云う叔父が一人あるだけでございましたが、それも二十五年も前に、アフリカに渡って行ったっきり、その後は何の消息もございませんでした。
When father died, we were left very poor, but one day we were told that there was an advertisement in the Times, inquiring for our whereabouts.	父が亡くなった時は、私どもは大変貧乏でしたが、ある日私どもは、タイムス紙上に私たちの住所を求めている広告が出ていたときかされたのでございました。
You can imagine how excited we were, for we thought that someone had left us a fortune.	まあ私たちの喜（よろこび）は御想像にお委せしますが、実は私たちは誰か私たちに遺産でものこしてくれたのかと、本当に喜びました。
We went at once to the lawyer whose name was given in the paper.	私たちは早速、新聞に出ていた弁護士のところにゆきました。
There we met two gentlemen, Mr. Carruthers and Mr. Woodley,	そこで私たちは、カラザースとウードレーと云う二人の方にお目にかかりました。
who were home on a visit from South Africa.	この人達はどちらも、南アフリカから帰国していた人たちでした。
They said that my uncle was a friend of theirs that he had died some months before in great poverty in Johannesburg, and that he had asked them with his last breath to hunt up his relations, and see that they were in no want.	その人たちの云うには、その人たちは私達の叔父の友だちで、叔父は二三ヶ月前に、ヨハネスブルグで貧困のうちに亡くなったが、その最後の際に、その親戚の者で、大変困っている者があるかどうかを、調べてみてくれと云ったとのことでした。
It seemed strange to us that Uncle Ralph, who took no notice of us when he was alive should be so careful to look after us when he was dead, but Mr. Carruthers explained that the reason was that my uncle had just heard of the death of his brother, and so felt responsible for our fate.''	生前はちっとも交渉の無かった叔父のラルフが、その死後に気にかけてくれるなどと云うことは、全く不思議なことでございましたが、なおカラザースさんの云うには、叔父のラルフが私の父の死をきいたので、私たちの上に責任を感じてそう言ったのだと云うことでした」
``Excuse me.''	「ちょっと――」
said Holmes.	ホームズは言葉をさしはさんだ。
``When was this interview?''	「その会見はいつでした？」
``Last December	「去年の十二月
-- four months ago.''	――つまり四ヶ月前でございます」
``Pray proceed.''	「さあ、その先を、――」
``Mr. Woodley seemed to me to be a most odious person.	「ウードレーと云う人は、私にはとてもいやな男に思われました。
He was for ever making eyes at me	始終私に失礼な目つきをして、
-- a coarse, puffy-faced, red-moustached young man, with his hair plastered down on each side of his forehead.	――下品な膨れっ面の、赤い髭をした、テカテカ光らせた髪を、額の両側に垂れ下げた、いやらしい奴ったらありませんでしたわ。
I thought that he was perfectly hateful -- and I was sure that Cyril would not wish me to know such a person.''	私はこんな男と知り合いになることは、とてもシイリールに対してすまないと思いましたわ」
``Oh, Cyril is his name!''	「おやおや、シイリールと云うのは、そうすると、あの人の名前なのですか！」
said Holmes, smiling.	ホームズはニヤニヤ笑いながら云った。
The young lady blushed and laughed.	この美しい娘さんも、顔を真赤にして笑った。
``Yes, Mr. Holmes,	「ホームズ先生、そうでございます。
Cyril Morton,	シイリール・モートンと申しますの。
an electrical engineer,	電気技師ですわ。
and we hope to be married at the end of the summer.	私たちは、この夏の末には、結婚しようと思っておりますの。
Dear me, how did I get talking about him?	まあいやだ私は、どうしてこんなことまで、お話してしまったのでしょう！
What I wished to say was that Mr. Woodley was perfectly odious, but that Mr. Carruthers, who was a much older man, was more agreeable.	私はただ、ウードレーと云う人はとてもいやな奴で、カラザースさんの方は、もっと年はとっていましたが、ずっと性に合った人だったと云うことだけを、お話するつもりでしたのに、
He was a dark, sallow, clean-shaven, silent person,	――カラザースさんは、やや暗い沈んだ感じの、きれいに顔を剃った、口数の少ない人でした。
but he had polite manners and a pleasant smile.	そして物腰はとても上品で、笑う時はとても気持のいい人でした。
He inquired how we were left, and on finding that we were very poor, he suggested that I should come and teach music to his only daughter, aged ten.	そして父の死後のことについて、親切に訊ねて下さって、私たちが貧しいと云うことを知りましたら、その十になるお嬢さんに、音楽を教えに来てくれと云うのでした。
I said that I did not like to leave my mother, on which he suggested that I should go home to her every week-end, and he offered me a hundred a year,	それで私は、母の側（そば）を離れるのはいやだと申しましたら、毎土曜日には、母のところに帰るように、そして給料は、年に百磅（ポンド）出してくれると云うことでした。
which was certainly splendid pay.	これは申すまでもなく私にとっては、とても素晴らしい給料でございますからね。
So it ended by my accepting, and I went down to Chiltern Grange, about six miles from Farnham.	それで私はそれをお受けして、ファーナムから六哩（まいる）ばかり離れた、チルターン・グランジに行きました。
Mr. Carruthers was a widower, but he had engaged a lady housekeeper, a very respectable, elderly person, called Mrs. Dixon, to look after his establishment.	カラザースさんは独身男でしたが、しかし、家政婦のディクソンと云う、もう年配の、なかなかしっかりした婦人と婚約が出来ていました。
The child was a dear, and everything promised well.	小供は大層可愛（かあい）い子で、もう何もかも面白くゆきそうでした。
Mr. Carruthers was very kind and very musical, and we had most pleasant evenings together.	カラザースさんは、大へん親切で、音楽もよく解り、夕（ゆうべ）の集いはとても愉快でした。
Every week-end I went home to my mother in town.	そして土曜日土曜日には、私は町の方の母のところに帰るのでございました。
``The first flaw in my happiness was the arrival of the red-moustached Mr. Woodley.	こうした私の幸福な生活に、最初の禍（わざわい）を持って来たのは、すなわちウードレーの赤髭顔でございました。
He came for a visit of a week, and oh! it seemed three months to me.	彼は一週間と云うことで訪ねて来たのでしたが、しかし私には全くその間が三月以上もの長さに思われましたわ。
He was a dreadful person -- a bully to everyone else, but to me something infinitely worse.	彼はもともと誰からも嫌われる人間のようでしたが、しかし私にとっては取り分けて悪人でした。
He made odious love to me, boasted of his wealth, said that if I married him I could have the finest diamonds in London,	彼は失礼にも私を愛してるなどと云って、その富を鼻にかけて、もし私が彼と結婚するなら、ロンドンで一番大きなダイヤモンドを買ってくれるなどと云うのでした。
and finally, when I would have nothing to do with him, he seized me in his arms one day after dinner	そして遂には、私がどうしても取り合わないと見て取って、ある日の夕食後に、私をしっかりと押えつけて、
-- he was hideously strong	――それはとても怖ろしい力でしたが、
-- and swore that he would not let me go until I had kissed him.	私がキスをしない中（うち）は、どうしても放さないと云うのでした。
Mr. Carruthers came in and tore him from me, on which he turned upon his own host, knocking him down and cutting his face open.	そこにちょうどカラザースさんが入って来て、彼から私を引き放してくれましたけれど、今度はこの暴漢は、主人の方に方向転換して、散々なぐりかかって、遂にその顔に怪我までもさせてしまったのでした。
That was the end of his visit, as you can imagine.	これが申すまでもなくその男の訪問の最後でございましたが、
Mr. Carruthers apologized to me next day, and assured me that I should never be exposed to such an insult again.	次の日カラザースさんは、私に陳謝して下さって、もう二度とこう云う侮辱には遭わせないからと、固く誓って下さるのでございました。
I have not seen Mr. Woodley since.	その後は私は、ウードレーをもう見ませんの。
``And now, Mr. Holmes, I come at last to the special thing which has caused me to ask your advice to-day.	そしてホームズ先生、これからがいよいよ、私が今夜伺った、特別の事情のお話になるのでございますが、
You must know that every Saturday forenoon I ride on my bicycle to Farnham Station, in order to get the 12:22 to town.	まず私は毎土曜日の午前に、十二時二十二分の列車に乗るために、ファーナムの停車場まで、自転車に乗ってゆくことを御承知おき下さいまし。
The road from Chiltern Grange is a lonely one,	そのチルタアーングランジからの道は、それはそれは寂しいのでございますよ。
and at one spot it is particularly so, for it lies for over a mile between Charlington Heath upon one side and the woods which lie round Charlington Hall upon the other.	殊にあの一方は、チャーリントンの荒地で、その一方はチャーリントンの廃院を包む森の間の、一哩（まいる）ばかりの間と云うものは、とても寂しいのでございますの。
You could not find a more lonely tract of road anywhere,	あんな寂しいところは全く、どこにもないと云ってもいいほどだと思いますわ。
and it is quite rare to meet so much as a cart, or a peasant, until you reach the high road near Crooksbury Hill.	あのクロックスベリーの丘の、広い道に来るまでは、荷馬車一台、百姓一人に逢うことさえも稀なのでございます。
Two weeks ago I was passing this place, when I chanced to look back over my shoulder, and about two hundred yards behind me I saw a man, also on a bicycle.	それがちょうど二週間前でございますが、私がちょうどそこを通っている時に、ふと肩越しに後を振り返ってみましたら、やはり自転車に乗った一人の男が、私の後方二百碼（ヤード）くらいのところをついて来るのに目が止まりました。
He seemed to be a middle-aged man, with a short, dark beard.	その男は中年の、身体の小さな、黒い髭の者のようでございましたが、
I looked back before I reached Farnham, but the man was gone, so I thought no more about it.	それからファーナムに着く前に、また振り返ってみましたら、もうその男は見えませんでしたので、私も別に意にも止めませんでした。
But you can imagine how surprised I was, Mr. Holmes, when, on my return on the Monday, I saw the same man on the same stretch of road.	ところが月曜日に私が帰って来る時に、またこの同じ場所で、同じ姿を見た時は、私は全く吃驚してしまいました。
My astonishment was increased when the incident occurred again, exactly as before, on the following Saturday and Monday.	それから更にその次の土曜日と月曜日にも、同様でしたので、今度は私は本当に怖ろしくなってしまったのでございます。
He always kept his distance and did not molest me in any way, but still it certainly was very odd.	その男は常に一定の間隔を取っていて、決して私に何の妨害もしませんでしたが、それでも変に気味悪く奇妙なのでございます。
I mentioned it to Mr. Carruthers, who seemed interested in what I said, and told me that he had ordered a horse and trap, so that in future I should not pass over these lonely roads without some companion.	それで私はこの事をカラザースさんに話しましたら、カラザースさんは、私の云うことに、多少の興味を持ったようでしたが、馬と馬車を用意したから、今後はそう云う寂しい処を、一人で通らせるようなことはしないと仰って下さるのでございました。
``The horse and trap were to have come this week, but for some reason they were not delivered, and again I had to cycle to the station.	その馬と馬車は、今週は来るはずでしたのを、何かの理由（わけ）で来ませんでしたので、また私は自転車で停車場に行くことになったのでございました。
That was this morning.	つまり今朝でございますが、
You can think that I looked out when I came to Charlington Heath, and there, sure enough, was the man, exactly as he had been the two weeks before.	やはり私がチァーリントンの森にさしかかりますと、以前二週間の間に見た男の姿が、またしてもたしかについて来るのでございました。
He always kept so far from me that I could not clearly see his face, but it was certainly someone whom I did not know.	その男はいつも私から、その顔がよく見えない程度に離れておりますので、よくは見ることが出来ませんでしたが、いずれ私の知らない者だろうと思われますの。
He was dressed in a dark suit with a cloth cap.	彼は黒い着物を着て、地衣（きれ）の帽子をかぶっていました。
The only thing about his face that I could clearly see was his dark beard.	私の目にはっきりと残っているものは、ただその灰黒色（かいこくしょく）の髭だけでございます。
To-day I was not alarmed, but I was filled with curiosity, and I determined to find out who he was and what he wanted.	今日は私は、決して怖ろしくはありませんでしたが、むしろ好奇心にかられて、一たいどんな者か、そして何のためにこんなことをするのかを確めようと心をきめて、自転車の速力をゆるめましたら、やはり向うでも、速力を落すのでございます。
I slowed down my machine, but he slowed down his.	それで私は遂に車を止めましたら、やはり向うでも止めました。
Then I laid a trap for him.	それで今度はうまく瞞しこんでやろうと思って、
There is a sharp turning of the road, and I pedalled very quickly round this, and then I stopped and waited.	ちょうど道はそこで鋭く曲りますので、私は全速力を出して、その角を曲って、急に車を止めて、その角のところに待ち伏せしましたの。
I expected him to shoot round and pass me before he could stop.	その者はやはり全速力で追っかけて来て、その角の前を、うまく通りすぎるだろうと思いましたら、
But he never appeared.	やはりその男は追っかけて来ません。
Then I went back and looked round the corner.	それで私はすぐに引き返して、その角から後の方を見ましたら、
I could see a mile of road, but he was not on it.	そこからは一哩（まいる）くらいの間は、見通しが出来るのでしたが、もうその男の姿は見えませんでした。
To make it the more extraordinary, there was no side road at this point down which he could have gone.''	その上に更に不思議なことには、その間には彼が遁（に）げこむような、横道は決して無いのでございます」
Holmes chuckled and rubbed his hands.	ホームズは喜色を漏らして、彼の手をさすった。
``This case certainly presents some features of its own,''	「この事件はなかなか特色がある」
said he.	彼は云った。
``How much time elapsed between your turning the corner and your discovery that the road was clear?''	「あなたが道の曲り角をまがってから、道路の上に誰も居なくなったのを見たのは、どのくらいの時間がたってからでした？」
``Two or three minutes.''	「まあ、せいぜい二分か三分だと思いましたが、――」
``Then he could not have retreated down the road,	「それではその者は、道を真直ぐに遁げ帰ったはずはないが、
and you say that there are no side roads?''	――またそこには全く、横道もないと云うのですな？」
``None.''	「ございません」
``Then he certainly took a footpath on one side or the other.''	「それではその者は、どっちかの側に、遁げこんだのでしょう、――」
``It could not have been on the side of the heath,	「もしそうだとすれば、それは荒地の方なはずはありません。
or I should have seen him.''	もしそうでしたら、私から見えたはずでしたから、――」
``So, by the process of exclusion, we arrive at the fact that he made his way toward Charlington Hall,	「それでは我々は結局、その者はチァーリントン廃院の中に遁げこんだに相違ないと、考えることが出来ますな。
which, as I understand is situated in its own grounds on one side of the road.	いや私も知っていますが、あのチァーリントンの廃院は、すぐ道路の側（そば）になっていますからね。
Anything else?''	その外に何かありましたか？」
``Nothing, Mr. Holmes, save that I was so perplexed that I felt I should not be happy until I had seen you and had your advice.''	「ホームズ先生、もうそれだけでございますが、どうも私は先生にお目にかかって、いろいろと伺わない中（うち）は安心が出来ませんので、――」
Holmes sat in silence for some little time.	ホームズはしばらくの間はただじっと黙していた。
``Where is the gentleman to whom you are engaged?''	「あなたの御婚約の方は、どちらに居らっしゃるのですか？」
he asked at last.	彼はようやく口を開いた。
``He is in the Midland Electrical Company, at Coventry.''	「コヴェントリーの、ミドランド電気会社に居りますの」
``He would not pay you a surprise visit?''	「不意にあなたを訪問して来るようなことは、ありませんでしたか？」
- ``Oh, Mr. Holmes!	「あら、ホームズ先生、
As if I should not know him!''	それでは私がまるであの人を知らないようではございませんの？」
``Have you had any other admirers?''	「その他にまだあなたを好きな人がありましたか？」
``Several before I knew Cyril.''	「シイリールを知る前に、少しございましたわ」
``And since?''	「その後には？」
``There was this dreadful man, Woodley,	「その後でしたら、あの怖ろしいウードレーでございます。
if you can call him an admirer.''	まあもしあの男もそうだとお思いになるならでございますが、――」
``No one else?''	「その他にはありませんか、
Our fair client seemed a little confused.	この美しい若い依頼者は、ちょっと困った形であった。
``Who was he?''	「いや、それではあの人はどんな人ですかね？」
asked Holmes.	ホームズは訊ねた。
``Oh,	「ああ、
it may be a mere fancy of mine;	――でもこれはただ私だけの想像なんでございますけれど、
but it had seemed to me sometimes that my employer, Mr. Carruthers, takes a great deal of interest in me.	私にはあの主人のカラザースさんは、とても興味を持っていると思われることが時々ございましたわ。
We are thrown rather together.	私たちは、全く開けっ放しで、
I play his accompaniments in the evening.	夜は私はあの方の伴奏を弾きました。
He has never said anything.	もちろんしかし彼はいつも、何にも云いませんでした。
He is a perfect gentleman.	彼はたしかに立派な紳士ですが
But a girl always knows.''	しかし、女の心と云うものは、いつもよく解っているものでございます」
``Ha!''	「ははあ！」
Holmes looked grave.	ホームズは真面目な表情をした。
``What does he do for a living?''	「生計の方はどうして立てているのですか？」
``He is a rich man.''	「あの人はお金持ちですもの」
``No carriages or horses?''	「馬車や馬は持っていませんか？」
``Well, at least he is fairly well-to-do.	「ええ、しかし何しろとてもいい生活でございますよ。
But he goes into the city two or three times a week.	あの方は毎週二三度はロンドンに出ますが、
He is deeply interested in South African gold shares.''	何でも南アフリカの採金地の株に、非常に興味を持っているようでございますわ」
``You will let me know any fresh development, Miss Smith.	「それではスミスさん、いずれこの上にも変ったことがありましたら、また入らして下さい。
I am very busy just now, but I will find time to make some inquiries into your case.	私は実は今は非常に忙（せ）わしいのですが、しかしいずれその中（うち）にあなたの御依頼のことにも、研究を進めてみましょう。
In the meantime, take no step without letting me know.	しかしこの間に、私に断りなしに、事を進めてはいけませんぞ。
Good-bye,	ではさようなら、
and I trust that we shall have nothing but good news from you.''	――あなたから吉報が来るようにいのっていますよ」
``It is part of the settled order of Nature that such a girl should have followers,''	「あんな美しい娘さんを追いまわすと云うことは、あまりに自然の命ずるままのいたずらだ」
said Holmes, as he pulled at his meditative pipe.	ホームズは彼の静思の時の、パイプを取り上げながら云った。
``but for choice not on bicycles in lonely country roads.	「寂しい田舎道までを、自転車などに乗って歩かなければいいものをね。
Some secretive lover, beyond all doubt.	まあいずれ誰か、人知れず懸想している者も、あるには相違ないが、
But there are curious and suggestive details about the case.	しかしこの事件には、ちょっと奇妙な、暗示的な変な性質が潜んでいるように思われるよ、
Watson.''	ワトソン君、――」
``That he should appear only at that point?''	「と云うのは、その者は同一の場所にだけ現われると云うためにかね？」
``Exactly.	「そうだ。
Our first effort must be to find who are the tenants of Charlington Hall.	我々はまず、チァーリントンの廃院に、どんな者が住み込んでいるか、それを探り出さなければならない。
Then, again, how about the connection between Carruthers and Woodley,	それからカラザースとウードレーの関係を調べてみなければならない。
since they appear to be men of such a different type?	この二人はどうもとても性質が相背馳（あいはいち）しているようだからね。
How came they both to be so keen upon looking up Ralph Smith's relations?	それからこの二人がどうして、ラルフ・スミスの親類に、熱心に注目するようになったか？
One more point.	それから更にもう一つは、
What sort of a menage is it which pays double the market price for a governess but does not keep a horse, although six miles from the station?	女家庭教師に普通の二倍もの給料を払いながら、停車場まで六哩（まいる）もあると云うのに、馬一頭飼ってないと云うのは、一たいどう云う家政なのだろうね？
Odd, Watson	ワトソン君、これはおかしいよ。
-- very odd!''	これはどうしたっておかしいよ」
``You will go down?''	「君はしかし出かけるだろう？」
``No, my dear fellow, you will go down.	「いや相棒君、君が出かけてみてくれたまえ。
This may be some trifling intrigue, and I cannot break my other important research for the sake of it.	これは案外つまらないものかもしれないし、僕はこのために、他の重大なものを、中絶させることは出来ないのだ。
On Monday you will arrive early at Farnham;	月曜日に早く、ファーナムに行って、
you will conceal yourself near Charlington Heath;	チァーリントンの森の中に、隠れていてごらん。
you will observe these facts for yourself, and act as your own judgment advises.	そうしたらいずれ君は事実を目撃するだろうが、その時君の独断専行で、善処してみるさ。
Then, having inquired as to the occupants of the Hall,	それから廃院の住人たちを調べて来てくれること、
you will come back to me and report.	――これだけをやって来てもらえば、大（おおい）に助かるんだがね。
And now, Watson,	そしてワトソン君、
not another word of the matter until we have a few solid stepping-stones on which we may hope to get across to our solution.''	――あとはもうこの問題の解決の、牢固（ろうこ）たる足がかりを得るまでは、何にも云わないことにするよ」
We had ascertained from the lady that she went down upon the Monday by the train which leaves Waterloo at 9:50, so I started early and caught the 9:13.	私たちは、あの娘さんから、月曜日の午前九時五十分の汽車で、ウォーターローの停車場を発って行くときかされていたので、私は早く出かけて、午前九時十三分の汽車に乗った。
At Farnham Station I had no difficulty in being directed to Charlington Heath.	ファーナムの停車場に着いてからは、私は別に迷いもしないで、すぐにチァーリントンの森に行くことが出来た。
It was impossible to mistake the scene of the young lady's adventure,	それから例の娘さんの、受難の地も決して見紛うようなところではなかった。
for the road runs between the open heath on one side and an old yew hedge upon the other, surrounding a park which is studded with magnificent trees.	道は広い荒原を通っていて、一方には荒野原、他方には巨木の林立した、公園を取り囲んだ、水松（いちい）の生籬（いけがき）のあるところ、
There was a main gateway of lichen-studded stone, each side pillar surmounted by mouldering heraldic emblems,	――そこには苔むした石でたたまれ、両側には紋章のついた柱の立っている正門があった。
but besides this central carriage drive I observed several points where there were gaps in the hedge and paths leading through them.	しかしこの車道の外（ほか）に、生籬に破れたところがあって、そこからも小径が通っているのだと云うことは、種々の点から私は気がついた。
The house was invisible from the road, but the surroundings all spoke of gloom and decay.	建物は道路から見えたが、その周囲の様子から考えると、だいぶ荒廃している感じであった。
The heath was covered with golden patches of flowering gorse, gleaming magnificently in the light of the bright spring sunshine.	荒蕪地（こうぶち）の方は、ハリエニシダの花が満開中で、四月の太陽を受けて、黄金色に燦爛（さんらん）としていた。
Behind one of these clumps I took up my position, so as to command both the gateway of the Hall and a long stretch of the road upon either side.	私はその一つの茂みのかげの、道路の両端と、廃院の門とがよく見える位置に身をひそめた。
It had been deserted when I left it, but now I saw a cyclist riding down it from the opposite direction to that in which I had come.	私が道路から横に入った時は、道路には何も見えなかったが、今は私が来た方向とは反対の方から、一人の自転車に乗った者の姿が現われた。
He was clad in a dark suit, and I saw that he had a black beard.	その者は灰黒色の着物を着て、黒い髭を蓄えているように思われたが、
On reaching the end of the Charlington grounds, he sprang from his machine and led it through a gap in the hedge, disappearing from my view.	チァーリントンの区域内に入って来ると、その者は自転車から降りて、生籬の間隙から忍び込んで、その影は見えなくなってしまった。
A quarter of an hour passed, and then a second cyclist appeared.	それから十五分ばかり経ったら、また別の自転車乗りの姿が現われた。
This time it was the young lady coming from the station.	今度のは例の娘さんが、停車場から来たのであった。
I saw her look about her as she came to the Charlington hedge.	チァーリントンの生籬のところまで来ると、彼の女は周囲を振返って見ているのが見えた。
An instant later the man emerged from his hiding-place, sprang upon his cycle, and followed her.	それからちょっとおくれて、生籬の間から、先の者が忍び出て、自転車に乗って彼の女を追っかけ始めたのであった。
In all the broad landscape those were the only moving figures, the graceful girl sitting very straight upon her machine, and the man behind her bending low over his handle-bar	一望開豁（いちぼうかいかつ）な荒野の中に、一方は自転車の上に、すっとその美しいフォームを立ててゆく若い美しい女性、一方はハンドルの上に低く身体をこごめて、これを追っかけてゆく、
with a curiously furtive suggestion in every movement.	――何かしら意味のありそうな、好奇心をそそらせる一場の活劇場の光景であった。
She locked back at him and slowed her pace.	彼の女は途中で振り返って、その男を見ながら、速力をゆるめた。
He slowed also.	そうするとその男もやはり速力をゆるめた。
She stopped.	彼の女はピタリと止まった。
He at once stopped, too, keeping two hundred yards behind her.	その男もすぐに止まって、二百碼（ヤード）ばかりの間隔を保った。
Her next movement was as unexpected as it was spirited.	その次の彼の女の行動は、全く思いも設けぬ敏（すば）しっこさであった。
She suddenly whisked her wheels round and dashed straight at him.	彼の女はクルリっと自転車をまわすと、一目散にその男の方に突進して行った。
He was as quick as she, however,	しかしこれを見たその男もまた、彼の女以上に駿敏であった。
and darted off in desperate flight.	やはり自転車を返して、死に物狂いの全速力で遁げ出した。
Presently she came back up the road again,	今は彼の女もまた引き返した。
her head haughtily in the air, not deigning to take any further notice of her silent attendant.	そして意気揚々と、自転車の上に反り返って、もう唖の従者には、一瞥も与えぬと云うように、昂然としてまた道を行くのであった。
He had turned also, and still kept his distance until the curve of the road hid them from my sight.	そうするとまたその男も引き返して、やはり二百碼（ヤード）ばかりの間隔で、二人の姿はその先の曲り角から、私には見えなくなってしまった。
I remained in my hiding-place, and it was well that I did so,	それからなお私は、その隠れ場にひそんでいたが、それはとてもいいことであった。
for presently the man reappeared, cycling slowly back.	その中（うち）に例の男は、ゆるやかに踏みながら、また自転車で引き返して来たのであった。
He turned in at the Hall gates, and dismounted from his machine.	それからその者は廃院の門から入って、自転車から降りた。
For some minutes I could see him standing among the trees.	ちょっとの間その者は立っていたが、
His hands were raised, and he seemed to be settling his necktie.	それはネクタイを結び直しているのらしかった。
Then he mounted his cycle and rode away from me down the drive towards the Hall.	それからまた自転車に乗って、廃院の方に進んで行った。
I ran across the heath and peered through the trees.	私は荒蕪地を走り抜けて、木の間を通してそれを覗いた。
Far away I could catch glimpses of the old gray building with its bristling Tudor chimneys, but the drive ran through a dense shrubbery, and I saw no more of my man.	はるか遠くに私は、チュードル［＃「チュードル」は底本では「チスードル」］風の煙突の屹立している、古い灰色の建物をチラチラと見たが、しかしその自転車乗りの姿は、濃い灌木の蔭になってしまって、もう見ることは出来なかった。
However, it seemed to me that I had done a fairly good morning's work, and I walked back in high spirits to Farnham.	けれども私は、とてもいい朝の仕事を、一つ仕終ったと思って、意気揚々として、ファーナムの停車場に引き返した。
The local house agent could tell me nothing about Charlington Hall, and referred me to a well known firm in Pall Mall.	この地方の建物の差配人は、チューリントン廃院のことについては、何も語ってはくれず、私にポール遊園地の、よく知られている、組合管理所を教えてくれた。
There I halted on my way home, and met with courtesy from the representative.	それで私は帰り道に、序（ついで）に立ち寄ったのであったが、そこの管理人は、非常に鄭重に応対してくれた。
No, I could not have Charlington Hall for the summer.	そのチューリントン廃院と云うのは、この夏はもう契約ずみであった。
I was just too late.	私はもうおそかった。
It had been let about a month ago.	一ヶ月ばかり前に、貸付の契約は出来てしまっていた。
Mr. Williamson was the name of the tenant.	ウィリアムソンと云うのが、その借り主だと云うことであったが、
He was a respectable, elderly gentleman.	それはなかなか尊敬するに足る、もう年長の老紳士だと云うのであった。
The polite agent was afraid he could say no more, as the affairs of his clients were not matters which he could discuss.	鄭重な管理人にもう、何も云うことはないので、ひどく困った様子をしていたが、たしかにこのお客様の要件と云うのは、その管理者にとって、口にしがたいことには相違ないことであった。
Mr. Sherlock Holmes listened with attention to the long report which I was able to present to him that evening,	その夜私は、これだけの長い報告を、シャーロック・ホームズ君のところに齎（もたら）した。
but it did not elicit that word of curt praise which I had hoped for and should have valued.	私は大変価値ある、そして多少の賞讃さえも、期待したことであったが、しかしそうした言葉は彼の口からは出て来なかった。
On the contrary, his austere face was even more severe than usual as he commented upon the things that I had done and the things that I had not.	それどころか、彼が私のやって来たこと、気がつかずに来たことに対する批評の時は、彼の峻厳な顔は、いよいよ嶮（けわ）しく変ってしまった。
``Your hiding-place, my dear Watson, was very faulty.	「いや、ワトソン君、
You should have been behind the hedge,	「そりゃ君は、生籬の蔭にかくれるべきだった。
then you would have had a close view of this interesting person.	そうすればその目的の人物を間近くで見ることが出来たわけじゃないかね。
As it is, you were some hundreds of yards away and can tell me even less than Miss Smith.	君も何百碼（ヤード）と云うものを離れて見たので、あの娘さんのスミス嬢以下の報告っきり出来ないじゃないか、
She thinks she does not know the man;	あの女は自分が知らない者だろうと云っていたが、
I am convinced she does.	しかし僕の見るところでは、あの女が知っている者に相違ないと思うのだ。
Why, otherwise, should he be so desperately anxious that she should not get so near him as to see his features?	だってもしそうでないとしたら、何もあの女が接近するのを、そんなに一生懸命で遁げる必要はないと思うからね。［＃「。」は底本では欠落］
You describe him as bending over the handle-bar.	君はその者がハンドルの上に身をこごめたと云うが、
Concealment again, you see.	それもすなわち、顔をかくしたのだろう。
You really have done remarkably badly.	君は全く徹頭徹尾間違ったよ。
He returns to the house, and you want to find out who he is.	その者は家に帰り、君はその者の正体をつき止めようとして、
You come to a London house agent!''	ロンドンの、貸家の差配人のところに来る、――」
``What should I have done?''	「じゃ僕は、どうすればよかったのだね？」
I cried, with some heat.	私はちょっと逆上（のぼ）せ気味になって叫んだ。
``Gone to the nearest public-house.	「そりゃ近所の居酒屋にとびこむのさ。
That is the centre of country gossip.	そこはその地方の噂（ゴシップ）の中心だ。
They would have told you every name, from the master to the scullery-maid.	そこに集（あつま）ってる者共は君に主人から食器洗いの者までの名前を教えてくれるだろう。
Williamson?	そうウィリアムソンと云ったね！
It conveys nothing to my mind.	しかしこの名前は、僕にも何の心当りもないな。
If he is an elderly man he is not this active cyclist who sprints away from that young lady's athletic pursuit.	しかしそれがもう相当の年配とすれば、あの活溌な若い自転車嬢さんに追跡されて、霞をくらって遁げた、素ばしっこい男なはずはないね。
What have we gained by your expedition?	さてこうなってみると、君の御苦労な遠征で得たものは何んだろうね？
The knowledge that the girl's story is true. I never doubted it.	なるほどあの娘さんの云ったことは逐一事実であると云うことはわかった。
That there is a connection between the cyclist and the Hall.	それから自転車乗りと、廃院とには何等かの関係のあること、
I never doubted that either.	廃院はウィリアムソンと云うものが借りたこと、
That the Hall is tenanted by Williamson.	――この二つはまあ僕も決して疑わないが、
Who's the better for that?	――ちょっとこれだけのことには誰も及びのつかないことだね。
Well, well, my dear sir,	まあ、まあ、わが敬愛する貴君
don't look so depressed.	――そう力を落としたもうな。
We can do little more until next Saturday, and in the meantime I may make one or two inquiries myself.''	次の土曜日までは、じっと日和を見て、その中（うち）には、僕自身でも一つ二つ手をかけてみるから、――」
Next morning, we had a note from Miss Smith,	次の朝私たちは、スミス嬢から一通の手紙を受け取った。
recounting shortly and accurately the very incidents which I had seen,	その中には、私が昨日目撃した事件を、正確に短文の中に要領よく書いてあった。
but the pith of the letter lay in the postscript:	しかし手紙の要旨は、追伸として末尾にかかれてあった。
I am sure that you will respect my confidence, Mr. Holmes, when I tell you that my place here has become difficult, owing to the fact that my employer has proposed marriage to me.	ホームズ先生、あなたは私の秘密を、お護り下さる御方（おんかた）と存じますが、私は、最近私の主人から求婚されて、ここでの私の立場は、非常に難しいものになって来たと云うことをお知らせいたします。
I am convinced that his feelings are most deep and most honourable.	私はあの人の感情は、最も深く最も尊敬すべきものだと信じています、
At the same time, my promise is of course given.	もちろんそれと同時に、私の約束も与えられることです。
He took my refusal very seriously, but also very gently.	あの人は私の拒絶を、非常に重大にとりまた非常に素直にも考えております。
You can understand, however, that the situation is a little strained.	いずれ局面が少し緊張して来たことを御想像下さいまし。
``Our young friend seems to be getting into deep waters,''	「あの娘さんは、段々に深みにはまってゆくらしいな、――」
said Holmes, thoughtfully, as he finished the letter.	ホームズは手紙を読み終ってから、考え深そうに云った。
``The case certainly presents more features of interest and more possibility of development than I had originally thought.	「この事件は、最初に僕が考えたよりも、もっと興味があって、また面白く発展してゆくらしいぞ。
I should be none the worse for a quiet, peaceful day in the country,	僕も田舎の静かな、平和な日のために、一臂（いちぴ）の力を添えてやっても、毒にもなるまいから、
and I am inclined to run down this afternoon and test one or two theories which I have formed.''	――今日は一つ午後から出かけて行って、考えた理論を二つ三つやってみるとするかな」
Holmes's quiet day in the country had a singular termination,	しかしホームズの田舎における静穏な日と云うのは全く変な結末を見せたのであった。
for he arrived at Baker Street late in the evening, with a cut lip and a discoloured lump upon his forehead, besides a general air of dissipation which would have made his own person the fitting object of a Scotland Yard investigation.	と云うのは彼は、夜おそくベーカー街に帰って来たのであったが、彼は唇には怪我をし、額には色の変った瘤を出かして云わば警視庁のお探ねものにもふさわしい、あのいつもの捕り手となる、放埓者（ほうらつもの）のような恰好をしていた。
He was immensely tickled by his own adventures and laughed heartily as he recounted them.	そして彼は自分の今日一日の冒険に、ひどく可笑しさを感じていたのか、底の底から笑いながら、一切の顛末（てんまつ）を語り出した。
``I get so little active exercise that it is always a treat,''	「僕は少しばかり活溌な運動をやって来たんだが、いやはや全く、御馳走さまなことさ！」
said he.	彼は云った。
``You are aware that I have some proficiency in the good old British sport of boxing.	「君、僕は御承知の通り、英国のあの結構な古来の拳闘については、少しばかり心得があるんだが、君、
Occasionally, it is of service;	あれは時々、とても役に立つ時があるよ。
today, for example, I should have come to very ignominious grief without it.''	例えば今日なども、もし僕があの心得がなかったら、全くいいざまを見るところだったよ」
I begged him to tell me what had occurred.	一たい何が起ったのか私は更に追求した。
``I found that country pub which I had already recommended to your notice, and there I made my discreet inquiries.	「僕は先に君にも云った、居酒屋を見つけて、そこへ入って、細密な調査を始めたわけさ。
I was in the bar, and a garrulous landlord was giving me all that I wanted.	僕は酒売台（さけうりだい）に陣地を取ったわけだが、ところがそこの主人は大変な饒舌（おしゃべり）で、僕のききたいことは、何もかもよく喋べってくれた。
Williamson is a white-bearded man, and he lives alone with a small staff of servants at the Hall.	ウィリアムソンと云うのは、真白な髭を蓄えた人間で、ごくわずかな使用人共と、あの廃院に住んでいるんだそうだ。
There is some rumour that he is or has been a clergyman,	彼が坊さんであったとか、またあるとかと云う噂もあるんだ。
but one or two incidents of his short residence at the Hall struck me as peculiarly unecclesiastical.	ところがその短い間の廃院生活に起った、一二の事件を見ると、どうも坊さんらしくないと思われる点があるんだがね。
I have already made some inquiries at a clerical agency, and they tell me that there was a man of that name in orders, whose career has been a singularly dark one.	それで僕は宗務管理所について調べて来たんだが、これと同じ名前で、その以前の経歴がはなはだ曖昧なのが、たしかにあったと云うのだ。
The landlord further informed me that there are usually week-end visitors -- `a warm lot, sir'	それからなおそこの主人の云ってくれたのには、あの廃院には、毎週の終りに、会合があるんだそうだ。
-- at the Hall, and especially one gentleman with a red moustache, Mr. Woodley by name, who was always there.	そのメンバーの中で、赤髭をした、ウードレーと云うのが、最も重要な御常連だそうだ。
We had got as far as this, when who should walk in but the gentleman himself, who had been drinking his beer in the taproom	ところがどうだろう、
and had heard the whole conversation.	もちろんこの一切の会話をきいてしまったのだから敵わない、
Who was I?	――「貴様は一たい何者だ？」
What did I want?	「何を調べているんだ？」
What did I mean by asking questions?	「何のためにそんなことを訊ねているんだ？」
He had a fine flow of language, and his adjectives were very vigorous.	と、全く雷でも落っこって来たように、まくし立てられてしまったわけさ。
He ended a string of abuse by a vicious backhander, which I failed to entirely avoid.	いや全く実に威勢のいい文句ばかり並べられたがね、遂に彼からは手の甲で一撃見舞って来てしまったんだが、僕は不覚にもそれはしっかり受けそこなってしまった。
The next few minutes were delicious.	次の二三分はとても味があったよ。
It was a straight left against a slogging ruffian.	滅茶打ちに打ってかかる暴漢に、左の手で見事に一突がきまったわけさ。
I emerged as you see me.	そして僕は抜け出して、再び君に拝顔の機を得たわけ、
Mr. Woodley went home in a cart.	それからウードレー紳士は、馬車で御帰宅と云うことになったのさ。
So ended my country trip, and it must be confessed that, however enjoyable, my day on the Surrey border has not been much more profitable than your own.''	こうして僕の田舎旅も終ったが、なかなか面白いには面白かったが、しかし何しろいやはや全く、このサーレーの外れの遠征だけは、君の時よりももっと、だらしのない恰好でおめおめと帰って来たわけさ、ははははははは」
The Thursday brought us another letter from our client.	木曜日にまた、我々の依頼者から、手紙が来た。
You will not be surprised, Mr. Holmes [ said she ] to hear that I am leaving Mr. Carruthers's employment.	ホームズ先生、私がカラザースさまのところから、お暇をいただいて、帰ってしまうとおききになりましても、決してお驚きなさいませぬように、
Even the high pay cannot reconcile me to the discomforts of my situation.	あんなに高い月給でも、やはり私の現在の位置の不愉快さは、埋め合せてはくれませぬ。
On Saturday I come up to town, and I do not intend to return.	土曜日に私はロンドンに帰り、もうこっちには来ないつもりでございます。
Mr. Carruthers has got a trap, and so the dangers of the lonely road, if there ever were any dangers, are now over.	カラザースさまは、馬車をお買いになりましたので、あの淋しい道の危険は、たとえば御座いましたものにしろ、今はもうそれも何でもないことになってしまいました。
As to the special cause of my leaving, it is not merely the strained situation with Mr. Carruthers, but it is the reappearance of that odious man, Mr. Woodley.	私がこちらを去ることになりました理由としては、ただカラザースさまとの間が、緊迫して来たためばかりではなく、その他にもう一つ、あのいやなウードレーが、また出て来たからでございます。
He was always hideous, but he looks more awful than ever now,	あの方は素々（もともと）から、凄い容子をしていますが、今度はまたもっと怖ろしい形相をしているように思われます。
for he appears to have had an accident, and he is much disfigured.	それに何か出来ごとでもあったのか、大変傷がついております。
I saw him out of the window, but I am glad to say I did not meet him.	私は窓の外にあの人を見かけたのですが、しかし逢わずにすまされたのは、何よりの幸福でございました。
He had a long talk with Mr. Carruthers, who seemed much excited afterwards.	何かカラザースさまと、大変長いこと、話していたようでしたが、後でカラザースさまは、ひどく昂奮していらっしゃいました。
Woodley must be staying in the neighbourhood,	ウードレーはきっと、この近所に居るに相違ございませぬ。
for he did not sleep here, and yet I caught a glimpse of him again this morning, slinking about in the shrubbery.	と申すのは、昨夜はこちらには宿（とま）りませんでしたし、それに今朝は私は、あの人が灌木の中を忍び歩いているのを見止めたのでございます。
I would sooner have a savage wild animal loose about the place.	やがてはあの野蛮な怖ろしい野獣が、檻を出てのそのそとやって来るのでございましょう、
I loathe and fear him more than I can say.	――もう私は考えただけでも、身振いをするように怖ろしゅうございますわ。
How can Mr. Carruthers endure such a creature for a moment?	あのカラザースさまでも、どうしてあんな気味の悪い動物にちょっとでも御我慢のお出来になるはずがございましょう。
However, all my troubles will be over on Saturday.	しかししかし、もう私の煩累（わずらい）は、この土曜日で終りでございますわ。
``So I trust, Watson, so I trust,''	「ははあ、ワトソン君、――」
said Holmes, gravely.	ホームズは慎重な調子で云った。
``There is some deep intrigue going on round that little woman,	「これはあの娘さんの周囲には、何か深いたくらみがめぐらされているよ。
and it is our duty to see that no one molests her upon that last journey.	あの娘さんの最後の帰り路を、無事に護ってやらなければならない。
I think, Watson, that we must spare time to run down together on Saturday morning and make sure that this curious and inclusive investigation has no untoward ending.''	ワトソン君、今度の土曜日の朝は、一つ一緒に出かけて行って、この奇妙な、不得要領（ふとくようりょう）な事件を、見事に結末をつけてしまおうじゃないかね？」
I confess that I had not up to now taken a very serious view of the case, which had seemed to me rather grotesque and bizarre than dangerous.	私は正直のところ、この事件については、どちらかと云えば、危険性と云うよりも、変な得体の知れなさはあったが、しかし結局大したものではないと、この時までは考えていたのであった。
That a man should lie in wait for and follow a very handsome woman is no unheard-of thing, and if he has so little audacity that he not only dared not address her, but even fled from her approach, he was not a very formidable assailant.	あんな綺麗な娘さんに、男が待ち伏せをするとか、あるいは追っかけるとか云ったようなことも、もう世間一般から、云ってそう珍らしいとすべき話でもないし、またその待ち伏せの追っかけの男も、強いて娘さんに話しかけようとするでもなく、かえって娘さんの方から近づくと、遁げ出してしまうほどの小心者とすれば、まあ大した悪者でもあるまいと思った。
The ruffian Woodley was a very different person, but, except on one occasion, he had not molested our client, and now he visited the house of Carruthers without intruding upon her presence.	なるほど暴漢のウードレーは、なかなかの注意人物に相違ないが、しかしこれも我々の美しい若い依頼者を困らせたのは、ただ一度だけで、その後はカラザースの家を訪問しても、彼の女の面前にも現われないとのこと、
The man on the bicycle was doubtless a member of those week-end parties at the Hall of which the publican had spoken, but who he was, or what he wanted, was as obscure as ever.	――それから例の自転車乗りの男も、居酒屋の主人のいわゆる、週末組の一員には相違ないが、しかしこの者も、一たいどう云う者で、何の目的であんなことをするかも、全く不得要領である。
It was the severity of Holmes's manner and the fact that he slipped a revolver into his pocket before leaving our rooms which impressed me with the feeling that tragedy might prove to lurk behind this curious train of events.	しかし私は、ホームズの態度がいかにも厳粛で、しかも出かける時にピストルまでもポケットにねじこんだので、これはとにかく、この変な事件の後にも、なかなかの惨劇も予想されているのだなと思った、のであった。
A rainy night had been followed by a glorious morning,	夜通しの雨が霽（は）れて、ここにも太陽の輝かしい朝であった。
and the heath-covered countryside, with the glowing clumps of flowering gorse, seemed all the more beautiful to eyes which were weary of the duns and drabs and slate grays of London.	荒野に蔽われた田園は、今ちょうど満開のハリエニシダの花が、方々に叢（むらが）り咲いていて、ロンドンの暗褐色（あんかっしょく）黄褐色（こうかっしょく）、――石板灰色（せきばんかいしょく）に、あきあきしている目には、とても素晴らしいものに見えた。
Holmes and I walked along the broad, sandy road inhaling the fresh morning air and rejoicing in the music of the birds and the fresh breath of the spring.	ホームズと私とは、朝の新鮮な空気を吸いこみ、小鳥の音楽、四月の春の生々（いきいき）とした黄韻（こういん）を享楽しながら、砂の多い広い道を進んだ。
From a rise of the road on the shoulder of Crooksbury Hill, we could see the grim Hall bristling out from amidst the ancient oaks,	路は上りになって、クルックスベリーの丘の肩のところに行ったら、我々は老樫樹の中から屹立している、厳めしい廃院を見た。
which, old as they were, were still younger than the building which they surrounded.	もっともこの老樫樹は、もう老いたと云っても、その取り囲んでいる廃院よりは若いのであるが、
Holmes pointed down the long tract of road which wound, a reddish yellow band, between the brown of the heath and the budding green of the woods.	――ホームズは、褐色の荒野と、芽のふき出ている緑の森の間をうねっている、赤味を帯びた黄色の帯のような、一条の道路を指した。
Far away, a black dot,	はるか遠方にポツリっと見えた黒い一点、
we could see a vehicle moving in our direction.	――それは我々の方に進んで来る乗物であった。
Holmes gave an exclamation of impatience.	ホームズは思わずも叫んだ。
``I have given a margin of half an hour,'' said he.	「おや、三十分おそかった！
``If that is her trap, she must be making for the earlier train.	もしあれが、あの娘さんの馬車だとすれば、あの娘さんは一列車早く発つつもりだったんだね。
I fear, Watson, that she will be past Charlington before we can possibly meet her.''	ワトソン君、俺たちが娘さんに出逢う前に、あのチァーリントンの森にさしかかってしまったら大変なことになるよ」
From the instant that we passed the rise, we could no longer see the vehicle,	私たちが上り坂を越してからは、もうその乗り物の姿は見えなかった。
but we hastened onward at such a pace that my sedentary life began to tell upon me, and I was compelled to fall behind.	しかし私たちはどんどん道を急いだが、私の元来の運動不足の職業が、今はしみじみと身体に答えて、いや応なしに私は、ホームズからは遅れてしまった。
Holmes, however, was always in training,	しかしホームズは少しも弱る様子がなかった。
for he had inexhaustible stores of nervous energy upon which to draw.	日頃練成していた精力が、全く驚くばかりであった。
His springy step never slowed until suddenly, when he was a hundred yards in front of me, he halted,	彼の跳ね返るような歩調は、決して衰えなかったが、私から百碼（ヤード）ばかりも先んじて行った彼は、ふと立ち止まった。
and I saw him throw up his hand with a gesture of grief and despair.	そして彼が手を上げてまわすのを見たが、それは悲しみと絶望の相図であった。
At the same instant an empty dog-cart, the horse cantering, the reins trailing, appeared round the curve of the road and rattled swiftly towards us.	と、――見る中（うち）に、空（から）な二輪馬車が、手綱を引きずりながら、カーブを曲ってガタガタと音させながら、私たちの方に駈けて来るのであった。
``Too late, Watson, too late!''	「遅かった、ワトソン君、遅かった！」
cried Holmes,	ホームズは叫んだ。
as I ran panting to his side.	私は喘ぎながら彼の側（そば）にかけ寄った。
``Fool that I was not to allow for that earlier train!	「もう一つ早い汽車を考えなかったなんて、僕は何と云ううっかりしたことをしたものであろう！
It's abduction,	誘拐されたんだ。
Watson -- abduction!	ワトソン君、誘拐だ！
Murder!	惨殺されたんだ！
Heaven knows what!	ああしかしまだ解らない！
Block the road!	さあ道を塞いで
Stop the horse!	馬を止めて。
That's right.	――さあそれでよい、
Now, jump in,	すぐに乗りたまえ。
and let us see if I can repair the consequences of my own blunder.''	一つこの失敗の取り返しが出来るかどうか、やれるだけやってみよう」
We had sprung into the dog-cart,	私たちは二輪馬車に乗った。
and Holmes, after turning the horse, gave it a sharp cut with the whip, and we flew back along the road.	ホームズは馬首をまわして、ピシャリと一打ち鞭を当てて道を進んだ。
As we turned the curve, the whole stretch of road between the Hall and the heath was opened up.	カーブを廻ってからは例の廃院と荒野の間の、真直ぐな道が、我々の目の前に展開した。
I grasped Holmes's arm.	私はホームズの腕をぎゅっとつかんだ。
``That's the man!''	「ああ、あの男さ！」
I gasped.	私はせきこんで云った。
A solitary cyclist was coming towards us.	その時ちょうど一人の自転車乗りが、私たちの方に走って来たのであった。
His head was down and his shoulders rounded, as he put every ounce of energy that he possessed on to the pedals.	その者の頭は低く前にかけられ、肩は丸く下（さが）っていて、ペダルを一踏するごとに、一オンスずつのエネルギーが消耗するのだと云うような恰好であった、
He was flying like a racer.	彼は競争者のように疾走して来たのであったが、
Suddenly he raised his bearded face, saw us close to him,	突然髭のある顔を起して、私たちを近々と見つめた。
and pulled up, springing from his machine.	そしてピタリっと車を引き止めて、自転車から飛び降りた。
That coal-black beard was in singular contrast to the pallor of his face, and his eyes were as bright as if he had a fever.	その漆黒の髭は、蒼白な顔色に、まことに変な対照でありまたその目は、熱病にでもつかれている者のように、キョロキョロとしていた。
He stared at us and at the dog-cart.	彼は私たちと馬車を、激しく見つめていたが、
Then a look of amazement came over his face.	その顔にはみるみる、驚きの色が浮かんだ。
``Halloa! Stop there!''	「おい止まれ！」
he shouted, holding his bicycle to block our road.	彼は自転車で、我々の行く先を遮りながら叫んだ。
``Where did you get that dog-cart?	「君達はこの馬車をどこから取って来たんだ？
Pull up, man!''	おい馬を止めないか！」
he yelled, drawing a pistol from his side pocket.	彼は無暗に喚きながら、ポケットからピストルを取り出した。
``Pull up, I say	「おい、馬を止めてくれないか！
or, by George, I'll put a bullet into your horse.''	さもなかったら、馬に一発ズドンとやってしまうぞ」
Holmes threw the reins into my lap and sprang down from the cart.	ホームズは私の膝の上に手綱を置いて、馬車から飛び降りた。
``You're the man we want to see.	「君こそ僕たちが逢いたいと思っていた人間なんだ。
Where is Miss Violet Smith?''	ヴァイオレット・スミスさんはどこに居るんだね？」
he said, in his quick, clear way.	彼一流の早口で、はっきりと云った。
``That's what I'm asking you.	「それこそこっちが聞きたいことなんだ。
You're in her dog-cart.	君たちこそ彼の女の馬車に乗っているから、
You ought to know where she is.''	君たちこそ知っているはずだ」
``We met the dog-cart on the road.	「いや、我々は道でこの馬車に逢ったんだが、
There was no one in it.	中は空っぽだったんだ。
We drove back to help the young lady.''	それであの娘さんを助けようと思って、引き返してゆくところなのだ」
``Good Lord!	「ああ神様、
Good Lord!	神様、
What shall I do?''	――私はどうすればいいのですか？」
cried the stranger in an ecstasy of despair.	この変な男は、全く失望のどん底に落っこったように悲叫した。
``They've got her, that hell-hound Woodley and the blackguard parson.	「いえそれではあの、地獄の犬めのウードレーと、あの悪漢坊主共が、彼の女を掠奪したのです。
Come, man, come,	さあではこっちに来て下さい。
if you really are her friend.	もしあなた方は本当に、私の味方でしたら、こっちに来て僕を助けて下さい。
Stand by me and we'll save her, if I have to leave my carcass in Charlington Wood.''	もし僕がチァーリントンの森で必死の覚悟を決めたら、彼の女を救うことが出来ましょう」
He ran distractedly,	彼は全く乱心したような様子で走り出した。
his pistol in his hand, towards a gap in the hedge.	そしてピストルを片手に持って生籬の切れ目に突進して行った。
Holmes followed him,	ホームズはすぐその後から続いた。
and I, leaving the horse grazing beside the road, followed Holmes.	それで私も、道の傍らに馬を放して草を食ませたまま、ホームズの後に従ってかけた。
``This is where they came through,''	「彼等はここから出て来たんです」
said he, pointing to the marks of several feet upon the muddy path.	彼はそう云いながら、泥の上にベタベタとついた足跡を指さした。
``Halloa!	「おい、
Stop a minute!	――ちょっと待て、
Who's this in the bush?''	――その籔かげに居るのは誰だ？」
It was a young fellow about seventeen, dressed like an ostler with leather cords and gaiters.	そこに居たのは十七才くらいの、革のズボンをはいて、ゲートルをかけた、馬丁風の若者であった。
He lay upon his back, his knees drawn up, a terrible cut upon his head.	そしてその者は、膝を縛り上げられて、仰向けに寝かされて、その上に額をひどく割られて、
He was insensible,	気絶して倒れていた。
but alive.	しかし生きてはいたが、
A glance at his wound told me that it had not penetrated the bone.	私はちょっと見たところ、その裂傷は、骨までは徹（とお）ってはいないものだと思った。
``That's Peter, the groom,''	「ああこれは馬丁のペーターだ」
cried the stranger.	この見知らぬ男は叫んだ。
``He drove her.	「この男が彼の女の馬車を御して来たのですが、
The beasts have pulled him off and clubbed him.	あの獣物（けだもの）連中は、この若者を引きずり降ろして、棍棒でやっつけたのだな。
Let him lie:	これはこのまま寝かしておきましょう。
we can't do him any good,	どうにも出来ませんから、
but ' we may save her from the worst fate that can befall a woman.''	――しかしまだ私たちは、彼の女の婦人として受ける、最大の悲しい運命から、救い出すことが出来るかもしれませんからね」
We ran frantically down the path, which wound among the trees.	私たちは全く夢中で、樹の間をうねり曲って、小径をかけ下りた。
We had reached the shrubbery which surrounded the house when Holmes pulled up.	そして私たちは、建物を取りまいている、灌木の所に出た時、ホームズは一同を引き止めた。
``They didn't go to the house.	「奴等は家には入らない、
Here are their marks on the left	そら左の方に足跡がある。
-- here, beside the laurel bushes.	これからずっと月桂樹の横の方に、
Ah!	――ああ、云わないこっちゃなかった、――」
I said so.''	彼がこう云う途端に、女の帛（きぬ）を裂くような悲叫（さけび）！
-- a scream which vibrated with a frenzy of horror -- burst from the thick, green clump of bushes in front of us.	恐怖のために狂乱してしまった咽喉から絞り出た、血も吐くような女の悲叫（さけび）が、私たちの前方の籔のかげから聞こえて来た。
It ended suddenly on its highest note with a choke and a gurgle.	それと共にその悲叫（さけび）は、最も高く絞り上げられたと思う中（うち）に、急に咽喉でも締められたのか、窒息するように止まってしまった。
``This way!	「こっちです、
This way!	こっちです！
They are in the bowling-alley,''	奴等は玉ころがしの囲の中に居るんです」
cried the stranger, darting through the bushes.	籔を突進して突きぬけながら、この見知らぬ［＃「見知らぬ」は底本では「見知らね」］男は叫んだ。
``Ah, the cowardly dogs!	「おい卑怯な犬共め！
Follow me, gentlemen!	さあ皆さん来て下さい、来て下さい。
Too late!	ああ遅れました。
too late!	ああ遅かった、
by the living Jingo!''	畜生め！」
We had broken suddenly into a lovely glade of greensward surrounded by ancient trees.	私たちはヒョッコリと、大木に囲まれた中の、小さな芝生に出た。
On the farther side of it, under the shadow of a mighty oak, there stood a singular group of three people.	その芝生の向う側に、老樫樹のかげに、変な恰好の三人の者の姿を見止めた。
One was a woman, our client, drooping and faint, a handkerchief round her mouth.	その中の一人は、我々の依頼者の若い美しい女性で、口にはハンカチーフを巻きつけられ、全く気絶したように、正体もなく崩れ跼（うずく）まっていた。
Opposite her stood a brutal, heavy-faced, red-moustached young man, his gaitered legs parted wide, one arm akimbo, the other waving a riding crop, his whole attitude suggestive of triumphant bravado.	その向うには、残忍な、いかつい顔をした、赤髭の若い男が、ゲートルを巻いた脚を開いて突っ立ち、片方の肱は腰に曲げ、片方の手には、猟用の鞭を振り上げて、あたかも勝ちほこった馬鹿大将みたいに、意気軒昂としていた。
Between them an elderly, gray-bearded man, wearing a short surplice over a light tweed suit, had evidently just completed the wedding service,	それからその二人の間には、もう年配の、灰色の髭のある男が、スコッチ織の簡単な着物の上に、白い法衣を重ねて、今しも二人の結婚式がすんだばかりと云う様子をしていた。
for he pocketed his prayer-book as we appeared, and slapped the sinister bridegroom upon the back in jovial congratulation.	と云うのはその法衣の男は、私たちが現われた時ちょうど、祈祷書をポケットに入れて、その縁喜（えんぎ）でもない花婿の背中を、お芽出度（めでと）うとでも云ったように、ぽんとたたいたところであった。
``They're married?''	「彼等は結婚したんだね」
I gasped.	私は喘ぎながら云った。
``Come on!''	「来て下さい！」
cried our guide;	我々の案内者は叫んだ。
``come on!''	「来て下さい！」
He rushed across the glade,	彼は芝生の上を横切って進んだ。
Holmes and I at his heels.	ホームズと私はその後に続いた。
As we approached, the lady staggered against the trunk of the tree for support.	そして私たちがようやくその地点に接近すると、その若い女性は、太い幹に身体を支えて、よろよろと立ち上った。
Williamson, the ex-clergyman, bowed to us with mock politeness, and the bully,	前牧師ウィリアムソンは、私たちに変に人を馬鹿にしたような鄭重さで、叩頭（おじぎ）をした。
Woodley, advanced with a shout of brutal and exultant laughter.	暴漢のウードレーはまた、気狂いのような叫びと、突拍子もない笑い声を上げた。
``You can take your beard off, Bob,'' said he.	「おいボッブ、髭なんか取っちまえよ。
``I know you, right enough.	そんな誤魔化しなんかするまでもないじゃないか。
Well, you and your pals have just come in time for me	いや君や御一同は、全くちょうどいい処に来たものだ。
to be able to introduce you to Mrs. Woodley.''	ウードレー夫人を御紹介しよう」
Our guide's answer was a singular one.	我々の先達の答は全く変なものであった。
He snatched off the dark beard which had disguised him and threw it on the ground, disclosing a long, sallow, clean-shaven face below it.	彼は扮装していた。
Then he raised his revolver and covered the young ruffian, who was advancing upon him with his dangerous riding crop swinging in his hand.	そして猟用の鞭を振りながら肉薄して来るウードレーに、発矢（はっし）とピストルを突きつけた。
``Yes,''	「そうだ」
said our ally,	わが味方の男は云った。
``I am Bob Carruthers,	「いかにも俺は、ボッブ・カラザースだ。
and I'll see this woman righted, if I have to swing for it.	俺は命に賭けても、この女に間違いのないように護るつもりだ。
I told you	俺は君に云ったろう、
what I'd do if you molested her, and, by the Lord!	――もし君がこの女を苦しめたら、俺はどう云う仕返しをするかと云うことは、
I'll be as good as my word.''	――俺は神明に誓って、俺の言葉を実行するよ！」
``You're too late.	「いや何しろ君は遅すぎた！
She's my wife.''	この女はもう僕の妻なのだ！」
``No, she's your widow.''	「いやこの女の方は、君の寡婦だよ」
His revolver cracked,	ピストルは鳴った。
and I saw the blood spurt from the front of Woodley's waistcoat.	ウードレーの胴衣（ちょっき）の前からは、血が迸り出た。
He spun round with a scream and fell upon his back, his hideous red face turning suddenly to a dreadful mottled pallor.	彼は悲鳴を上げながら、腕をもがいてのたうちまわったが、遂に仰向けに倒れて、その兇悪な真赤な顔は、急に気味悪い斑のある蒼白に変ってしまった。
The old man, still clad in his surplice, burst into such a string of foul oaths as I have never heard, and pulled out a revolver of his own,	その年取った男はと見れば、まだ法衣を羽織っていたが、私がまだかつて耳にしたことなどはないような、呪詛の言葉を放ちながら、ピストルを取り出して向けようとした。
but, before he could raise it, he was looking down the barrel of Holmes's weapon.	しかしこれはまだピストルを取り上げる前に、ホームズの武器に狙われてしまった。
``Enough of this,''	「これでいいだろう、――」
said my friend, coldly.	私の友人は冷やかに云った。
``Drop that pistol!	「ピストルを棄てろ！」
Watson, pick it up!	「ワトソン君、拾ってくれたまえ！
Hold it to his head!	そしてそれを頭につきつけて！
Thank you.	いや有難う。
You Carruthers, give me that revolver.	君、カラザース君、そのピストルをこっちにくれたまえ。
We'll have no more violence Come,	もう乱暴者は無いだろう。
hand it over!''	さあ、こっちに渡して、――」
``Who are you, then?''	「しかし、あなたはどなたですか？」
``My name is Sherlock Holmes.''	「僕はシャーロック・ホームズです」
``Good Lord!''	「ああ、そうでございましたか！」
``You have heard of me, I see.	「いずれ私のことは知っているでしょう。
I will represent the official police until their arrival.	警官が来るまで、私はその代理をつとめる。
Here, you!''	ああ君が来ていたのか！」
he shouted to a frightened groom, who had appeared at the edge of the glade.	彼は馬丁が芝生の端に来たのを見て、その驚いて茫然としているのに呼びかけた。
``Come here.	「こっちに来たまえ。
Take this note as hard as you can ride to Farnham.''	君ね、馬に乗って出来るだけ大急ぎで、これをファーナムまで持って行ってくれたまえ」
He scribbled a few words upon a leaf from his notebook.	彼はノートの紙をとって、ちょっと何か書きつけた。
``Give it to the superintendent at the police-station.	「これを警察署の監督官に渡してくれ。
Until he comes, I must detain you all under my personal custody.''	それから彼が来るまでは、私が諸君を監視するから、――」
The strong, masterful personality of Holmes dominated the tragic scene, and all were equally puppets in his hands.	ホームズの強い、よく訓練された性格は、こうした悲劇の場面をしっかり支配してしまって、いずれも彼の把握の中に収められてしまった。
Williamson and Carruthers found themselves carrying the wounded Woodley into the house, and I gave my arm to the frightened girl.	ウィリアムソンとカラザースは、負傷したウードレーを家の中に運び入れ、私はまた、ただ恐怖におののいている娘さんを、支えてやった。
The injured man was laid on his bed, and at Holmes's request I examined him.	その負傷した男は、ベットの上に横にされたが、私はホームズに頼まれたので、彼を診察した。
I carried my report to where he sat in the old tapestry-hung dining-room	そして私はその報告書を綴織の掛っている食堂に居る、ホームズのところに持って行った。
with his two prisoners before him.	彼の前には彼があずかっている、二人の罪人も居た。
``He will live,''	「あの者は助かるだろう」
said I.	私は云った。
``What!''	「何ですって？」
cried Carruthers, springing out of his chair.	カラザースは、椅子から飛び上りながら叫んだ。
``I'll go upstairs and finish him first.	「私は二階に行って、あいつに止めを刺して来ましょう。
Do you tell me that that girl, that angel, is to be tied to Roaring Jack Woodley for life?''	あなたはあの女が、あの天使が、あの吼えつくようなジャック・ウードレーのために生涯しばりつけられるのだと仰るのですか？」
``You need not concern yourself about that,''	「いやそれはもう君のかかわったことではない」
said Holmes.	ホームズは云った。
``There are two very good reasons why she should, under no circumstances, be his wife.	「ここにあの女の方が、彼の妻になることのない立派な理由が二つあるんだ。
In the first place, we are very safe in questioning Mr. Williamson's right to solemnize a marriage.''	まず第一に、ウィリアムソン君の、結婚式の執行権について追求すると、これにまず我々は、安心が出来るのだ」
``I have been ordained,''	「私は僧職は授けられていますよ」
cried the old rascal.	この老悪漢は叫んだ。
``And also unfrocked.''	「そしてまた、その僧職は、剥脱されているだろう」
``Once a clergyman, always a clergyman.''	「一度牧師になった者は、いつまでも牧師ですよ」
``I think not.	「そんな馬鹿なことはない。
How about the licence?''	では免許証はどうした？」
``We had a licence for the marriage.	「私たちは結婚の免許証は貰い受けました。
I have it here in my pocket.''	それはポケットにあります」
``Then you got it by a trick.	「それじゃ君は、詐欺をしてそれを手に入れたんだ。
But, in any case, a forced marriage is no marriage,	しかしとにかくこれは、強制結婚じゃないか、
but it is a very serious felony,	それどころか大変な重罪だよ。
as you will discover before you have finished.	そのことはいずれ君にもじきにわかるよ。
You'll have time to think the point out during the next ten years or so, unless I am mistaken.	まあ僕にして誤（あやま）ちなしとすれば、君がこのことをよく考えてみるために、この後十年以上もの年月が、君のために与えられるだろう。
As to you, Carruthers, you would have done better to keep your pistol in your pocket.''	それからカラザース君だが、君はピストルは出さん方がよかったね」
``I begin to think so, Mr. Holmes,	「いやホームズさん、今僕はそれを後悔しております。
but when I thought of all the precaution I had taken to shield this girl	しかし私が彼の女を保護するために取った手段を考えた時に、
-- for I loved her, Mr. Holmes, and it is the only time that ever I knew what love was	――いえ私は実は、彼の女を愛していたのですが、ホームズさん実は私は恋と云うものを、この時こそ初めて知ったのでしたが、
-- it fairly drove me mad to think that she was in the power of the greatest brute and bully in South Africa -- a man whose name is a holy terror from Kimberley to Johannesburg.	――私は彼の女が、あの南アフリカ第一の残忍な悪漢で、キムバーレーから、ヨハネスブルグまでの間で、人々から震怖（しんぷ）されているウードレーの手中にあるのかと考えた時は、私は全く前後不覚に逆上してしまったのでした。
Why, Mr. Holmes, you'll hardly believe it, but ever since that girl has been in my employment I never once let her go past this house where I knew the rascals were lurking, without following her on my bicycle, just to see that she came to no harm.	いえホームズさん、御信用下さらないかもしれませんが、私はこの娘さんを雇入れてからは、私はこの家には悪漢共の住んでいるのは知っていますから、いつも自転車で彼の女の後に遠くついて、彼の女の無事なのを見届けるようにしたほどでした。
I kept my distance from her, and I wore a beard, so that she should not recognize me, for she is a good and high-spirited girl, and she wouldn't have stayed in my employment long if she had thought that I was following her about the country roads.''	私は彼の女からは、相当の距離をとり、また髭もつけていたので、彼の女には私がわからなかったのですが、強いてこんなことをさしたのも、あの善良で潔白な彼の女が、もし私が田舎道で彼の女をつけるなどと云うことがわかったら、もう私のところには居なくなるだろうと思ってのことでした。」
``Why didn't you tell her of her danger?''	「じゃどうして君は、彼の女にその危険を教えてくれなかったのだね？」
``Because then, again, she would have left me,	「つまりそれも、やはり彼の女に、私のところを去られてしまうと思ったからです。
and I couldn't bear to face that.	このことだけは私は、とても堪え切れませんでした。
Even if she couldn't love me, it was a great deal to me just to see her dainty form about the house, and to hear the sound of her voice.''	例えば彼の女は、私を愛してはくれなくっても、せめて彼の女の美しい姿を、私の家のあたりに見、彼の女の声をきくことが、私にとっては、絶大のことでした。」［＃「」」は底本では欠落］
``Well,''	「なるほど」
said I,	私は云った。
``you call that love, Mr. Carruthers, but I should call it selfishness.''	「君はそれを愛と呼んでいるが、しかしカラザース君、それは利己主義と云うものだよ」
``Maybe the two things go together.	「いやそれは結局、一致するものかもしれませんが
Anyhow, I couldn't let her go.	しかし、とにかく私は、彼の女を去らせることは出来ませんでした。
Besides, with this crowd about,	その上に周囲はああした連中ですからね。
it was well that she should have someone near to look after her.	彼の女には誰か、側（そば）に居てよく見てやるとよいのだがなと思いましたが、
Then, when the cable came, I knew they were bound to make a move.''	その時私は海底電信を受け取りましたので、彼等は策動を始めようとしていることを知ったのでした」
``What cable?''	「どんな電信だね？」
Carruthers took a telegram from his pocket.	カラザースはポケットから、海底電信を取り出した。
``That's it,''	「これです」
said he.	彼は云った。
It was short and concise:	それは短い簡明なものであった。
THE OLD MAN IS DEAD.	『あの老人は死んだ』
``Hum!''	「ふうむ！」
said Holmes.	ホームズは云った。
``I think I see how things worked,	「もう大体の見当はついたが、
and I can understand how this message would, as you say, bring them to a head.	――またこの電信でどうしようと云うことも、まあ想像は出来るが、
But while you wait, you might tell me what you can.''	しかしこうして待っている間に、君の知ってるだけのことを話してもらってもいいね」
The old reprobate with the surplice burst into a volley of bad language.	その年取った法衣姿の無頼漢は、無茶苦茶な悪口罵詈を浴びせかけて来た。
``By heaven!''	「覚悟しろよ！」
said he,	彼は叫んだ。
``if you squeal on us, Bob Carruthers I'll serve you as you served Jack Woodley.	「もしお前が俺たちを裏切るなら、ボッブ［＃「ボッブ」は底本では「ポップ」］・カラザース、お前がジャック・ウードレーに逢わしたと、同じ報をしてやるから、
You can bleat about the girl to your heart's content, for that's your own affair, but if you round on your pals to this plain-clothes copper, it will be the worst day's work that ever you did.''	――お前があの娘に、心のたけの泣きごと云うのは、お前のことだからかまわないが、しかしこの私服刑事に俺たち仲間のことにまで口をすべらしたら、それこそお前が臍の緒を切ってから今までにやったことの中で、一番ひどい悪業だぞ」
``Your reverence need not be excited,''	「いや尊師よ、そう昂奮しては困りますな」
said Holmes, lighting a cigarette.	煙草に火をつけながらホームズは云った。
``The case is clear enough against you,	「この事件と君との関係は、もう十分明瞭になっている。
and all I ask is a few details for my private curiosity.	私のききたいのは、ただ自分の好奇心の満足のため、少しばかり細々しいことを耳に入れたいだけなのだ。
However, if there's any difficulty in your telling me, I'll do the talking,	いやしかし、それは君の口からは話しにくいと云うことなら、僕の方から話してやろう。
and then you will see how far you have a chance of holding back your secrets.	こんなことを秘密にしようたって、それはいかに、難しいかを、よく考えてみるがいい。
In the first place, three of you came from South Africa on this game	まず第一にだ、君達は三人で、この獲物のために、南アフリカから来たのだろう、ね？
-- you Williamson, you Carruthers, and Woodley.''	ウィリアムソン君、ね、カラザース君、ウードレー君、――」
``Lie number one,''	「いや、その第一番目のは嘘だ。」
said the old man;	老年の男は云った。
``I never saw either of them until two months ago, and I have never been in Africa in my life,	「私は二ヶ月前までは、この二人を全く知らなかったし、また私は生れてからまだ、南アフリカなんて云うところには、行ったこともありませんよ。
so you can put that in your pipe and smoke it, Mr. Busybody Holmes!''	おせっかい屋のホームズさん、篤（とく）とお考えなさって、冗談も休み休み仰有って下さい」
``What he says is true,''	「彼の云うことは本当です」
said Carruthers	カラザースは云った。
``Well, well,	「よろしい、よろしい。
two of you came over.	君たち二人が海を越えて来たんだね。
His reverence is our own homemade article.	それなる御尊師は、内地製だったんだ。
You had known Ralph Smith in South Africa.	それで君等は南アフリカで、ラルフ・スミスを知った。
You had reason to believe he would not live long.	そして彼はもう長くは生きないと云う見極めもついていた。
You found out that his niece would inherit his fortune.	そして彼の姪がその財産を相続することになると云うことも気がついた。
How's that	どうだね？
-- eh?''	それでいいかね？」
Carruthers nodded and Williamson swore.	カラザースは点頭（うな）ずき、ウィリアムソンも肯定した。
``She was next of kin, no doubt, and you were aware that the old fellow would make no will.''	「彼の女はもちろん最も近い血縁の者であるが、君たちは、その老人は遺言状を作るまいと考えたろう」
``Couldn't read or write,''	「彼は読むも書くも出来なかったのです」
said Carruthers.	カラザースは云った。
``So you came over, the two of you, and hunted up the girl	「そこで君たちは二人で帰国して、その女を狩り出したのだ。
The idea was that one of you was to marry her, and the other have a share of the plunder.	しかもその方針をなおつきつめてみると、君たちの中の一人は、彼の女と結婚し、それから他の方は、そうして得た獲物の、分け前を取ると云うことであったろう。
For some reason, Woodley was chosen as the husband.	そして更に、何かの理由からウードレーがその夫に選ばれたんだね。
Why was that?''	その理由は何だったんだね？」
``We played cards for her on the voyage.	「私たちは航海中に、カルタで賭けて、
He won.''	彼が勝ったのです」
``I see.	「ふうむ、そんなことか、
You got the young lady into your service, and there Woodley was to do the courting.	――そこで君はあの娘さんを雇い入れて、ウードレーはそれに、持ちかけると云うことだったんだね。
She recognized the drunken brute that he was, and would have nothing to do with him.	しかしあの娘さんはウードレーを、飲んだくれの悪漢ときめてしまって、てんで相手にはならない、
Meanwhile, your arrangement was rather upset by the fact that you had yourself fallen in love with the lady.	――その中（うち）に君があの娘さんに恋をしてしまって、君たちのお膳立ては、すっかりと覆ってしまうこととなった。
You could no longer bear the idea of this ruffian owning her?''	君はもうあの娘さんを、あの悪漢に渡すことが出来なくなってしまった」
``No, by George. I couldn't!''	「えい、私は金輪際、渡すことが出来ませんでした」
``There was a quarrel between you.	「そこで君たちの中には喧嘩がおっぱじまってしまった。
He left you in a rage, and began to make his own plans independently of you.''	そして喧嘩分れとなって、彼は今度は君にはかかわりなく、勝手に計画を立てた」
``It strikes me, Williamson, there isn't very much that we can tell this gentleman,''	「ウィリアムソン、この方は何もかもちゃんと知っているには驚いてしまったね。」
cried Carruthers, with a bitter laugh.	カラザースは、苦笑しながら叫んだ。
``Yes, we quarreled,	「そうです、確に私たちは喧嘩をしました。
and he knocked me down.	そして彼は私を打ちのめしました。
I am level with him on that, anyhow.	とにかくここまでは私は、彼と全く同等です。
Then I lost sight of him.	それからは私は、彼とは逢いませんでしたが、
That was when he picked up with this outcast padre here.	しかしこの時に彼はここに居る、相棒を拾ったのでしょう。
I found that they had set up housekeeping together at this place on the line that she had to pass for the station.	それから私は、この連中が、彼の女が停車場に行くに、通らなければならないところに、すなわちここですが、家を持ったと云うことは、わかっていましたが、
I kept my eye on her after that, for I knew there was some devilry in the wind.	それからどうも、不吉な予感がしてならないので、私は彼の女から、目を放さないようにしました。
I saw them from time to time, for I was anxious to know what they were after.	それからまた、あいつめ共は、どう云うことを企らんでいるかと云うことも、気がかりでしたので、時々あの連中にも目をつけました。
Two days ago Woodley came up to my house with this cable, which showed that Ralph Smith was dead.	二日前にウードレーは、あのラルフ・スミスが死んだという電信を持って、私のところに来て、
He asked me if I would stand by the bargain.	例の契約を履行するか否かを訊ねました。
I said I would not.	私は出来ないと云いますと
He asked me if I would marry the girl myself and give him a share.	今度は、もし私自身が彼の女と結婚することになったら、分け前を出すかと云いますので、
I said I would willingly do so, but that she would not have me.	私は、出したいことは山々だが、しかし彼の女は結婚してはくれないだろうと云いました。
He said,	そうしたら彼は、
`Let us get her married first, and after a week or two she may see things a bit different.'	『とにかく彼の女を結婚させようではないか。
I said I would have nothing to do with violence.	しかし私は、暴力沙汰はいやだと云いましたら、
So he went off cursing, like the foul-mouthed blackguard that he was, and swearing that he would have her yet.	彼の本性の悪漢振りをまる出しにして、私を口ぎたなく罵りながら、どうしても彼の女を手に入れるんだと、タンカを切って出ていったのでした。
She was leaving me this week-end, and I had got a trap	それから彼の女は今週の末は、私のところを去りますので、私は馬車を用意しました。
to take her to the station, but I was so uneasy in my mind that I followed her on my bicycle.	彼の女はその馬車に乗って、停車場に向ったのでしたが、やはり私は不安だったので、自転車で後から追っかけることにしたのですが、
She had got a start, however, and before I could catch her, the mischief was done.	しかし彼の女は早く発ってしまって、私が追いつかない中（うち）に、この不幸が襲いかかってしまったのでした。
The first thing I knew about it was when I saw you two gentlemen driving back in her dog-cart.''	それで私が最初に知ったことは、全くお二方が彼の女の馬車で、進んで来られたことだったのでした」
Holmes rose and tossed the end of his cigarette into the grate.	ホームズは起ち上って、煙草の吸い殻を、灰皿の中に捨てた。
``I have been very obtuse,	「僕は実にのろまだったよ。
Watson,''	ワトソン君」
said he.	彼は云った。
``When in your report you said that you had seen the cyclist as you thought arrange his necktie in the shrubbery, that alone should have told me all.	「君が帰って来た時に、君の考えでは自転車乗りが、灌木の中で、多少ネクタイを直したろう、と云うことを云ったが、あのことはもう、僕に全部を語っていることだったのだ。
However, we may congratulate ourselves upon a curious and, in some respects, a unique case.	しかしとにかく我々は、種々（いろいろ）の意味で全く比類の無い事件にぶっつかったと云うことは、大いに祝福するに足ることであったと思う。
I perceive three of the county constabulary in the drive,	ああ田舎の警官諸君が三人、駈けつけて来る。
and I am glad to see that the little ostler is able to keep pace with them,	あの馬丁君も、一緒に足並を揃えて来るのは、嬉しいじゃないかね。
so it is likely that neither he nor the interesting bridegroom	そこで彼でもない、いやあの面白い花婿君でもない
will be permanently damaged by their morning's adventures.	――まあいずれこの諸君は、今朝の一冒険で、一生を棒に振ったと云うわけかな。
I think, Watson, that in your medical capacity, you might wait upon Miss Smith	それからワトソン君、君は医者の資格で、一つあのスミス嬢を見舞ってみてはどうかね。
and tell her that if she is sufficiently recovered, we shall be happy to escort her to her mother's home.	そしてもしもう御気分がすっかりいいのなら、お母さんのところに、送ってあげようと云ってみたまえ。
If she is not quite convalescent, you will find that a hint that we were about to telegraph to a young electrician in the Midlands would probably complete the cure.	またもしまだ気分が癒（なお）らないと云うようなら、ミドランドの若い電気技師に、電報を打とうと謎をかけてやれば、もう即坐に全快だろうよ。
As to you, Mr. Carruthers, I think that you have done what you could to make amends for your share in an evil plot.	それから君、カラザース君だが、君は最初の悪い計画に対して参与した罪を償うためには、最善のことをしたと、僕は考える。
There is my card, sir,	さあ、名刺をあげておこう。
and if my evidence can be of help in your trial, it shall be at your disposal.''	もし僕の立証が、法廷で君に役だつようであったら、それは君の御自由にやってくれてよろしいよ」
In the whirl of our incessant activity, it has often been difficult for me, as the reader has probably observed, to round off my narratives, and to give those final details which the curious might expect.	たぶん読者諸君も、よく解ってくれるだろうと思うが、この全く休み無い立て続けの大活動の中で、事件の詳報をもたらすと云うことは、それはたしかに世の好奇心に大いに期待することには相違ないが、しかし私にとってはしばしば困難なことであった。
Each case has been the prelude to another, and the crisis once over, the actors have passed for ever out of our busy lives.	それぞれの事件は、他の事件の前奏曲であり、そしてその最高の峠を越してしまうと、その登場役者たちは、忙わしい我々の生活から、永久に消え去ってしまった。
I find, however, a short note at the end of my manuscript dealing with this case, in which I have put it upon record that Miss Violet Smith did indeed inherit a large fortune, and that she is now the wife of Cyril Morton, the senior partner of Morton & Kennedy, the famous Westminster electricians.	しかしこの事件のことを記した稿本の末尾には、ちょっとした追記があって、ヴァイオレット・スミス嬢は、たしかに大きな財産を相続し、そして現在は、あの有名なウェスミンスター電業者の集りである、モートン・エンド・ケネデー協会の、高級会員である、シリル・モートンの妻になっていると記されてある。
Williamson and Woodley were both tried for abduction and assault, the former getting seven years and the latter ten.	それからウィリアムソンとウードレーは、誘拐罪と殴打罪で、前者は七年の懲役、後者は同じく十年に処された。
Of the fate of Carruthers, I have no record, but I am sure that his assault was not viewed very gravely by the court, since Woodley had the reputation of being a most dangerous ruffian,	カラザースのことについては、私は別に記録してはいないが、しかし、ウードレーがもっぱら兇悪漢と云う定評で通っていたから、彼のやったことは法廷では、そう重大視はされなかったろうと確信する。
and I think that a few months were sufficient to satisfy the demands of justice.	たぶん数ヶ月の懲役と云うところが、適当な求刑であったろう。
