THE ADVENTURE OF THE DANCING MEN	暗号舞踏人の謎
Holmes had been seated for some hours in silence with his long, thin back curved over a chemical vessel	ホームズは全く黙りこんだまま、その脊の高い痩せた身体を猫脊にして、何時間も化学実験室に向っていた。
in which he was brewing a particularly malodorous product.	そこからは頻りに、いやな悪臭がただよって来る、
His head was sunk upon his breast, and he looked from my point of view like a strange, lank bird, with dull gray plumage and a black top-knot.	――彼の頭は胸に深くちぢこめられて、その恰好は、鈍い灰色の羽毛の、黒い鳥冠（とさか）の奇妙な鳥のようにも見えた。
"So, Watson,"	「そこで、ワトソン君、――」
said he, suddenly,	彼は突然に口を開いた。
"you do not propose to invest in South African securities?"	「君は南アフリカのある投資事業に、投資することは、思い止まってしまったのだね」
I gave a start of astonishment.	私はサッと驚かされてしまった。
Accustomed as I was to Holmes's curious faculties, this sudden intrusion into my most intimate thoughts was utterly inexplicable.	私は彼の不思議な直覚力と云ったようなものには、毎度のことでよく慣れていたが、しかしこの私の胸中の、秘中の秘事にずばりっと図星を指されたのには、全くあきれ返ってしまった。
"How on earth do you know that?"	「一たい君は、どうしてその事を知っていたのだね？」
I asked.	私は訊き返した。
"Now, Watson, confess yourself utterly taken aback,"	「さあワトソン君、ぐうの音が出まいがね」
"I am."	「いや、全くその通りだ」
"I ought to make you sign a paper to that effect."	「それではね君、とにかくきれいに参ったと云う一札（いっさつ）を入れたまえ」
"Why?"	「それはまたどうしてさ？」
"Because in five minutes you will say that it is all so absurdly simple."	「いや、実はもう五分の後には、君はきっと、それは馬鹿馬鹿しくわかり切ったことだと云うに相違ないからだよ」
"I am sure that I shall say nothing of the kind."	「いやいや、僕は決して、そんなことは云わないよ」
"You see, my dear Watson"--	「ワトソン君、それでは御説明に及ぶとしようかね」
he propped his test-tube in the rack, and began to lecture with the air of a professor addressing his class--	ホームズは試験管を架にかけて、教授が講堂で、学生たちに講義でもする時のような恰好で話し出した。
"it is not really difficult to construct a series of inferences, each dependent upon its predecessor and each simple in itself.	「先人の研究材料を基本として、それを単純化して、推論の系統を立てると云うことは、決してそう難しいことでもないのだ。
If, after doing so, one simply knocks out all the central inferences and presents one's audience with the starting-point and the conclusion, one may produce a startling, though possibly a meretricious, effect.	そしてもしこう云う試（こころみ）をして、誰かが中心思潮となっている論説を覆して、更にその聴衆に、新（あらた）な出発点と結論とを与えたら、それはたしかに、キザたっぷりなことではあるが、しかし一つの驚歎すべき結果をもたらしたと云ってよかろう。
Now, it was not really difficult, by an inspection of the groove between your left forefinger and thumb, to feel sure that you did NOT propose to invest your small capital in the gold fields."	さて、君の左の人差し指と拇指（おやゆび）の間の皮膚の筋を見て、君が採金地の株を買わなかったと云うことが、あまり首をひねりまわさない中（うち）に解ったと云うわけさ」
"I see no connection."	「どうも僕には何の事か解らないね」
"Very likely not;	「いや誠に御もっとも至極
but I can quickly show you a close connection.	――しかしこれはごく手短に説明することが出来るんだ。
Here are the missing links of the very simple chain:	ここにそれぞれ取り外れていた、鎖の輪があるからね。
1. You had chalk between your left finger and thumb when you returned from the club last night.	第一には、君が昨夜倶楽部（くらぶ）から帰って来た時は、君の左の手の指のあたりに、白いチョークがついていたこと。
2. You put chalk there when you play billiards, to steady the cue.	第二には、君が玉を突く時は棒（キュー）の辷（すべ）りをよくするために、チョークをつける習慣のあること。
3. You never play billiards except with Thurston.	第三には、君はサーストン氏との外（ほか）には、決して玉を突かないこと、
4. You told me, four weeks ago, that Thurston had an option on some South African property which would expire in a month, and which he desired you to share with him.	――第四には君が四週間前に、サーストン氏は、南アフリカの採金地の株式募集をやっているが、その締切りまでは一ヶ月あるので、君にも加入してくれと云って来たと話したことのあったこと、
5. Your check book is locked in my drawer, and you have not asked for the key.	――第五には、君の小切手帳は、僕の抽斗（ひきだし）に入って錠が下りているが、しかし君はその鍵を決して僕に請求しなかったこと、
6. You do not propose to invest your money in this manner."	――第六には、君がこのようにして、この株式に申込をしなかったと云うこと、――」
"How absurdly simple!"	「ははははははは、何と云う馬鹿馬鹿しく解り切ったことだ！」
I cried.	私は叫んだ。
"Quite so!"	「全くその通りさ」
said he, a little nettled.	彼はちょっと不気嫌になって云った。
"Every problem becomes very childish when once it is explained to you.	「どんな問題でも、一通りわかってしまうと君には皆小供だましのように解り切ったものになってしまうのだ。
Here is an unexplained one.	ではここに未解決の問題があるが、
See what you can make of that, friend Watson."	ワトソン君、これには君はどう云う解釈を与えるね？」
He tossed a sheet of paper upon the table, and turned once more to his chemical analysis.	彼は一枚の紙を机の上に放り出して、また化学の分析の方に向き直った。
I looked with amazement	私はそれを見て驚いてしまった。
at the absurd hieroglyphics upon the paper.	それは、何かの符牒の文字のようなものであった。
"Why, Holmes, it is a child's drawing,"	「何んだ、――これは小供の絵ではないか――ホームズ君！」
I cried.	私は叫んだ。
"Oh, that's your idea!"	「ははははははは、そんなものに見えるのかね！」
"What else should it be?"	「じゃ何なんだね？」
"That is what Mr. Hilton Cubitt, of Riding Thorpe Manor, Norfolk, is very anxious to know.	「これは、ノーフォークのリドリング公領［＃「リドリング公領」は底本では「リドリユグ公領」］のヒルトン・キューピット氏が、しきりに知りたがっていることなんだがね。
This little conundrum came by the first post, and he was to follow by the next train.	この謎のような問題は、第一回の郵便配達で来て、その人は二番列車でその後から来ることになっているのだ。
There's a ring at the bell, Watson.	ああワトソン君。
I should not be very much surprised if this were he."	ベルが鳴っているが、あるいはその人かもしれない――」
A heavy step was heard upon the stairs, and an instant later there entered a tall, ruddy, clean-shaven gentleman, whose clear eyes and florid cheeks told of a life led far from the fogs of Baker Street.	重々しい足取りが、階段にきこえたと思う中（うち）に、一人の紳士が入って来た。
He seemed to bring a whiff of his strong, fresh, bracing, east-coast air with him as he entered.	彼が室（へや）の中に入って来た時に、どこか強健なきびきびしたような、東海岸独特の香（におい）が、ただよって来るようであった。
Having shaken hands with each of us, he was about to sit down, when his eye rested upon the paper with the curious markings, which I had just examined and left upon the table.	彼は我々二人と握手を交わして、さて腰かけようとした時に、私が見て机の上に置いてあった、不思議な記号のようなものに目を止めた。
"Well, Mr. Holmes,	「ああホームズさん、
what do you make of these?"	――これをどう云う風にお考えになりましたか？」
he cried.	彼は叫んだ。
"They told me that you were fond of queer mysteries, and I don't think you can find a queerer one than that.	「あなたは大変、奇妙な神秘的なことをお好きでいらっしゃるそうですが、しかしこれはまた一段と、奇妙不可思議なものでしょう。
I sent the paper on ahead, so that you might have time to study it before I came."	私はあなたが、私が来る前に研究しておかれるようにと思って、前もってお送りしたわけです」
"It is certainly rather a curious production,"	「これはたしかに奇妙なものですな」
said Holmes.	ホームズは云った。
"At first sight it would appear to be some childish prank.	「ちょっと見れば、子供の悪戯画（いたずらがき）のようにも思われるし、
It consists of a number of absurd little figures dancing across the paper upon which they are drawn.	また、紙の上を踊りながらゆく、でたらめな小さな姿の、絵のようでもありますね。
Why should you attribute any importance to so grotesque an object?"	一たいこんな変な、得体の知れないものに、どうしてそんな勿体振った意味をつけようと仰有るのですか？」
"I never should, Mr. Holmes.	「いや、私は決してそう云うつもりではないのですが、
But my wife does.	ただ私の妻が大変なのです。
It is frightening her to death.	実は妻が全く気絶するほど、これに驚かされたのです。
She says nothing, but I can see terror in her eyes.	彼の女は何にも云いませんが、しかし私はその目の中に、非常な驚怖（きょうふ）を見て取りました。
That's why I want to sift the matter to the bottom."	それでそれを穿鑿（せんさく）してみたいと思ったわけです」
Holmes held up the paper so that the sunlight shone full upon it.	ホームズは紙片を取り上げて、太陽の光線をその上に直射せしめた。
It was a page torn from a notebook.	その紙片は、ノートブックから離し取ったもので、
The markings were done in pencil, and ran in this way:	鉛筆で次のような象形（かたち）が画かれてあった。
Holmes examined it for some time, and then, folding it carefully up, he placed it in his pocketbook.	ホームズはしばらくの間、それを検（しら）べていたが、やがて、叮嚀（ていねい）に折りたたんで、自分の手帳の間にはさんだ。
"This promises to be a most interesting and unusual case,"	「これはとても面白い、稀有の事件かもしれない」
said he.	彼は云った。
"You gave me a few particulars in your letter, Mr. Hilton Cubitt, but I should be very much obliged if you would kindly go over it all again for the benefit of my friend, Dr. Watson."	「ヒルトン・キューピットさん、あなたはお手紙の中（うち）では、二三具体的なことを書かれてありましたが、しかしこの友人のワトソン博士のために、もう一度一通りお話し下さいませんか」
"I'm not much of a story-teller,"	「どうも私は説明は拙劣（まず）いのですが、――」
said our visitor, nervously clasping and unclasping his great, strong hands.	我等の訪客は、その大きな強い手を、組んだり放したり、もじもじさせながら、神経質に語り出した。
"You'll just ask me anything that I don't make clear.	「いずれお解りにならないところは、そちらの方からお訊ね下さい、
I'll begin at the time of my marriage last year, but I want to say first of all that, though I'm not a rich man, my people have been at Riding Thorpe for a matter of five centuries, and there is no better known family in the County of Norfolk.	――私は去年、結婚した時のことから申しますが、まずその前にお耳に入れておきたいことは、私の家は、決して金持ではありませんが、ここ約五世紀の間は、現在のリドリング村に住んでいて、ノーフォーク地方では、第一の旧家だと云うことです。
Last year I came up to London for the Jubilee, and I stopped at a boarding-house in Russell Square,	去年の五十年祭には私はロンドンに来て、ランセル街の宿泊所に滞在しました。
because Parker, the vicar of our parish, was staying in it.	それは私の教区の牧師の、パーカーさんが滞在していた関係から、そこを選んだのでした。
There was an American young lady there--	そうするとそこに、亜米利加（アメリカ）の若い婦人が居たのでした。
Patrick was the name--	パートリックと云う名前で
Elsie Patrick.	――すなわちエルシー・パートリックと云う女でしたが、
In some way we became friends, until before my month was up I was as much in love as man could be.	――ふとした機会から、私共は友人になってしまいましたが、その滞在中に私は、遂に男性並々に、その女と恋愛関係に陥ってしまったのでした。
We were quietly married at a registry office, and we returned to Norfolk a wedded couple.	それで私共は早速結婚の手続をすまし、夫婦としてノーフォークに帰って来ました。
You'll think it very mad, Mr. Holmes, that a man of a good old family should marry a wife in this fashion, knowing nothing of her past or of her people, but if you saw her and knew her, it would help you to understand.	とにかく少しは知られている旧家の人間が、こんな風にして、全くその身元調査もろくろくしないで、結婚してしまうなどということは、とても乱暴なことと思われるでしょうが、しかしそのことは、私の妻を御覧下されて、彼の女を知って下されば、お解りになると思われますが、
"She was very straight about it, was Elsie.	――とにかく彼の女は、――エルシーは卒直でした。
I can't say that she did not give me every chance of getting out of it if I wished to do so.	もし私が訊ねさえしたら、何もかも隠さずに云ってくれたと思っています。
`I have had some very disagreeable associations in my life,'	「わたしにはとても厭な思い出がありますのよ」
said she,	こう云って彼の女は語るのでした。
`I wish to forget all about them.	「わたしはそれをどうにかして忘れてしまいたいと思いますわ。
I would rather never allude to the past, for it is very painful to me.	わたしはもう一切それには触れたくはありませんの。
If you take me, Hilton, you will take a woman who has nothing that she need be personally ashamed of, but you will have to be content with my word for it, and to allow me to be silent as to all that passed up to the time when I became yours.	ヒルトンさん、あなたがもしわたしを求めて下さるなら、そりゃ過去において一点の曇もない女性を得ることになると申しますが、しかしいずれあなたは、わたしの言葉を全部信じて下さって、わたしの過去については、何にも訊ねないと云うことを約束して下さい。
If these conditions are too hard, then go back to Norfolk, and leave me to the lonely life in which you found me.'	それでこのお約束が無理だと仰有るのでしたら、どうぞわたしをこのままのこしてノーフォークにお帰り下さい」
It was only the day before our wedding that she said those very words to me.	と、これは私達の結婚の前日に、彼の女が私に云った言葉でした。
I told her that I was content to take her on her own terms, and I have been as good as my word.	それで私は彼の女の言葉をそのまま容れて、その後もこの約束をかたく守って来たのでした。
"Well we have been married now for a year, and very happy we have been.	そしてその後私共は、この一年の間、結婚生活をつづけて来ましたが、私共は実に幸福でした。
But about a month ago, at the end of June, I saw for the first time signs of trouble.	しかしほぼ一ヶ月前、――六月の末頃に、私は始めて煩累（わざわい）の兆を見たのでした。
One day my wife received a letter from America. I saw the American stamp.	その頃妻は亜米利加（アメリカ）の消印のある手紙を受け取ったのでしたが、
She turned deadly white, read the letter, and threw it into the fire.	その時彼の女の顔は気絶しないばかりに蒼白になり、手紙を読んでから、それを火の中に投げこんでしまったのでした。
She made no allusion to it afterwards, and I made none, for a promise is a promise, but she has never known an easy hour from that moment.	その後は別に彼の女はそれについて何も云いませんでしたし、私もまた約束にしたがって、そのことについては一言も触れませんでした。
There is always a look of fear upon her face--a look as if she were waiting and expecting.	しかし彼の女は、それ以来はずっと、一つの不安にとざされていて、とかく顔色が浮かなくなり、何ごとかにビクビクしているようでした。
She would do better to trust me.	まあ俺を信ずるがよい。
She would find that I was her best friend.	俺こそは彼の女の、最もよい伴侶なのだ。
But until she speaks, I can say nothing.	しかし彼の女が云い出すまでは、私は切り出すことは出来ません。
Mind you, she is a truthful woman, Mr. Holmes, and whatever trouble there may have been in her past life it has been no fault of hers.	しかしホームズさん、くれぐれもお含みを願いたいのですが、彼の女はたしかに真実な女性で、もし彼の女の過去に、何か難題のようなものがあるとしても、それは彼の女の欠点ではないと思うのです。
I am only a simple Norfolk squire, but there is not a man in England who ranks his family honour more highly than I do.	私はただノーフォークの田舎者にすぎないのですが、しかしそれでも、英国では第一流の旧家であると云うことは、
She knows it well, and she knew it well before she married me.	彼の女はよく知っており、また結婚前からも認めていましたから、
She would never bring any stain upon it--of that I am sure.	まさか彼の女は、その私の家名を汚すようなことは、万々（ばんばん）無いと私は確信するのです。
"Well, now I come to the queer part of my story.	さていよいよこれから、私の話は、奇怪な部分に進みますが、
About a week ago--	一週間ばかり前、――
it was the Tuesday of last week--	そうです先週の火曜日でした。
I found on one of the window-sills a number of absurd little dancing figures like these upon the paper.	私は窓硝子の上に、この紙に画いてあるような、出鱈目（でたらめ）な小さな、踊っているような姿が、画かれてあるのを発見したのでした。
They were scrawled with chalk.	それは白墨でいたずら画きしたものでしたが、
I thought that it was the stable-boy who had drawn them, but the lad swore he knew nothing about it.	私は厩（うまや）番の少年がかいたのだろうと思いました、その若者は、全く知らないと云いはるのでした。
Anyhow, they had come there during the night.	とにかくそれは夜かかれたものでしたが、
I had them washed out, and I only mentioned the matter to my wife afterwards.	私はそれを洗い落してから、このことを妻に話しました。
To my surprise, she took it very seriously, and begged me if any more came to let her see them.	ところが驚いたことには、妻はそんなものを大変重大視して、もしまた画かれたら、ぜひ見たいと云うのでした。
None did come for a week, and then yesterday morning I found this paper lying on the sundial in the garden.	それから、一週間の間は、そんなものは画かれませんでしたが、ちょうど昨日の朝、またまた私は、庭園の日時計の上に、この紙片がおかれてあるのを見つけたのでした。
I showed it to Elsie, and down she dropped in a dead faint.	私はそれをエルシーに見せましたら、彼の女は気絶して倒れてしまったのでした。
Since then she has looked like a woman in a dream, half dazed, and with terror always lurking in her eyes.	それ以来彼の女は、全く茫然としてしまって、いつも恐怖にとりつかれた目色をしているのです。
It was then that I wrote and sent the paper to you, Mr. Holmes.	それでその時に私は、この紙片をあなたにお送りして、手紙をさし上げた次第でした。
It was not a thing that I could take to the police, for they would have laughed at me, but you will tell me what to do.	これはまさか警察に訴えても、ただ笑いものにされて、取りあってくれますまいし、あなたでしたら何とか方法を教えて下さるだろうと考えたのでした。
I am not a rich man, but if there is any danger threatening my little woman, I would spend my last copper to shield her."	私は決して金持ではありませんが、しかし何か私の妻を悩ましているものがあるとしたら、私は彼女を全財産を賭しても、保護してやりたいと思うのですが――」
He was a fine creature, this man of the old English soil--simple, straight, and gentle, with his great, earnest blue eyes and broad, comely face.	古いイギリスっ児のこの人間は、単純で卒直で、目は大きく熱意のこもった、堂々たる風貌の紳士であった。
His love for his wife and his trust in her shone in his features.	彼がその妻に対する愛情と信実は、外部にまで溢れ出ていた。
Holmes had listened to his story with the utmost attention, and now he sat for some time in silent thought.	ホームズは全注意を集めて、この話を聞いていたが、この話が終ると、しばしの間は、静（じ）っと沈黙したまま思案に沈んだ。
"Don't you think, Mr. Cubitt,"	「いや、キューピットさん、――」
said he, at last,	彼はようやく口を開いた。
"that your best plan would be to make a direct appeal to your wife, and to ask her to share her secret with you?"	「これはやはり、あなたが直接に奥さんにお訊ねになって、あなたに対して秘（かく）されていたことを、話してもらうのが一番早道ではないかと思われますがね」
Hilton Cubitt shook his massive head.	ヒルトン・キューピットはしかし、その大きな頭を振った。
"A promise is a promise, Mr. Holmes.	「ホームズさん、約束はどこまでも約束ですからね。
If Elsie wished to tell me she would.	もしエルシーが、話していいと思うくらいでしたら、彼から話してくれるでしょう。
If not, it is not for me to force her confidence.	そしてまたもし話したくないことでしたら、私は彼の女に対して強要はしたくはありません。
But I am justified in taking my own line--	しかしそれと離れても、私には私で取るべき道はあるはずです。
and I will."	そしてそれを私は大（おおい）にやろうと思うのです」
"Then I will help you with all my heart.	「いや、そう云うのでしたら、私も全力をつくして御相談に与（あずか）りましょう。
In the first place, have you heard of any strangers being seen in your neighbourhood?"	まずお訊ねしますが、この頃からあなたの御近所に、新に来た者があるようなことはお聞きになりませんか？」
"No."	「いえ」
"I presume that it is a very quiet place.	「大変閑静なところだろうと思われますが、
Any fresh face would cause comment?"	新顔などが現われて、人々の噂に上るようなことがありますか？」
"In the immediate neighbourhood, yes.	「えい、そうそうごく近所にありました。
But we have several small watering-places not very far away.	しかし私共の近所には、湯治場（とうじば）があるので、
And the farmers take in lodgers."	よく田舎者共が宿をとります」
"These hieroglyphics have evidently a meaning.	「この象形文字は、たしかに意味がありましょう。
If it is a purely arbitrary one, it may be impossible for us to solve it.	もし全く出鱈目なものだとすれば、それはもうとても解釈が出来ませんが、
If, on the other hand, it is systematic, I have no doubt that we shall get to the bottom of it.	しかしこれが組織的なものだとすれば、きっとどうにかして解くことが出来ますよ。
But this particular sample is so short that I can do nothing, and the facts which you have brought me are so indefinite that we have no basis for an investigation.	しかし何しろこれはひどく短いもので、どうにも仕様が無いし、またあなたが持って来られた事柄も、はなはだ漠然としたことで、考査の基本にはなりませんからね。
I would suggest that you return to Norfolk, that you keep a keen lookout, and that you take an exact copy of any fresh dancing men which may appear.	やはりこれはあなたが、一度ノーフォークにお帰りになって、注意深く監視をして、もう一度この踊り人の姿が現われた時に、正しく写し取った方がいいと思いますがね。
It is a thousand pities that we have not a reproduction of those which were done in chalk upon the window-sill.	先に窓硝子に画かれたものの写しを、見ることの出来ないのははなはだ遺憾ですが、
Make a discreet inquiry also as to any strangers in the neighbourhood.	いずれ近所に最近に現われた者に対しても、慎重の注意を向けなさい。
When you have collected some fresh evidence, come to me again.	そして新な証拠が得られたら、またお出で下さい。
That is the best advice which I can give you, Mr. Hilton Cubitt.	これがもうあなたに対しての、僕の最善のお答えです。
If there are any pressing fresh developments, I shall be always ready to run down and see you in your Norfolk home."	それでヒルトン・キューピットさん、もし何か新な展開がありましたら、その時は私はいつでも早速出発して、ノーフォークのお宅でお目にかかりましょう」
The interview left Sherlock Holmes very thoughtful,	この会見の後、シャーロック・ホームズは、しっかり考えこんでしまった。
and several times in the next few days I saw him take his slip of paper from his notebook and look long and earnestly at the curious figures inscribed upon it.	そしてこの後二三日の間、彼はたびたび手帳から、例の記号の画かれてある紙片を取り出しては、長いこと熱心に見つめているのであった。
He made no allusion to the affair, however, until one afternoon a fortnight or so later.	その後二週間ばかりの間、彼はそのことを、（おくび）にも出さなかったが、
I was going out when he called me back.	ふとある日の午後、私が外出しようとしているところを呼び止めた。
"You had better stay here, Watson."	「ワトソン君、出ないでいる方がよかろうと思われるんだがね」
"Why?"	「なぜ？」
"Because I had a wire from Hilton Cubitt this morning.	「今朝ヒルトン・キューピットから電報が来たのだ。
You remember Hilton Cubitt, of the dancing men?	そらあの舞踏人形のヒルトン・キューピットを知っているだろう。
He was to reach Liverpool Street at one-twenty.	彼は一時二十分にリバプール街に着くと云っているのだ。
He may be here at any moment.	で、もうやがてここに見えるだろうと思うのさ。
I gather from his wire that there have been some new incidents of importance."	その電報を綜合すると、どうも何か重大な新らしい出来事があったように思われるのだ」
We had not long to wait, for our Norfolk squire came straight from the station as fast as a hansom could bring him.	やがてまもなく、二輪馬車が全速力で、停車場から我等のノーフォークの紳士を乗せて、来たのであった。
He was looking worried and depressed, with tired eyes and a lined forehead.	大変悩み衰えているらしく、目は疲れており、額には皺を寄せていた。
"It's getting on my nerves, this business, Mr. Holmes,"	「これには全く、すっかり弱らされてしまいました、ホームズさん、――」
said he, as he sank, like a wearied man, into an armchair.	彼は半病人のように、腕椅子にもたれ寄りながら云った。
"It's bad enough to feel that you are surrounded by unseen, unknown folk, who have some kind of design upon you, but when, in addition to that, you know that it is just killing your wife by inches,	「どうでしょう、――自分の周囲に未知の未見の人間が、何か策動していて、しかもその上に妻がもう一寸刻みに、殺されてゆくと考えては、とても我慢が出来ませんでしょう？
then it becomes as much as flesh and blood can endure.	いやこれこそ全く生きた気持はありませんよ。
She's wearing away under it--	いや私の妻は刻々に、弱っていきます。
just wearing away before my eyes."	もう刻々に弱って私の前から消えてしまいそうなんです」
"Has she said anything yet?"	「奥さんは何も仰有いませんか？」
"No, Mr. Holmes, she has not.	「いえ、何も云いません。
And yet there have been times when the poor girl has wanted to speak, and yet could not quite bring herself to take the plunge.	しかし彼の女は、云おうとしたこともあったようでしたが、やはり遂に云い出し得ませんでした。
I have tried to help her,	私は妻を助けようとしました。
but I daresay I did it clumsily, and scared her from it.	しかし私はまずかったので結局彼の女を怖れすくませてしまうだけでした。
She has spoken about my old family, and our reputation in the county, and our pride in our unsullied honour, and I always felt it was leading to the point, but somehow it turned off before we got there."	彼の女は私の古い家庭のこと、私の家庭の地方においての名聞、またその汚れない名誉と云ったようなものについて、言葉を触れさせることもありましたが、その時は私は、いよいよ大切な要点にゆくのだと思うと、もうその中（うち）に、話は外（よそ）に外（そ）れてしまうのでした」
"But you have found out something for yourself?"	「しかしあなた御自分で、気のついたものはありませんでしたか？」
"A good deal, Mr. Holmes.	「いやホームズさん、
I have several fresh dancing-men pictures for you to examine,	それはたくさんあります、私はぜひあなたにお目にかけたい、新な舞踏人の絵を持って来ました。
and, what is more important, I have seen the fellow."	そして更に重大なことは、私はある者を見たのです」
"What, the man who draws them?"	「ある者を、――それはその絵を画いた当人ですか？」
"Yes,	「そうです。
I saw him at his work.	私はその者が画いているところを見ました。
But I will tell you everything in order.	いやとにかく、最初こう順序を立てて申しましょう。
When I got back after my visit to you, the very first thing I saw next morning was a fresh crop of dancing men.	私がこの前にお訪ねして帰ってからまず、次の朝に新な舞踏人の絵を見たのでした。
They had been drawn in chalk upon the black wooden door of the tool-house, which stands beside the lawn in full view of the front windows.	それは芝生の横にある、物置の真黒い扉の上に、白墨で画かれたものでしたが、私のところの正面の窓から目に止まったのでした。
I took an exact copy, and here it is."	私はそれを正確に写し取って来ましたが、これがそれです」
He unfolded a paper and laid it upon the table.	彼は一枚の紙をひろげて、テーブルの上に置いた。
Here is a copy of the hieroglyphics:	それは次の図のような、象形記号と云ったようなものであった。
"Excellent!"	「素敵！
said Holmes.	素敵！
"Excellent!	さあその先を、――」
Pray continue."	ホームズは云った。
"When I had taken the copy, I rubbed out the marks, but, two mornings later, a fresh inscription had appeared.	「私がそれを写し取ってしまってから、その絵を消してしまいましたが、その次の次の朝に、また別のが画かれてありました。
I have a copy of it here":	それがこの方です」
Holmes rubbed his hands and chuckled with delight.	ホームズは、手をもじゃもじゃさせ、歓喜の微笑をもらした。
"Our material is rapidly accumulating,"	「材料は着々と集まって来るぞ！」
said he.	彼は云った。
"Three days later a message was left scrawled upon paper, and placed under a pebble upon the sundial.	「それから三日の後、紙の上に走りがきされた、一枚の通牒（メッセージ）が日時計の上の、小石の下に置かれてありました。
Here it is.	それはこれです。
The characters are, as you see, exactly the same as the last one.	御覧の通り、これはすべて同一人のものですがね。
After that I determined to lie in wait, so I got out my revolver and I sat up in my study, which overlooks the lawn and garden.	それでこの後は私は、一つ待ち伏せしてやろうと思い立って、拳銃（ピストル）を持って、私の書斎に位置を取り、芝生や庭を見張りました。
About two in the morning I was seated by the window, all being dark save for the moonlight outside,	午前二時頃、――私が窓際に腰かけていましたが、外は月夜で仄（ほの）あかるかったがしかし、その外はもちろん暗闇でした。
when I heard steps behind me, and there was my wife in her dressing-gown.	その時私はふと後に、人の気配を感じたと思うと、それは寝巻姿の妻でした。
She implored me to come to bed.	彼の女は私に、寝室に帰るようにと云いましたが、
I told her frankly that I wished to see who it was who played such absurd tricks upon us.	私は卒直に、私たちに馬鹿気たいたずらをする者を突き止めようと思うのだと告げました。
She answered that it was some senseless practical joke, and that I should not take any notice of it.	そうすると妻は、それはつまらない悪戯に相違ないのだから、私に深く気に止めないようにと云うのでした。
"`If it really annoys you, Hilton, we might go and travel, you and I, and so avoid this nuisance.'	そして
"`What, be driven out of our own house by a practical joker?'	「だってそんな馬鹿気た悪戯に、自分の家（うち）を追い出されたりして、世間の笑い物になったりしてはいられないではないか、――」
said I.	私はこう答えました。
"`Well, come to bed,'	「えい、それもそうですね。
`and we can discuss it in the morning.'	朝になってからよくお話が出来るじゃありませんか」
"Suddenly, as she spoke, I saw her white face grow whiter yet in the moonlight, and her hand tightened upon my shoulder.	しかし彼の女はこう云うと共に、彼の女の白い顔は、それは月光の中としても、あまりに白いと思われるように、蒼白になって来て、手を私の肩にしっかりとかけました。
Something was moving in the shadow of the tool-house.	その時に物置小屋の蔭の中に、何か動いているのに目が止まりました。
I saw a dark, creeping figure which crawled round the corner and squatted in front of the door.	何かいっそう黒い影が、その蔭の角（すみ）のところを這いまわって、戸口の前に跼（うずく）まったのでした。
Seizing my pistol, I was rushing out, when my wife threw her arms round me and held me with convulsive strength.	私はやにわに、ピストルを持って飛び出そうとすると、妻は両腕でしっかりと私を抱き止めて、顫（ふる）えるような力で押えるのでした。
I tried to throw her off, but she clung to me most desperately.	私は妻を振り放そうとしましたが、彼の女は全く必死でした。
At last I got clear, but by the time I had opened the door and reached the house the creature was gone.	私はやっと振り払って、外に出てその物置へ行った時は、もうその姿は見えませんでした。
He had left a trace of his presence, however, for there on the door was the very same arrangement of dancing men	しかしたしかにその者は来た形跡はあって、扉（と）の上には例の舞踏人姿の画（え）がかかれてありました。
which had already twice appeared, and which I have copied on that paper.	それは以前に二度かかれたものと同じものですが、その写しはこれです。
There was no other sign of the fellow anywhere, though I ran all over the grounds.	それから私は周囲を残る隈なく探しましたが、もうその他には何の痕跡もありませんでした。
And yet the amazing thing is that he must have been there all the time, for when I examined the door again in the morning, he had scrawled some more of his pictures under the line which I had already seen."	しかしそれから更に驚いたことには、その者はその後も現われたらしく、翌朝になって私は、例の扉（と）の上を見ましたら、私が前夜見ておいたものの下に、更に新らしいのが画かれてありました」
"Have you that fresh drawing?"	「その新らしいのも写し取りましたか？」
"Yes, it is very short, but I made a copy of it, and here it is."	「えい、とても短いものですが、これです」
Again he produced a paper.	彼は更に新らしい紙片を取り出した。
The new dance was in this form:	その新らしい舞踏人姿は次のようなものであった。
"Tell me,"	「いや、ちょっと――」
said Holmes--	ホームズは云った。
and I could see by his eyes that he was much excited--	彼は非常に気乗りがして来たらしかった。
"was this a mere addition to the first or did it appear to be entirely separate?"	「これは最初ののに、ただ附けたしに画かれてありましたか、それとも全く別のものに離して画かれてありましたか？」
"It was on a different panel of the door."	「これは扉（と）の別の鏡板（かがみいた）にかかれてありました」
"Excellent!	「素敵だ！
This is far the most important of all for our purpose.	これは我々にとっては、最も重要なものだ。
It fills me with hopes.	これではなはだ有望になった。
Now, Mr. Hilton Cubitt, please continue your most interesting statement."	さてヒルトン・キューピットさん、とても面白いですが、その先を云って下さい」
"I have nothing more to say, Mr. Holmes,	「ホームズさん、もう何も云うことはないのですが、
except that I was angry with my wife that night for having held me back when I might have caught the skulking rascal.	――ただ私は、その夜妻が、私が悪漢をつかまえるために、飛び出るのを引き止めたことについて怒りました。
She said that she feared that I might come to harm.	そうすると妻は、私が怪我をしてはいけないと思ったからと云いわけするのでした。
For an instant it had crossed my mind that perhaps what she really feared was that HE might come to harm, for I could not doubt that she knew who this man was, and what he meant by these strange signals.	しばしの間は私に、妻はその者の何者であるかを知っていて、またその変な相図もわかっていて、彼の女の案じているのは、私ではなく、向うの者の怪我であると云うことが、閃きましたが、
But there is a tone in my wife's voice, Mr. Holmes, and a look in her eyes which forbid doubt,	しかしまたよく考え直してみると、ホームズさん、彼の女の声の調子にも、また目の色にも、この疑念をかき消させるものがありました。
and I am sure that it was indeed my own safety that was in her mind.	それで私はやはり、彼の女が本当に心配したのは、私自身の身であったのだと考えるのです。
There's the whole case, and now I want your advice as to what I ought to do.	これでもう話は終りました、が、さてどうすればよろしいのか、これに対する方法を教えていただきたいのですが。
My own inclination is to put half a dozen of my farm lads in the shrubbery, and when this fellow comes again to give him such a hiding that he will leave us in peace for the future."	――まあ私の考えとしては、百姓の若者共を五六人も待ち伏せさせておいて、その者が出て来た時に、したたか打ちのめして、以後私共に近寄れないようにしようかとも思っていますが、――」
"I fear it is too deep a case for such simple remedies,"	「いや、そんな簡単なことで、収（おさま）りのつくことではないでしょう」
said Holmes.	ホームズは云った。
"How long can you stay in London?"	「一たいあなたはどのくらい、ロンドンに滞在することが出来ますか？」
"I must go back to-day.	「私は今日中には、帰宅しなければなりません。
I would not leave my wife alone all night for anything.	私はどんなことがあっても、妻を一人で夜を暮させることは出来ません。
She is very nervous, and begged me to come back."	彼の女はもう非常に神経質になっていて、どうしても僕に帰宅するようにと云うのです」
"I daresay you are right.	「いや、それは御もっともです。
But if you could have stopped, I might possibly have been able to return with you in a day or two.	しかしもしあなたが、滞在しておられるなら、一両日中にはあなたと一緒に出かけることが出来ると思いますが、
Meanwhile you will leave me these papers,	――とにかく、この紙は置いて行って下さい。
and I think that it is very likely that I shall be able to pay you a visit shortly and to throw some light upon your case."	私はごく最近にお訪ねして、この事件に対しては、多少の吉報を齎（もたら）すことが出来ると思いますから、――」
Sherlock Holmes preserved his calm professional manner until our visitor had left us, although it was easy for me, who knew him so well, to see that he was profoundly excited.	シャーロック・ホームズは、この訪客が立ち去るまでは、いかにもその職業的な、冷静を保っていたが、しかし彼の容子を見なれている私には、彼は内面では、ひどく昂奮（こうふん）しているに相違なかった。
The moment that Hilton Cubitt's broad back had disappeared through the door my comrade rushed to the table, laid out all the slips of paper containing dancing men in front of him, and threw himself into an intricate and elaborate calculation.	ヒルトン・キューピットの広い脊中が、扉（ドア）の外に見えなくなるや否や、彼は机の上に走り寄って例の舞踏人画の紙を取り出して並べて、とても大変なこみ入った計算を始めた。
For two hours I watched him as he covered sheet after sheet of paper with figures and letters,	二時間ばかりの間、――彼は何枚も何枚も、数字と文字を書いては、その仕事に没頭した。
so completely absorbed in his task that he had evidently forgotten my presence.	全く私がその室（へや）にいるのさえも忘れて、一生懸命に続けた。
Sometimes he was making progress and whistled and sang at his work;	ある時は多少に仕事が進むもののように、口笛を吹いたり歌ったりし、
sometimes he was puzzled, and would sit for long spells with a furrowed brow and a vacant eye.	またやがては、全くその長い謎に閉口してしまったように、額をすくめ目を茫然とさせていた。
Finally he sprang from his chair with a cry of satisfaction, and walked up and down the room rubbing his hands together.	それから遂に彼は思わずも歓喜の声を上げながら起ち上って、盛んに手をもじもじさせながら室（へや）の中をぶらぶらと歩き出した。
Then he wrote a long telegram upon a cable form.	それから海底電信機式に、長い電報をかいた。
"If my answer to this is as I hope, you will have a very pretty case to add to your collection, Watson,"	「もしこの返事が、僕の注文通りのものだったらワトソン君、――君の蒐集（しゅうしゅう）の中に、また実に素晴らしいものを加えることが出来るんだがね」
said he.	彼は云った。
"I expect that we shall be able to go down to Norfolk tomorrow, and to take our friend some very definite news as to the secret of his annoyance."	「明日は我々はノーフォークに行って、あの人間が苦しんでいる秘密事に、決定的な新な展開を与えることが出来そうだ」
I confess that I was filled with curiosity, but I was aware that Holmes liked to make his disclosures at his own time and in his own way, so I waited until it should suit him to take me into his confidence.	私はとても好奇心をそそられてしまった、しかしまた私は、彼はいつも自分の方から、いい時を見計らって話してくれることはよく知っているので、私の方から訊ねることはしなかった。
But there was a delay in that answering telegram,	しかしその返電はなかなか来なかった。
and two days of impatience followed, during which Holmes pricked up his ears at every ring of the bell.	ホームズはその間を、呼鈴に注意しながら、ヤキモキして待った。
On the evening of the second there came a letter from Hilton Cubitt.	しかしその二日目の夕方、やっとヒルトン・キューピットから、一通の手紙が来た。
All was quiet with him, save that a long inscription had appeared that morning upon the pedestal of the sundial.	その手紙によれば、ヒルトン・キューピットの身辺は、その後は静穏であったが、しかしその朝、またまた、日時計の上に、長いものを画いたものが乗っていたので、
He inclosed a copy of it,	その写しをとって送ってよこしたのであった。
which is here reproduced:	それは次のようなものであった。
Holmes bent over this grotesque frieze for some minutes, and then suddenly sprang to his feet with an exclamation of surprise and dismay.	ホームズは数分間の間、――この奇怪な帯模様の絵に見入っていたが、突然、驚愕と困迷の声を上げて起ち上った。
His face was haggard with anxiety.	その顔は不安のために全く色を失っていた。
"We have let this affair go far enough,"	「これはうっかりしてしまったかもしれない！」
said he.	彼は云った。
"Is there a train to North Walsham to-night?"	「今夜これから、北ワルシャムに行く汽車があるかね？」
I turned up the time-table.	私は時間表をくってみた。
The last had just gone.	ちょうど最終列車が出たばかりのところであった。
"Then	「じゃ仕方がない。
we shall breakfast early and take the very first in the morning,"	――あしたの朝早く朝食をすまして、一番列車に乗ろう」
said Holmes.	ホームズは云った。
"Our presence is most urgently needed.	「俺たちは出来るだけ早くゆかなければならない。
Ah! here is our expected cablegram.	これがすなわち待ち設けた海底電信なのだ。
One moment, Mrs. Hudson, there may be an answer.	ちょっとハドソン夫人、また返事がいるかもしれませんが、
No, that is quite as I expected.	――いやこれでよい、これでよい。
This message makes it even more essential that we should not lose an hour	この通信が手に入った以上は、いよいよ遅れてはならない。
in letting Hilton Cubitt know how matters stand,	一時も早く、ヒルトン・キューピットに、この事を知らせてやらなければならない。
for it is a singular and a dangerous web in which our simple Norfolk squire is entangled."	これがすなわちあのノーフォークの先生を悩ましている、蜘蛛の網だからね」
So, indeed, it proved,	たしかに着々とその通りに進んだ。
and as I come to the dark conclusion of a story which had seemed to me to be only childish and bizarre, I experience once again the dismay and horror with which I was filled.	私はその話を一時は子供威しと思ったのであったが、しかしその暗澹（あんたん）たる真相を知るにつれて、私はその後感じさせられた気味悪さを、今更にまた深く感じさせられた。
Would that I had some brighter ending to communicate to my readers, but these are the chronicles of fact,	私は読者諸君には、どうにかしていい話をきかせたいと思うのであるが、しかし事実はこうであったのだ。
and I must follow to their dark crisis the strange chain of events which for some days made Riding Thorpe Manor a household word through the length and breadth of England.	私はこのリドリング地方と云う名前が、僕が数日の間に、全英国の人口に膾炙（かいしゃ）した言葉となってしまった物語を、そのままここに述べてみることとする。
We had hardly alighted at North Walsham, and mentioned the name of our destination, when the station-master hurried towards us.	私たちが北ワルシャムに着いて下車して、我々の行先を云うや否や、駅長が我々の前に走って来た。
"I suppose that you are the detectives from London?"	彼はそしてこう云った。
said he.	「あなた方はロンドンからお出でになった、探偵の方々でいらっしゃいますか？」
A look of annoyance passed over Holmes's face.	ホームズの面上には、当惑の色が現われ出た。
"What makes you think such a thing?"	「どうしてそう思うのです？」
"Because Inspector Martin from Norwich has just passed through.	「いえ実はじき今し方、検察官のマーチンさんが、ノーアウィッチから来て、ここを通過して行ったばかりなのです。
But maybe you are the surgeons.	しかしあるいはあなた方は、外科医でいらっしゃるかもしれない。
She's not dead--	――彼の女はまだ死にませんよ。
or wasn't by last accounts.	いやさっききいた容子では、たしかにまだ死なないとのことでしたがね。
You may be in time to save her yet	あなた方は間に合うでしょう。
--though it be for the gallows."	――もっともどうせ絞首台にゆくことですがね」
Holmes's brow was dark with anxiety.	ホームズの顔はすっかり不安に蔽（おお）われてしまった。
"We are going to Riding Thorpe Manor,"	「我々は、リドリング村に行く途中ですが、しかし実は、全くどんなことが起ったのか、きいてはいないのです」
said he,	彼は云った。
"It's a terrible business,"	「それはなかなか大変なことですな」
said the stationmaster.	駅長は云った。
"They are shot, both Mr. Hilton Cubitt and his wife.	「ヒルトン・キューピット夫妻は、どちらも撃たれたのだそうです。
She shot him and then herself--so the servants say.	召使の者の云うには、まず夫人が檀那（だんな）さんを撃って、それから自分も撃ったのだそうですがね。
He's dead and her life is despaired of.	それで檀那さんの方はもう事切れてしまい、夫人の方は虫の息ですって、――
Dear, dear, one of the oldest families in the county of Norfolk, and one of the most honoured."	どうも全く、あたら名門の末を本当に、――」
Without a word Holmes hurried to a carriage, and during the long seven miles' drive he never opened his mouth.	ホームズは一語も発せず、馬車に大急ぎで乗り、それから七哩（まいる）以上の道のりを、全く黙し切ったままであった。
Seldom have I seen him so utterly despondent.	私は実際この時ほど、ホームズが落胆している様子を、そうたびたび見たことはない。
He had been uneasy during all our journey from town, and I had observed that he had turned over the morning papers with anxious attention,	彼は町から以来と云うものは、全く不安に塞（とざ）されたままで、ただ凝（じっ）と朝刊に、不安な目を向けているだけであった。
but now this sudden realization of his worst fears left him in a blank melancholy.	そして結局、最も悪い結果の予想が、俄然はっきりしてしまってからは、彼はもう救うべからざる憂欝に陥ってしまったのであった。
He leaned back in his seat, lost in gloomy speculation.	彼は坐席に凭（もた）れて、沈思のために全く茫然自失の容子であった。
Yet there was much around to interest us,	しかしもちろん我々の馬車の両側には、とても興味ある眺望があったのであった。
for we were passing through as singular a countryside as any in England, where a few scattered cottages represented the population of to-day, while on every hand enormous square-towered churches bristled up from the flat green landscape and told of the glory and prosperity of old East Anglia.	すなわち我々の馬車の両側には、英国の特有の田園が展開し、方々に散在している田舎家は、今日の殷盛な人口を思わせ、またあっちにもこっちにも、大きな四角な塔の教会が、平原の地平線の上に屹立（きつりつ）し、緑の濃い風景、――と、昔の東部アングリアの、光栄と殷盛を想わしめるものであった。
At last the violet rim of the German Ocean appeared over the green edge of the Norfolk coast,	その中（うち）に遂に、菫色（すみれいろ）の独逸（ドイツ）海の海面が、ノーフォークの海岸の緑の縁を越して現われた。
and the driver pointed with his whip to two old brick and timber gables which projected from a grove of trees.	それから馭者（ぎょしゃ）は、茂った樹木の間からそびえ立っている煉瓦と木材の破風を、鞭で指しながら
"That's Riding Thorpe Manor,"	「あれがリドリング村です」
said he.	と云った。
As we drove up to the porticoed front door, I observed in front of it, beside the tennis lawn, the black tool-house and the pedestalled sundial	私たちが玄関の戸口に乗りつけると、その前面は、テニスコートの横であったが、黒い戸の建物と、台の上に乗っている日時計が目に止まった。
with which we had such strange associations.	これ等については私たちは、もちろん不思議な連想を持っているのである。
A dapper little man, with a quick, alert manner and a waxed moustache, had just descended from a high dog-cart.	一人の気のきいたような小さな男が、蝋（ろう）を塗ったような髭をしていたが、二輪馬車から敏捷な容子で下り立った。
He introduced himself as Inspector Martin, of the Norfolk Constabulary, and he was considerably astonished when he heard the name of my companion.	その男は、自分自身で、ノーフォーク警察の、検察官マーティンであると云って紹介して来たが、私の友人の名前を聞いた時は、かなり驚いた様子であった。
"Why, Mr. Holmes,	「これはまた、ホームズ先生、
the crime was only committed at three this morning.	――犯罪は今朝の三時に行われたばかりなのですが、
How could you hear of it in London	ロンドンで、どうしてこんなに早くお聞きになったのですか？
and get to the spot as soon as I?"	私と同時にこの現場にお出でになると云うことには全く驚きました」
"I anticipated it.	「私はこのことを予想したのでした。
I came in the hope of preventing it."	実はそれを防止するためにやって来たのでしたが」
"Then you must have important evidence, of which we are ignorant,	「それではあなたは、われわれの知らない、重大な証拠をお持ちになっていられるでしょう、
for they were said to be a most united couple."	――彼らは大変琴瑟相和（きんひつあいわ）した夫婦だったと云うことですがね、――」
"I have only the evidence of the dancing men,"	「私はただあの舞踏人の話を知っているだけなんですが、――」
said Holmes.	ホームズは云った。
"I will explain the matter to you later.	「いずれ後刻、そのことはお話しましょう。
Meanwhile, since it is too late to prevent this tragedy, I am very anxious that I should use the knowledge which I possess in order to insure that justice be done.	いずれにしても、もう手遅れしてしまいましたが、しかし僕は、多少持ち合せている智識を、この事件の解決のために、出来るだけ提供し、利用したい希望なのですが、
Will you associate me in your investigation, or will you prefer that I should act independently?"	あなたはこの事件の調査については、私と協同して下さいますか、、またそれとも別々に行動しましょうか？」
"I should be proud to feel that we were acting together, Mr. Holmes,"	「いえホームズ先生、協力してやらせて下されば光栄の至りですが、――」
said the inspector, earnestly.	その検察官は熱意をこめて云った。
"In that case I should be glad to hear the evidence and to examine the premises without an instant of unnecessary delay."	「では早速証拠を持ち寄り合って、時を移さずこの邸内の調査を始めようではないですか、――」
Inspector Martin had the good sense to allow my friend to do things in his own fashion, and contented himself with carefully noting the results.	検察官のマーティンは私の友人に大変好意を持っていて、私の友人を自由に活動させて、ただその結果を注意深く見ているだけであった。
The local surgeon, an old, white-haired man, had just come down from Mrs. Hilton Cubitt's room, and he reported that her injuries were serious, but not necessarily fatal.	白髪の老田舎外科医が、ヒルトン・キューピット夫人の診察に来ていたが、その話に因れば、彼の女の傷は重傷ではあったが、しかし命には差支えがなかろうと云うことであった。
The bullet had passed through the front of her brain, and it would probably be some time before she could regain consciousness.	弾丸（たま）は彼の女の前額を貫通していたが、たぶん彼の女はしばらくの間は、意識を失ったに相違なかった。
On the question of whether she had been shot or had shot herself, he would not venture to express any decided opinion.	彼の女が撃たれたのであるのか、それとも自分から自分を撃ったのであるかと云うことについては、彼の女は決して口を開かなかった。
Certainly the bullet had been discharged at very close quarters.	そしてそれは疑もなく、ごく近距離から発射されたものに相違なかった。
There was only the one pistol found in the room, two barrels of which had been emptied.	室の中に一挺（ちょう）のピストルっきり見出されなかったが、しかし薬莢（やくきょう）は、二つ空になっていた。
Mr. Hilton Cubitt had been shot through the heart.	ヒルトン・キューピット氏は、心臓を打ちぬかれていた。
It was equally conceivable that he had shot her and then himself, or that she had been the criminal, for the revolver lay upon the floor midway between them.	そのただ一挺のピストルは、二人のちょうど中間の床の上に落ちてあったが、したがってこれは、ヒルトン・キューピットがその妻を撃ってから、自分自身を撃ったのか、それとも妻の方が先に夫を撃って自分を撃ったのか、いずれとも考え迷われることであった。
"Has he been moved?"	「ヒルトン・キューピットさんは動かされましたか？」
asked Holmes.	ホームズは訊ねた。
"We have moved nothing except the lady.	「いいえ、奥さんの外（ほか）は、何も動かしません。
We could not leave her lying wounded upon the floor."	怪我をしている者だけは、そのまま床の上に放っておくわけにはゆきませんからな」
"How long have you been here, Doctor?"	「あなたはいつ頃ここに来られました？」
"Since four o'clock."	「四時でした」
"Anyone else?"	「外に誰かいましたか？」
"Yes, the constable here."	「巡査が来ています」
"And you have touched nothing?"	「では何にも手を触れないわけですな？」
"Nothing."	「えい、決して、――」
"You have acted with great discretion.	「なかなか慎重におやりになりましたな。
Who sent for you?"	誰があなたをお迎えにゆきました？」
"The housemaid, Saunders."	「女中のサウンダーでした」
"Was it she who gave the alarm?"	「最初に見つけたのはその女だったのですか？」
"She and Mrs. King, the cook."	「その女とそれから、料理女（コック）のキングさんと云うのと二人だそうです」
"Where are they now?"	「その人たちはどこにいますか？」
"In the kitchen, I believe."	「たぶん台所にいるでしょう」
"Then I think we had better hear their story at once."	「そう、それでは早速、その人たちからきいてみよう」
The old hall, oak-panelled and high-windowed, had been turned into a court of investigation.	樫の腰板の、高い窓のついた古い広間が、審理所にあてられた。
Holmes sat in a great, old-fashioned chair, his inexorable eyes gleaming out of his haggard face.	ホームズは大きな古い型の椅子に腰かけて、古色蒼然とした顔から烱々（けいけい）とした眼光を輝かしていた。
I could read in them a set purpose to devote his life to this quest until the client whom he had failed to save should at last be avenged.	その目の中には、彼が依頼されながら、みすみす助ける機会を失ってしまった依頼者のために、見事に復讐してやるまでは、この事件に心身を賭してやるという決心の色が窺われた。
The trim Inspector Martin, the old, gray-headed country doctor, myself, and a stolid village policeman made up the rest of that strange company.	小ざっぱりとした検察官のマーティン、灰色髭の老田舎医師、私自身、のろまなような田舎巡査とが、変な恰好のつかない一坐をつくった。
The two women told their story clearly enough.	その二人の女は、よく明瞭に話してくれた。
They had been aroused from their sleep by the sound of an explosion, which had been followed a minute later by a second one.	その話に因ると、彼の女たちは爆音に目をさまさせられたのであったが、その時この爆音は、ものの一分も間があったろうか、すぐにきえたそうである。
They slept in adjoining rooms, and Mrs. King had rushed in to Saunders.	彼の女たちは室をとなり合せて、寝ていたのであったがキング女の方がサウンダー女の方に、驚いて飛びこんで行った。
Together they had descended the stairs.	そして二人は一緒に階段を下りた。
The door of the study was open, and a candle was burning upon the table.	書斎の扉（ドア）は開いていて、テーブルの上には、ローソクがともっていた。
Their master lay upon his face in the centre of the room.	そして彼の女たちの主人は、うつ伏せになって室の中央に斃（たお）れて、
He was quite dead.	もう全く息は絶えており、
Near the window his wife was crouching, her head leaning against the wall.	夫人の方は窓近くに這い寄って、壁に頭を寄せかけていたが
She was horribly wounded, and the side of her face was red with blood.	大変な負傷で、顔の半面は血まみれになっていて、
She breathed heavily, but was incapable of saying anything.	もう何も云うことが出来ず、ただ呻吟（うめい）ていたそうである。
The passage, as well as the room, was full of smoke and the smell of powder.	室の中はもちろん、廊下も何も、火薬の煙と臭（におい）で一ぱいで、
The window was certainly shut and fastened upon the inside.	室の窓はたしかに閉められて、内側からは掛け金もかけられてあったと。
Both women were positive upon the point.	二人の女どもはこの点については、とてもよくはっきりしていた。
They had at once sent for the doctor and for the constable.	彼の女たちは早速、医者と駐在所に知らせた。
Then, with the aid of the groom and the stable-boy, they had conveyed their injured mistress to her room.	それから馬丁と厩番の少年の手を藉（か）りて、夫人をその室に移したのであった。
Both she and her husband had occupied the bed.	主人夫婦はたしかにその夜は寝室に入ったに相違なかった。
She was clad in her dress--he in his dressing-gown, over his night-clothes.	婦人のほうは日常の着物を着ていたが、しかし主人の方は、寝衣（ドレッシングガウン）に、寛服（ナイトガウン）を重ねていたのであった。
Nothing had been moved in the study.	書斎の中は全く一物も動かされた形跡はなかった。
So far as they knew, there had never been any quarrel between husband and wife.	その女たちの見て知っているところでは、その夫妻の間に、喧嘩と云ったようなもののあったためしも無いようであったと。
They had always looked upon them as a very united couple.	とても仲のよい夫婦と見られていたのであった。
These were the main points of the servants' evidence.	以上のことは女中たちの陳述の大要であるが、
In answer to Inspector Martin, they were clear that every door was fastened upon the inside, and that no one could have escaped from the house.	検察官マーティンに答えた言葉では、扉（ドア）と云う扉（ドア）は全部、内部からしっかりと締め下されてあって、誰も家の中から遁げ出したはずはないと云うことであった。
In answer to Holmes, they both remembered that they were conscious of the smell of powder from the moment that they ran out of their rooms upon the top floor.	それからホームズの問いに対しては、彼の女たちは、一番上の自分たちの室を飛び出した時に、火薬の臭をかいだと云うのであった。
"I commend that fact very carefully to your attention,"	「これはなかなか慎重にかからなければならない大問題ですな」
said Holmes to his professional colleague.	ホームズは仕事仲間に云った。
"And now I think that we are in a position to undertake a thorough examination of the room."	「さあ、それでは、一つ室の中を徹底的に調べてみようじゃないですか」
The study proved to be a small chamber,	書斎は小さな室であった。
lined on three sides with books, and with a writing-table facing an ordinary window, which looked out upon the garden.	三方は書物を立て並べられ、書机（しょづくえ）は普通の窓に向って置かれ、そこから庭園は見渡されるのであった。
Our first attention was given to the body of the unfortunate squire,	まず我々は第一に、この不幸な田園紳士の死体を検べた。
whose huge frame lay stretched across the room.	彼のがっかりした躯幹（くかん）は、室にさし渡しになって横たわっていた。
His disordered dress showed that he had been hastily aroused from sleep.	着衣は大変乱れていたが、それはあるいは彼が眠ってるところから、飛び起きたのだろうと思われた。
The bullet had been fired at him from the front, and had remained in his body, after penetrating the heart.	弾丸は前面から撃たれて、彼の心臓をやっつけたまま、体内に止まっていた。
His death had certainly been instantaneous and painless.	彼の死はたしかに即死で、しかももう苦痛さえも無いものであったろう。
There was no powder-marking either upon his dressing-gown or on his hands.	火薬の痕跡は、寝衣（ドレッシングガウン）にもまた手にもついてはいなかった。
According to the country surgeon, the lady had stains upon her face, but none upon her hand.	また田舎医師の言葉では、妻の方は顔には血がまみれていたが、しかし手には何にもついてはいなかったと云うことであった。
"The absence of the latter means nothing,	「手に何にもついていなくっては、何にもならない、――
though its presence may mean everything,"	もっとももしついていたとすれば、もうそれで何もかも一目瞭然だけれど、――」
said Holmes.	ホームズは云った。
"Unless the powder from a badly fitting cartridge happens to spurt backward, one may fire many shots without leaving a sign.	「しかしもっとも実弾がうまく装填されておれば、何発でも何の痕跡ものこさずに、撃つことも出来ることは出来るのだが、――
I would suggest that Mr. Cubitt's body may now be removed.	さてもう、キューピット氏の死体は、動かしてもよろしいでしょう。
I suppose, Doctor, you have not recovered the bullet which wounded the lady?"	それから先生（ドクトル）、夫人を撃った弾丸は、見つかりましょうか？」
"A serious operation will be necessary before that can be done.	「何しろ非常な大手術をしなければなりませんな。
But there are still four cartridges in the revolver.	しかし実弾は四発ありますから、
Two have been fired and two wounds inflicted, so that each bullet can be accounted for".	二発で二人が撃たれ、弾丸の勘定はよく合いますがな」
"So it would seem,"	「そう思いますか？」
said Holmes.	ホームズは云った。
"Perhaps you can account also for the bullet which has so obviously struck the edge of the window?"	「あなたはあのたしかに、窓の縁を射た弾丸も勘定に入れておられるでしょうな？」
He had turned suddenly, and his long, thin finger was pointing to a hole	彼は突然振り返って、痩せた長い指で一点を指さした。
which had been drilled right through the lower window-sash, about an inch above the bottom.	なるほど、窓の下際から一吋（インチ）ばかり上の処を、見事に貫通した穴があった。
"By George!"	「ああ！」
cried the inspector.	検察官は歎声を上げた。
"How ever did you see that?"	「どうしてあんなものに目が止まったのですか？」
"Because I looked for it."	「いや私は探していたのです」
"Wonderful!"	「これは怖ろしい！」
said the country doctor.	田舎医者は云った。
"You are certainly right, sir.	「いや確に仰せの通りに相違ありません。
Then a third shot has been fired, and therefore a third person must have been present.	それでは、第三弾が発射されてるわけですから、第三者がいなければならないわけですな。
But who could that have been, and how could he have got away?"	しかしそうしたら、どんな者がここに現われて、そしてどうして遁げ出したのでしょう？」
"That is the problem which we are now about to solve,"	「そのことがすなわち、これからの我々の問題ですがね」
said Sherlock Holmes.	シャーロック・ホームズが云った。
"You remember,	「ね――
Inspector Martin, when the servants said that on leaving their room they were at once conscious of a smell of powder, I remarked that the point was an extremely important one?"	検察官のマーティンさん、女中たちは室を出るや否や、火薬の臭がしたと云った時に私はそれはとても重要なことだと云ったでしょう？」
"Yes, sir;	「えい、たしかに仰有いました。
but I confess I did not quite follow you."	しかし私は正直のところ、あまりそれに同感も感じていませんでした」
"It suggested that at the time of the firing, the window as well as the door of the room had been open.	「このことはつまり、発射された時には、室のドアも窓も開いていたのだと云うことを暗示しているのです。
Otherwise the fumes of powder could not have been blown so rapidly through the house.	もしそうでないとしたら、そんなに早く、火薬の臭が家中に、ただよい渡るはずはないからね。
A draught in the room was necessary for that.	それにはどうしても一陣の隙間風を必要とする。
Both door and window were only open for a very short time, however."	ドアも窓も、ほんのちょっとの間開かれたのだ」
"How do you prove that?"	「それはどうして証明なさいますか？」
"Because the candle was not guttered."	「ローソクが傾いてへっていなかったから、――」
"Capital!"	「ああこれは敵（かな）わない！」
cried the inspector.	検察官は叫んだ。
"Capital!	「ああ、大したものだ！」
"Feeling sure that the window had been open at the time of the tragedy, I conceived that there might have been a third person in the affair, who stood outside this opening and fired through it.	「この悲劇の時は、窓は開いていたと云うことを認めてみると、この事件には第三者があって、その開いていた窓を通して、窓の外から射撃したに相違ないと云うことが考えられる。
Any shot directed at this person might hit the sash.	それからその者を撃った弾丸のどれかは窓縁に当ったに相違ない。
I looked, and there, sure enough, was the bullet mark!"	私は見渡したら果して、弾痕があった！」
"But how came the window to be shut and fastened?"	「しかしそうしたとしたら、窓が閉められて、しかも内側からしっかりと締めつけられたのはどう云うわけでしょう？」
"The woman's first instinct would be to shut and fasten the window.	「女と云うものは、本能的に窓を閉めて、しかも締めつけるものではないですかね。
But, halloa!	ああ、おやおや、
What is this?"	――これは何だろう？」
It was a lady's hand-bag which stood upon the study table--	机の上に婦人の手提袋（ハンドバック）があった。
a trim little handbag of crocodile-skin and silver.	気のきいた小さな、鰐皮のものであった。
Holmes opened it and turned the contents out.	ホームズは中のものを取り出した。
There were twenty fifty-pound notes of the Bank of England, held together by an india-rubber band--nothing else.	その中には、英蘭銀行の五十磅（ポンド）紙幣二十枚が、印度ゴムのバンドでしばられて入っていた外（ほか）、あとは何にもなかった。
"This must be preserved, for it will figure in the trial"	「これは法廷で必要だろうから、よく注意して保管しておくように」
said Holmes, as he handed the bag with its contents to the inspector.	ホームズは中味をしっかりと入れて、その手提袋を、検察官に渡しながら云った。
"It is now necessary that we should try to throw some light upon this third bullet,	「さて今度はこの第三弾の正体をつき止めなければならないことになった、
which has clearly, from the splintering of the wood, been fired from inside the room.	――もっともこれは木の裂け具合から見て、明かに内側から発射されたものだが、
I should like to see Mrs. King, the cook, again.	――さて料理女（コック）のキングさんにちょっとききたいが、
You said, Mrs. King, that you were awakened by a LOUD explosion.	あのキングさんあんたは、とても高い爆音に目をさまされたと云ったが、
When you said that, did you mean that it seemed to you to be louder than the second one?"	これは最初の一弾が、次の爆音よりも大きかったと云うことかね？」
"Well, sir,	「はあ、左様でございます。
it wakened me from my sleep, so it is hard to judge.	わたしはその音で、目を醒ましたのでございましたが、どうもはっきりとはいたしませんが、
But it did seem very loud."	とにかく大変大きな音でございました」
"You don't think that it might have been two shots fired almost at the same instant?"	「君は一度に二発うたれたのだと云うようには感ぜられなかったかね？」
"I am sure I couldn't say, sir."	「さあ、それははっきりとは申し上げられないんでございますが――」
"I believe that it was undoubtedly so.	「しかしそれはきっとそうだったろう。
I rather think, Inspector Martin, that we have now exhausted all that this room can teach us.	さて検察官のマーティンさん、もうこの室で調査することは、全く尽きてしまったと思われるが、
If you will kindly step round with me, we shall see what fresh evidence the garden has to offer."	何でしたら今度は庭の方を歩きまわって、新たな証拠をさがそうじゃないかね」
A flower-bed extended up to the study window, and we all broke into an exclamation as we approached it.	書斎の窓の下からずっと、花壇になっていたが、我々はそこに近づいてみて、あっと驚かされてしまった。
The flowers were trampled down, and the soft soil was imprinted all over with footmarks.	花は踏みにじられ、柔かな土の上には、足跡が一ぱいについていた。
Large, masculine feet they were, with peculiarly long, sharp toes.	それは男性の大きな足跡で、特に足先が鋭く長い足のものであった。
Holmes hunted about among the grass and leaves like a retriever after a wounded bird.	ホームズは草や木のあいだを、レトリーバー犬が傷ついた鳥を探すように、探しまわったが、
Then, with a cry of satisfaction, he bent forward and picked up a little brazen cylinder.	遂に彼はひどく喜んだ叫びを上げて、身をこごめて、小さな真鍮（しんちゅう）の円筒を拾い上げた。
"I thought so,"	「僕はたしかに、ピストル又は、薬莢の自動排除装置があって、きっと第三弾があるに相違ないと睨んでいた、――」
said he,	彼は云った。
I really think, Inspector Martin, that our case is almost complete."	「さあ検察官マーティンさん、これでもうほとんど、この事件も調査が出来上ったですな」
The country inspector's face had shown his intense amazement at the rapid and masterful progress of Holmes's investigation.	この田舎検察官はしかし、ホームズのあまりに急速な、あまりにも鮮かな探査振りに、ただ驚歎の色を現わしているのであった。
At first he had shown some disposition to assert his own position, but now he was overcome with admiration, and ready to follow without question wherever Holmes led.	最初の中（うち）は多少は、自分自身の立場も、発揮したいような傾向も見えたが、しかし今はもうとても歯がたたないと観念して、ただホームズの為すままに、唯々諾々として、後からついて来るだけのことになってしまった。
"Whom do you suspect?"	「犯人は誰でしょう？」
he asked.	彼は訊ねた。
"I'll go into that later.	「いやその事はいずれ後にしましょう。
There are several points in this problem which I have not been able to explain to you yet.	実はこの問題には、まだあなたにはっきりと説明しかねることが二三点あるんですがね。
Now that I have got so far, I had best proceed on my own lines,	とにかくここまで来たのですから、僕はこの上もひた押しに押し切った方がいいと思われるのです。
and then clear the whole matter up once and for all."	それから全部を明瞭に発表しましょう」
"Just as you wish, Mr. Holmes, so long as we get our man."	「犯人があがるまでは、ホームズ先生、あなたの御自由におやり下さい」
"I have no desire to make mysteries, but it is impossible at the moment of action to enter into long and complex explanations.	「いや別に秘密主義でゆこうと云う意味でもないのですが、いずれ事件の進行中に、長い込み入った説明をすることは難かしいことですからね。
I have the threads of this affair all in my hand.	まあ僕はこの事件のすべての鍵は持っています。
Even if this lady should never recover consciousness, we can still reconstruct the events of last night and insure that justice be done.	もし夫人が遂に意識を回復しなくっても、この事件は明瞭にすることが出来ますよ。
First of all, I wish to know whether there is any inn in this neighbourhood known as `Elrige's'?"	まず第一に、この近所に、エルライジと云う名前で通っている旅館があるかどうか、確かめたいものだがね」
The servants were cross-questioned, but none of them had heard of such a place.	下僕の者共をよく審問してみたが、しかし誰もそんな旅館を知っているものはなかった。
The stable-boy threw a light upon the matter	その中（うち）に厩番の少年が、この事に対して一条の光明を与えてくれた。
by remembering that a farmer of that name lived some miles off, in the direction of East Ruston.	それはここから東ラストンの方に、ちょっと離れているところに、こう云う名前の農夫のあることを思い出してくれたのであった。
"Is it a lonely farm?"	「そこはとても人里離れた農場かね？」
"Very lonely, sir."	「えい、とても寂しいところです」
"Perhaps	「どうだろう、
they have not heard yet of all that happened here during the night?"	――そこの人達は、まだここの事件について知らないだろうか？」
"Maybe not, sir."	「さあ、たぶんまだきこえてはいないだろうと思いますが、――」
Holmes thought for a little,	ホームズはしばらくの間、
and then a curious smile played over his face.	――静（じ）っと思案していたが、やがて小気味の悪い微笑をうかべた。
"Saddle a horse, my lad,"	「おい若者君、――馬の用意をしてくれたまえ。
"I shall wish you to take a note to Elrige's Farm."	御苦労だがこの書付を、エルライジと云う人の農場に持って行ってもらいたいんだ」
He took from his pocket the various slips of the dancing men.	彼はポケットから、舞踏人のいろいろの紙片（かみきれ）を取り出した。
With these in front of him, he worked for some time at the study-table.	そしてこれを前に並べて、机に向って何かやっていた。
Finally he handed a note to the boy, with directions to put it into the hands of the person to whom it was addressed, and especially to answer no questions of any sort which might be put to him.	そして一枚の書付を少年に渡して、その書付をきっとこの宛名の人に手渡し、またどんな質問をされても、決して答えないようにと云うことを、くれぐれも云い含めた。
I saw the outside of the note, addressed in straggling, irregular characters, very unlike Holmes's usual precise hand.	その封筒の上の文字は、私の目に止まったが、ホームズの簡明な文字とは似も似つかず、苦心して手跡をかえたものであった。
It was consigned to Mr. Abe Slaney, Elriges Farm, East Ruston, Norfolk.	その宛名は、ノーフォーク、東ラストン・エルライジ農場、アベー・スラネー氏と云うのであった。
"I think, Inspector,"	「検察官――」
Holmes remarked,	ホームズは叫んだ。
"that you would do well to telegraph for an escort,	「護衛の者を派遣してもらうよう、打電した方がいいと思いますがね。
as, if my calculations prove to be correct, you may have a particularly dangerous prisoner to convey to the county jail.	もし僕の胸算用に誤りがないとすれば、あなたはとても危険な犯人を護送しなければならないことになるかもしれないと思われますよ。
The boy who takes this note could no doubt forward your telegram.	いやこの書付を持ってゆく子供は、きっとあなたに電報を打たせることになりますよ。
If there is an afternoon train to town, Watson, I think we should do well to take it,	さてワトソン君、もし午後の汽車があるなら、我々はそれに乗った方がよかろう。
as I have a chemical analysis of some interest to finish, and this investigation draws rapidly to a close."	やってしまいたい、面白い化学の分析の仕事もあったし、またこの事件の方はもう、さっさと片づいてしまいそうだから――」
When the youth had been dispatched with the note, Sherlock Holmes gave his instructions to the servants.	その若者が出発してしまってからは、ホームズは今度は、下僕たちに指図した。
If any visitor were to call asking for Mrs. Hilton Cubitt, no information should be given as to her condition, but he was to be shown at once into the drawing-room.	もし夫人を訪ねて来た者があっても、決してその状態を知らせてはならないこと、――そしてその者を早速、応接間に通すこと
He impressed these points upon them with the utmost earnestness.	――こう云うことを彼は、熱心に云い含めた。
Finally he led the way into the drawing-room, with the remark that the business was now out of our hands, and that we must while away the time as best we might until we could see what was in store for us.	それから最後に彼は、もう仕事もなくなったから、いずれまた何か出てくるまで、ブラブラしていようじゃないかね、と云いながら、応接間の方に引き上げて行った。
The doctor had departed to his patients, and only the inspector and myself remained.	田舎医者は、患者のところに出かけたので、もう私と検察官と三人だけになってしまった。
"I think that I can help you to pass an hour in an interesting and profitable manner,"	「さあそれでは、この一時間の間を、最も愉快に、最も有益に過そう」
said Holmes, drawing his chair up to the table, and spreading out in front of him the various papers upon which were recorded the antics of the dancing men.	ホームズはこう云って、テーブルに椅子を引き寄せ、変なおどけたような、舞踏人を書いた紙片（かみきれ）を、その前に拡げた。
"As to you, friend Watson, I owe you every atonement for having allowed your natural curiosity to remain so long unsatisfied.	「いや、わが友人のワトソン君、君には君の持前の好奇心を満足させずに、今まで待たせておいたことの、埋め合せをしなければならないし、
To you, Inspector, the whole incident may appeal as a remarkable professional study.	それから検察官、あなたにはこの事件の一切は、最も刮目（かつもく）すべき職業上の研究問題として現われるでしょう。
I must tell you, first of all, the interesting circumstances connected with the previous consultations which Mr. Hilton Cubitt has had with me in Baker Street."	それでまず第一にあなたにヒルトン・キューピット氏が、ベーカー街で私に相談に来られた事情についてお話しなければならない」
He then shortly recapitulated the facts which have already been recorded.	彼は簡単に要領よく、前に述べたようなことを概略して話すのであった。
"I have here in front of me these singular productions,	「ここにこう云う全く奇妙なものがありますがね。
at which one might smile, had they not proved themselves to be the forerunners of so terrible a tragedy.	まあ誰が見たって、これがあんな恐ろしい悲劇の、先駆であったと云ったら、まず一笑に附してしまいたくなりますがね。
I am fairly familiar with all forms of secret writings, and am myself the author of a trifling monograph upon the subject, in which I analyze one hundred and sixty separate ciphers, but I confess that this is entirely new to me.	私は元来、暗号記号については、いささか自信があって、それについてはつまらない論文もありますが、その中で私は、百六十種の暗号を解析してみましたが、しかしこれはまた、私にとっても全く最初のものでした。
The object of those who invented the system has apparently been to conceal that these characters convey a message, and to give the idea that they are the mere random sketches of children.	この暗号を案出したものの考えでは、これに意味があるなどと云うことは巧みに隠して、ただ子供たちを、気まぐれにスケッチしたものだと思わせるつもりなのだがね。
"Having once recognized, however, that the symbols stood for letters, and having applied the rules which guide us in all forms of secret writings, the solution was easy enough.	しかし、これも結局文字の代用であるとわかって、それからあらゆる暗号文字の解釈に適用する法則をあてはめたところ、この解釈も容易でした。
The first message submitted to me was so short that it was impossible for me to do more than to say, with some confidence, that the symbol XXX stood for E.	最初に私の手に入ったものは、ごく短いものだったので、この記号はアルファベットのＥを表わすものだと云うことを、云い切られただけでした。
As you are aware, E is the most common letter in the English alphabet, and it predominates to so marked an extent that even in a short sentence one would expect to find it most often.	御存じの通り英語のアルファベットの中では、Ｅは最も普通の文字で、どんな短い文章のなかでも、一番出て来る文字ですからな。
Out of fifteen symbols in the first message, four were the same, so it was reasonable to set this down as E.	この最初手に入った文章の中では、十五の記号の中で、これは四つだけあって、一番多かったので、これをＥと帰納したわけです。
It is true that in some cases the figure was bearing a flag, and in some cases not, but it was probable, from the way in which the flags were distributed, that they were used to break the sentence up into words.	それから記号もある時は旗を持ち、ある場合は持っていないが、段々考えたらこの旗は、文章を言葉に区切るためのものでした。
I accepted this as a hypothesis, and noted that E was represented by XXX.	私はこれを仮説として立ててをＥと置いたのです。
"But now came the real difficulty of the inquiry.	しかしここまではいいとして、これから先がなかなか大変なのです。
The order of the English letters after E is by no means well marked,	英語の文字では、Ｅの後に来るものは、決してそう決定的ではない。
and any preponderance which may be shown in an average of a printed sheet may be reversed in a single short sentence.	ちょっとした文章などで平均を取ってみたら、あるいは反対の現象を現わしているかもしれない。
Speaking roughly, T, A, O, I, N, S, H, R, D, and L are the numerical order in which letters occur, but T, A, O, and I are very nearly abreast of each other,	まあ大ざっぱに云ってみて、Ｔ、Ａ、Ｏ、Ｉ、Ｎ、Ｓ、Ｈ、Ｒ、Ｄ、Ｌ、――と云うのは、その頻出数の順序であるが、しかし、Ｔ、Ａ、Ｏ、Ｉなどは、実に伯仲しているからね。
and it would be an endless task to try each combination until a meaning was arrived at.	これ等の結合を考えて、意味を見出そうと云うことは、それは全く際限の無い仕事になる。
I therefore waited for fresh material.	それで私は、新たな材料の来るのを待った。
In my second interview with Mr. Hilton Cubitt he was able to give me two other short sentences and one message, which appeared--since there was no flag--to be a single word.	第二回のヒルトン・キューピット氏との会見では、私は二つの短い文章と、一つの牒号（メッセージ）を提供されたが、この牒号（メッセージ）には旗が無いので、単語に相違ないと思った。
Here are the symbols.	これがそれですがね。
Now, in the single word I have already got the two E's coming second and fourth in a word of five letters.	さて単語としてみると、これは五文字から成る単語で、しかも私が先に推定したＥが、第二と第四にあるもの。
It might be `sever,' or `lever,' or `never.'	――それは SEVER（切り放す）か、LEVER（梃子（てこ））か、NEVER（けっして、―打ち消しの）などとなる。
There can be no question that the latter as a reply to an appeal is far the most probable,	哀願に対する返事としては、この最後のものはもう異論なく、最も適当である。
and the circumstances pointed to its being a reply written by the lady.	そしておそらくはこれは、夫人の書いた返事であろうと思われる点も大いにあるのだ。
Accepting it as correct, we are now able to say that the symbols stand respectively for N, V, and R.	これだけのことを認容してみると、もう記号のはそれぞれ、Ｎ、Ｖ、Ｒ、と云うことになる。
"Even now I was in considerable difficulty, but a happy thought put me in possession of several other letters.	しかしまだまだ私には、難関があるのであったが、幸いに他の文字の解釈に、都合のよい思いつきが浮んだ。
It occurred to me that if these appeals came, as I expected, from someone who had been intimate with the lady in her early life, a combination which contained two E's with three letters between might very well stand for the name `ELSIE.'	つまりもし私の予想が違わないとすれば、この哀訴が夫人の以前の腹心の者から来たものとすれば、両端にＥがあって、真中に他の三文字のあるものは、結局、ELSIE と云う名前に、ぴったりと吻合（ふんごう）して来る。
On examination I found that such a combination formed the termination of the message which was three times repeated.	それで更によく調べてみると、三度とも文章の末尾が、この組合せで終っているのを発見した。
It was certainly some appeal to `Elsie.'	それでこれは ELSIE に、何か訴えて来たものに相違ない。
In this way I had got my L, S, and I.	こうして私はＬと、Ｓと、Ｉを得た。
But what appeal could it be?	しからば一たい何を訴えて来ているのであろう？
There were only four letters in the word which preceded `Elsie,' and it ended in E.	この ELSIE の前には、四文字あって、しかも終りはＥである。
Surely the word must be `COME.'	これは確に COME であろうか、
I tried all other four letters ending in E, but could find none to fit the case.	――私は外（ほか）にも、Ｅで終っている、四文字の単語を考えたが、しかしどうもこの場合に適当と思われるものは見当らなかった。
So now I was in possession of C, O, and M, and I was in a position to attack the first message once more, dividing it into words and putting dots for each symbol which was still unknown.	それで私はこうして、Ｃ、Ｏ、Ｍ、を得たので、今度は再び最初の文章にもどって、これを言葉に分けて、未発見の記号と共に、書き並べるまでになった。
So treated, it worked out in this fashion:	そうしたら、次のようなものとなった。
"Now the first letter CAN only be A, which is a most useful discovery,	そこで、この中で最初の文字はＡに相違ない、と云うことを推定した。
since it occurs no fewer than three times in this short sentence,	と云うのは、この短い文章の中で、三度も出ているから、このよく出て来る文字はＡに相違ないと考えた。
and the H is also apparent in the second word.	そこで、第二の場所は、Ｈであろうと想定してみた。
Now it becomes:	そうしてまたあてはめてみると、
AM HERE A.E SLANE.	AM HERE A. ESLANE.となり、
Or, filling in the obvious vacancies in the name:	また、名前の解りきった空所を満たしてみると、
I had so many letters now that I could proceed with considerable confidence to the second message,	私はもうかなりの文字を得たので、今度は相当の自信を持って、第二の文章に進むことが出来ることとなった。
which worked out in this fashion:	それをやってみると今度はこんなものになった。
Here I could only make sense by putting T and G for the missing letters,	さてこうなると、私は、Ｔと、Ｇを空所に入れると、やっと意味をなして来ることに気がついた
and supposing that the name was that of some house or inn at which the writer was staying."	――そしてこれはこの筆者のいる家か、旅館の名であろうと推定したわけだ」
Inspector Martin and I had listened with the utmost interest to the full and clear account of how my friend had produced results which had led to so complete a command over our difficulties.	検察官マーティンと私は、この我々の面前の難事業を、快刀で乱麻を断つように、明快に解決を与えた、私の友人の説明に、全く魅了されて傾聴した。
"What did you do then, sir?"	「先生、それからどうなされたのですか？」
asked the inspector.	検察官は訊ねた。
"I had every reason to suppose that this Abe Slaney was an American,	「私は種々の理由から、この Abe Slaney. と云うのは、亜米利加（アメリカ）人であろうと推定したのです。
since Abe is an American contraction, and since a letter from America had been the starting-point of all the trouble.	この Abe と云うのは元来、亜米利加（アメリカ）式の綴（つづり）にあるし、それに亜米利加（アメリカ）から来た、一通の手紙と云うのが、今回の大事件の端緒でしたからな。
I had also every cause to think that there was some criminal secret in the matter.	それに更に私は、この事件には、更にその中に伏在した、隠れたる犯罪があるに相違ないと睨む理由があったのです。
The lady's allusions to her past, and her refusal to take her husband into her confidence, both pointed in that direction.	つまり夫人が過去について、ちょっと仄めかしたあと、夫に対して絶対にそれを追求させなかったなどと云うことは、明かにそうした理由を暗示しているものだからね。
I therefore cabled to my friend, Wilson Hargreave, of the New York Police Bureau,	それで私は、私の友人でニューヨークの警務局の、ウィルソン・ハーグレーブに、海底電信を打ってやったのです。
who has more than once made use of my knowledge of London crime.	この男はたびたび、私からお蔭を蒙（こうむ）っているものですがね、
I asked him whether the name of Abe Slaney was known to him.	で私はこの男に、Abe Slaney と云う者を知っているかどうかと云ってやったのだが、
Here is his reply:	その返電はこうだったのです。
`The most dangerous crook in Chicago.'	「市俄古（シカゴ）での最も恐るべき悪漢」
On the very evening upon which I had his answer, Hilton Cubitt sent me the last message from Slaney.	するとちょうど私が、この返電を得た夜、ヒルトン・キューピットは、スラネーからの最後の牒号（メッセージ）を送ってよこしたのです。
Working with known letters, it took this form:	それにまた、先の文字をあてはめてみると、
The addition of a P and a D completed a message	それでこれにＰとＤを加えてみると、もうこの牒号（メッセージ）の意味は完全なものとなる。
（ELSIE PREPARE TO MEET THY GOD.	エルシーよ、汝の神に逢う用意をしろ）
which showed me that the rascal was proceeding from persuasion to threats, and my knowledge of the crooks of Chicago prepared me to find that he might very rapidly put his words into action.	これによると、悪漢は説得から威嚇に進んだことがわかり、更に私はこの者の市俄古（シカゴ）での兇悪振りを知っているだけに、もうすぐに実行するだろうと直覚した。
I at once came to Norfolk with my friend and colleague, Dr. Watson, but, unhappily, only in time to find that the worst had already occurred."	それで取るものも取りあえず、友人であり相棒である、ワトソン博士と共に、ノーフォークに駈けつけたのだが、もう時既に遅かった」
"It is a privilege to be associated with you in the handling of a case,"	「事件を扱うに際して、あなたと協力することが出来るなどと云うことは全く、望外の特権ですね」
said the inspector, warmly.	検察官は静かに云い出した。
"You will excuse me, however, if I speak frankly to you.	「失礼して卒直に申しますが、あなたはあなた御自身が御満足なさればおよろしいのですが、
You are only answerable to yourself, but I have to answer to my superiors.	私は上官に対して、私の職責を全うしなければなりません。
If this Abe Slaney, living at Elrige's, is indeed the murderer, and if he has made his escape while I am seated here, I should certainly get into serious trouble."	それでもしそのエルライジにいる、アベイ・スラネーなる者が、本当に下手人であるとすれば、私がこうしている中に、逃亡でもしてしまうと、とても大問題になりますが、――」
"You need not be uneasy.	「いや御心配はいらない、――
He will not try to escape."	彼は逃亡などはおそらくしないから、――」
"How do you know?"	「どうしてそう仰有います？」
"To fly would be a confession of guilt."	「逃亡することはもう、犯罪を自白していることだからね」
"Then let us go arrest him."	「それでは逮捕に向おうではございませんか？」
"I expect him here every instant."	「いや、もうじきにここに来る」
"But why should he come."	「ではどうしてここになぞ来るのでしょう？」
"Because I have written and asked him."	「さっき手紙を書いて、招んでやったから、――」
"But this is incredible, Mr. Holmes!	「いやホームズ先生、それはちょっと当（あて）にはなりますまい。
Why should he come because you have asked him?	あなたがお招びになったって、その者は来ると云うわけはございますまい。
Would not such a request rather rouse his suspicions and cause him to fly?"	それどころかかえって、感づいて逃亡することになりはしませんでしょうか？」
"I think I have known how to frame the letter,"	「いや私も、その手紙のこしらえ方は知っているつもりだがね」
said Sherlock Holmes.	シャーロック・ホームズは云った。
"In fact,	「論より証拠
if I am not very much mistaken,	――大体間違いはなさそうですよ。
here is the gentleman himself coming up the drive."	ほら、その紳士御自身で、御出張になったよ」
A man was striding up the path which led to the door.	一人の男が玄関の方に、大股に歩いて来るのであった。
He was a tall, handsome, swarthy fellow, clad in a suit of gray flannel, with a Panama hat, a bristling black beard, and a great, aggressive hooked nose, and flourishing a cane as he walked.	その男は、背の高い、男振りのよい、色の浅黒い顔で、灰色のフランネルの着物を着てパナマの帽子を冠り、剛（こわ）い黒い髭をはやし、高い圧倒的な鼻をうごめかして、籐の杖をふりまわしながらやって来た。
He swaggered up a path as if as if the place belonged to him, and we heard his loud, confident peal at the bell.	彼は全く意気揚々として、小径をはばむようにして歩き、堂々と呼鈴（ベル）を押すのであった。
"I think, gentlemen,"	「諸君、――」
said Holmes, quietly,	ホームズは静かに云った。
"that we had best take up our position behind the door.	「これは我々はドアの蔭にかくれた方がいいようだよ。
Every precaution is necessary when dealing with such a fellow.	あんな奴の相手になるには、うっかりしたことは出来ないからね。
You will need your handcuffs, Inspector.	それから検察官、手錠が入りますよ。
You can leave the talking to me."	さあ黙って、――」
We waited in silence for a minute	一分間ほどの間
--one of those minutes which one can never forget.	――我々は息を殺して待った。
Then the door opened and the man stepped in.	忘れようとしても、決して忘れることの出来ない一分間であった。
In an instant Holmes clapped a pistol to his head,	やがてドアは開いて、その男は中に入って来た。
and Martin slipped the handcuffs over his wrists.	と、――思う中（うち）に、ホームズはピストルをその男の頭に狙いつけ、マーティンは素早く、手錠をはめてしまった。
It was all done so swiftly and deftly that the fellow was helpless before he knew that he was attacked.	こうしたことが、全く疾風迅雷的にやられたので、流石の悪漢もただ茫然として、何もかもすんでからやっと、自分が待ち伏せをくったのだとわかった。
He glared from one to the other of us with a pair of blazing black eyes.	その男は私達を、次から次と、その黒い鋭い目で睨みつけた。
Then he burst into a bitter laugh.	そして最後に、ゲラゲラと苦しい笑い声を上げた。
"Well, gentlemen, you have the drop on me this time.	「いや各々方、なかなかうまく、仕組んだと云うわけですか、
I seem to have knocked up against something hard.	――これはとんだ災難に遭ったものだ。
But I came here in answer to a letter from Mrs. Hilton Cubitt.	しかし僕はヒルトン・キューピット夫人の手紙に答えるために来たのです。
Don't tell me that she is in this?	夫人はここに居るかどうか、教えてくれないですか？
Don't tell me that she helped to set a trap for me?"	夫人は僕を陥れることに与（あず）ったのですか？」
"Mrs. Hilton Cubitt was seriously injured, and is at death's door."	「ヒルトン・キューピット夫人は、瀕死の重傷を負うているのだよ」
The man gave a hoarse cry of grief, which rang through the house.	その男は嗄（しわが）れた声で、家中に響き渡るように、悲叫（ひきょう）を上げた。
"You're crazy!"	「あなた方は気が違っているのだ！」
he cried, fiercely.	その男は激しく叫んだ。
"It was he that was hurt, not she.	「負傷したのはヒルトン・キューピットで、彼の女のはずはない。
Who would have hurt little Elsie?	誰があの可愛いエルシーなどを傷つけるものか！
I may have threatened her--God forgive me!	私は彼の女を威かしはしたかもしれないが、それは神様もお許し下さろう。
--but I would not have touched a hair of her pretty head.	――しかし私は彼の女の美しい頭の、髪の毛一本にさえも触れはしないのだ。
Take it back--you!	さあそれを取り消しなさい。
Say that she is not hurt!"	彼の女は決して負傷しないと云って下さい！」
"She was found badly wounded, by the side of her dead husband."	「彼の女は死んだ夫の側（そば）に、ひどく怪我をしているのを発見されたのだ」
He sank with a deep groan on the settee and buried his face in his manacled hands.	彼は深い呻吟声（うめきごえ）を上げながら、腕椅子に崩れるように腰かけて、手錠のかかった両手で顔を蔽うた。
For five minutes he was silent.	五分くらいの間は、全く黙りこんでいたが、
Then he raised his face once more, and spoke with the cold composure of despair.	それからまた顔を起して、今度はもう捨鉢の度胸で、冷静に語り出した。
"I have nothing to hide from you, gentlemen,"	「いや、皆さん、決して何も隠し立てはしません」
said he.	彼は言葉をつづけた。
"If I shot the man he had his shot at me,	「もし私が彼を撃ったと云うなら、彼もまた私を撃っているのです。
and there's no murder in that.	ここに殺人罪はありません。
But if you think I could have hurt that woman, then you don't know either me or her.	またもしあなた方が、私があの女を撃ったのだとお思いになるなら、それはあなた方が、私とあの女とをよく知らないからです。
I tell you, there was never a man in this world loved a woman more than I loved her.	私は断言して憚（はばか）りませんが、私はいかなる男性の愛情よりも、彼の女を深く愛していました。
I had a right to her.	私は彼の女に対しては、権利を持っています。
She was pledged to me years ago.	私達は数年前に、それぞれ誓った間柄です。
Who was this Englishman that he should come between us?	それだのに我々の間に入って来た英国人などは、全くどこの馬の骨でしょう？
I tell you that I had the first right to her, and that I was only claiming my own.	私は断言しますが、私こそは彼の女に対して、第一の優先権を持っている者で、ただ私はその正統の権利を要求しただけです」
"She broke away from your influence when she found the man that you are,"	「夫人は君のそう云う人となりを知ったので、君の把握から遁げ出したのだ」
said Holmes, sternly.	ホームズは厳しく云った。
"She fled from America to avoid you, and she married an honourable gentleman in England.	「夫人は君を避けるために亜米利加（アメリカ）から遁げ出して、英国の立派な紳士と結婚したのだ。
You dogged her and followed her and made her life a misery to her, in order to induce her to abandon the husband whom she loved and respected in order to fly with you, whom she feared and hated.	それに君は未練がましくも追かけて来て、彼の女にその敬愛する夫を捨てて、憎悪し恐怖している君と、遁げ出すことを強迫したので、彼の女は、不幸極まるものになってしまったのだ。
You have ended by bringing about the death of a noble man and driving his wife to suicide.	君も一人の貴人を殺し、しかしてその妻を自殺させて、もうそれで万事休矣（ばんじきゅうす）というものさ。
That is your record in this business, Mr. Abe Slaney, and you will answer for it to the law."	君のお手柄の一切はこれだけだが、さてアベー・スラネー君、この上はただ法の適用を受けるだけさ」
"If Elsie dies, I care nothing what becomes of me,"	「もしエルシーが死ぬなら、そりゃもうこの身体などは、どうなったっておかまいなしだ」
said the American.	その亜米利加（アメリカ）人は云った。
He opened one of his hands, and looked at a note crumpled up in his palm.	そして彼は片方の掌（てのひら）に、皺くしゃになっていた書ものに見入った。
"See here, mister!	「これを御覧下さい」
he cried, with a gleam of suspicion in his eyes,	彼は目を疑い深く閃かせながら叫ぶのであった。
"you're not trying to scare me over this, are you?	「あなた方は私をおどかしているのではないでしょうね？
If the lady is hurt as bad as you say, who was it that wrote this note?"	もし彼の女があなた方の仰せのように非常に重態であるとしたら、一たい誰がこの手紙をかいたのでしょう？」
He tossed it forward on to the table.	彼はその紙片をテーブルの上に投げてよこした。
"I wrote it, to bring you here."	「君をここに来させるために、僕が書いたのだ」
"You wrote it?	「あなたが書きましたって？
There was no one on earth outside the Joint who knew the secret of the dancing men.	この世界中でわれわれの仲間の外（ほか）は、誰もこの舞踏人の秘密を解るものが無いのですよ。
How came you to write it?"	どうしてあなたなどが書けるものですか？」
"What one man can invent another can discover,"	「君、誰かが案出したものとすれば、また誰かがそれを解くことが出来るさ」
said Holmes.	ホームズは云った。
There is a cab coming to convey you to Norwich, Mr. Slaney.	「さてスラネー君、君をノーアウッドに、連れてゆく馬車が来た。
But meanwhile, you have time to make some small reparation for the injury you have wrought.	しかしまだ、君の悪業に対して、多少の罪滅しをする時間はある。
Are you aware	君は気がついているかどうか、
that Mrs. Hilton Cubitt has herself lain under grave suspicion of the murder of her husband, and that it was only my presence here, and the knowledge which I happened to possess, which has saved her from the accusation?	――実はヒルトン・キューピット夫人は、夫君（ふくん）の殺害に対して、非常に重大な嫌疑を受けていたのだが、幸いに僕が現われて、たまたま持ち合せていた智識で、夫人は告発されることを免れることとなったのだ。
The least that you owe her is to make it clear to the whole world that she was in no way, directly or indirectly, responsible for his tragic end."	それで君の夫人に対する、最後の償（つぐない）として、夫人はこの大悲惨事に対しては、直接にも間接にも、全然責任はないものであると云うことを、全世界に明瞭にしたまえ」
"I ask nothing better,"	「もうどうにでもなるがよい」
said the American.	亜米利加（アメリカ）人は云った。
"I guess the very best case I can make for myself is the absolute naked truth."	「えい一そのこと、何もかも有りのままにさらけ出してしまいましょう」
"It is my duty to warn you that it will be used against you,"	「そうだ。
cried the inspector, with the magnificent fair play of the British criminal law.	検察官はあたかも英国刑法の、厳粛な公明を示すものの如く云った。
Slaney shrugged his shoulders.	スラネーは肩をすくめた。
"I'll chance that,"	「早速申し上げましょう」
said he.	彼は語り出した。
"First of all, I want you gentlemen to understand that I have known this lady since she was a child.	「まず第一に皆さんの御了解を得たいことは、私はあの夫人とは、ごく小供の時からの知り合いであると云うことです。
There were seven of us in a gang in Chicago, and Elsie's father was the boss of the Joint.	私共も七人の仲間で市俄古（シカゴ）で徒党を組んでいたのですが、あのエルシーの父はその首領でした。
He was a clever man, was old Patrick.	悧※［＃「りっしんべん＋巧」、126-1］な人で、パトリック老人と云ったものです。
It was he who invented that writing, which would pass as a child's scrawl unless you just happened to have the key to it.	この暗号を案出したのも彼ですが、これはもうあなたがこれを解く鍵を持っていなかったら、ただ小供のいたずら書としか思われないものですからね。
Well, Elsie learned some of our ways, but she couldn't stand the business, and she had a bit of honest money of her own,	さて、あのエルシーは私共のすることを多少気がついたのですが、しかし彼の女は、こうした仕事を見ることはもう堪えられなかったのですな。
so she gave us all the slip and got away to London.	そして彼の女は自分の、これは公明正大な金を多少持っていたので、私達の中から抜け出して、ロンドンに遁げて来てしまったのです。
She had been engaged to me, and she would have married me, I believe, if I had taken over another profession,	私は彼の女とは婚約の仲でしたが、これは私は今でもそう思っているのですが、もし私が商売替えをしたら、彼の女はきっと私と結婚してくれたに相違ありませんでした。
but she would have nothing to do with anything on the cross.	彼の女はかりそめにも不正なことに対しては、掛り合いを持ちたくなかったのでしょう。
It was only after her marriage to this Englishman that I was able to find out where she was.	そして私がやっと彼の女の居所をつきとめた時は、彼の女はもうこの英国人と結婚していました。
I wrote to her, but got no answer.	それで私は手紙を出しましたが、しかし返事はくれませんでした。
After that I came over, and, as letters were no use, I put my messages where she could read them.	私はそれでこっちに海を越えて来たのですが、手紙はもう何の役にも立たないので私は、あの通牒を彼の女の目の止まるところに置いたのでした。
"Well, I have been here a month now.	そしてとにかく私がここに来てから一ヶ月になります。
wI lived in that farm, where I had a room down below, and could get in and out every night,	あの農場に住んで、地下の一室を持って、夜間は毎夜のように、自由に出入が出来ました。
and no one the wiser.	しかし誰もそのことは知りませんでした。
I tried all I could to coax Elsie away.	私はあらゆる手段をつくして、エルシーを誘い出そうとしました。
I knew that she read the messages, for once she wrote an answer under one of them.	彼の女はたしかに、通牒は読んだに相違なく、遂に一度だけは返事をくれました。
Then my temper got the better of me, and I began to threaten her.	それに私は少し気をよくして、彼の女の脅迫を始めたのです。
She sent me a letter then, imploring me to go away,	それから彼の女は一本の手紙をよこして、私に立ち去ってくれるようにと、懇願して来ました。
and saying that it would break her heart if any scandal should come upon her husband.	そしてもし夫の身辺に、その名誉を汚すようなことでも起ったら、もう彼の女は立っても寝てもいられないからと云うのでした。
She said that she would come down when her husband was asleep at three in the morning, and speak with me through the end window, if I would go away afterwards and leave her in peace.	そして、もし私が素直にここを立ち去って、彼の女を安穏にのこして行ってくれるなら、夫の眠っているのを見計らって、
She came down and brought money with her, trying to bribe me to go.	暁（あ）け方の三時に起きて来て、私に立ち退くように説得するために、金を持って来ました。
This made me mad, and I caught her arm and tried to pull her through the window.	私はこれを見て、嚇（かっ）としてしまって、彼の女の腕を取って、窓から引ずり落そうとしたのです。
At that moment in rushed the husband with his revolver in his hand.	と、――その瞬間に、彼の女の夫は、ピストルを手にして、飛び出して来ました。
Elsie had sunk down upon the floor, and we were face to face.	エルシーは床の上に跼まってしまったので、私たちは顔と顔とを向き合せていました。
I was heeled also,	私も身体をこごめました。
and I held up my gun to scare him off and let me get away.	そして鉄砲を取り出して、彼を脅かして自分も遁げようとしました。
He fired and missed me.	しかし彼は発射し、しかも弾丸は外れました。
I pulled off almost at the same instant,	それで私もほとんどおくれずに引き金を引きました。
and down he dropped.	彼は斃れたのです。
I made away across the garden, and as I went I heard the window shut behind me.	私はそれから庭を横切って遁げましたが、私の後から窓を閉める音がきこえたのでした。
That's God's truth, gentlemen, every word of it,	皆さんこれは、すべて有りのままで、神明に誓って偽りはありません。
and I heard no more about it until that lad came riding up with a note which made me walk in here, like a jay, and give myself into your hands."	そして私は、その後は、あの若者がこの手紙を持って来て、私が、まるでむくどりのように、あなた方の網にかかってしまうまでは、何にも知りませんでした」
A cab had driven up whilst the American had been talking.	亜米利加（アメリカ）人が話している中に、馬車は着いていた。
Two uniformed policemen sat inside.	その中には制服の巡査が二人いた。
Inspector Martin rose and touched his prisoner on the shoulder.	検察官マーテンは起ち上って、犯人の肩に手をかけた。
"It is time for us to go."	「さあ行こう、――」
"Can I see her first?"	「ちょっと彼の女に逢わせて下さいませんでしょうか？」
"No, she is not conscious.	「いや、夫人はまだ意識が回復しないのだ。
Mr. Sherlock Holmes,	シャーロック・ホームズ先生、
I only hope that if ever again I have an important case, I shall have the good fortune to have you by my side."	――何卒この後も重大事件が突発した時は、よろしく御助力下さいますよう、幾重にもお願い申します」
We stood at the window and watched the cab drive away.	私たちは窓際に立って、馬車の遠ざかってゆくのを眺めた。
As I turned back, my eye caught the pellet of paper which the prisoner had tossed upon the table.	それから私は振り返った途端に犯人がテーブルの上に投げて行った、紙片を丸めたものを見つけた。
It was the note with which Holmes had decoyed him.	それはホームズが彼をおびき寄せた手紙であった。
"See if you can read it,	「さあ、君、これを読めるかね？
Watson,"	ワトソン君、――」
said he, with a smile.	ホームズは笑いながら云った。
It contained no word, but this little line of dancing men:	それは一語もなく、ただ次のような舞踏人の短い一行であった。
"If you use the code which I have explained,"	「いや、僕が使った、暗号表を用いれば、これはもうごく簡単なものだとわかるよ」
said Holmes,	ホームズは云った。
I was convinced that it was an invitation which he would not refuse,	「これは、"COME HERE AT ONCE"（すぐに来い）と云うだけのことだよ、いくら何でもこの招待状では、彼は万障を繰合せても来ると思ったのさ。
since he could never imagine that it could come from anyone but the lady.	何しろこうしたものを書ける者は、夫人以外には無いのだと彼は信じているのだからね。
And so, my dear Watson, we have ended by turning the dancing men to good when they have so often been the agents of evil, and I think that I have fulfilled my promise of giving you something unusual for your notebook.	さてこうして、親愛なワトソン君、我々もこの悪業の手先に使われていた舞踏人を、今度は善い意味のものに転化してしまったし、また僕も君の覚書の中に、一つはなはだ特異な件をお土産にしようと云う約束も、これでともかく果したわけだ。
Three-forty is our train, and I fancy we should be back in Baker Street for dinner."	三時四十分の汽車があるが、我々はベーカー街に行って、夕食でも食べるとしようか、――」
Only one word of epilogue.	簡単に結末だけを。
The American, Abe Slaney, was condemned to death at the winter assizes at Norwich, but his penalty was changed to penal servitude in consideration of mitigating circumstances, and the certainty that Hilton Cubitt had fired the first shot.	この亜米利加（アメリカ）人のアベー・スラネーは、ノーアウィッチの冬期巡回裁判で、死刑を宣告されたのであったが、しかしヒルトン・キューピット氏が、最初に発射したと云うことが明瞭になったので情状酌量して、死刑を改めて懲役刑とされた。
Of Mrs. Hilton Cubitt I only know that I have heard she recovered entirely, and that she still remains a widow, devoting her whole life to the care of the poor and to the administration of her husband's estate.	それからヒルトン・キューピット夫人については、その後負傷はすっかり癒り、寡婦として一貫し、その生涯を救貧事業と、亡夫の遺産管理に専念していると云うことをきいただけである。
