THE DEAD	死者たち
LILY, the caretaker's daughter, was literally run off her feet.	管理人の娘、リリーは文字通りてんてこ舞いだった。
Hardly had she brought one gentleman into the little pantry behind the office on the ground floor and helped him off with his overcoat than the wheezy hall-door bell clanged again and she had to scamper along the bare hallway to let in another guest.	紳士を一人、一階の事務所の裏の小さな食器室に案内して彼がコートを脱ぐのを手伝ったばっかりだのに、また玄関のゼーゼー言ってるベルががらんと鳴って、彼女は別の客を通すために玄関ホールのむき出しの通路を急いで駆けなければならなかった。
It was well for her she had not to attend to the ladies also.	ラッキーなことに彼女はご婦人たちの世話まで見る必要はなかった。
But Miss Kate and Miss Julia had thought of that and had converted the bathroom upstairs into a ladies' dressing-room.	でもミス・ケイトとミス・ジュリアはそのことを考えて、二階のバスルームをご婦人たちの化粧室に変えたのだった。
Miss Kate and Miss Julia were there, gossiping and laughing and fussing, walking after each other to the head of the stairs, peering down over the banisters and calling down to Lily to ask her who had come.	ミス・ケイトとミス・ジュリアはその辺にいて、噂話をしたり笑ったり空騒ぎをしたり、かわるがわる階段の上まで歩いてきては、手すり越しに下をじっと見て誰が来たのと訊くために下のリリーに呼びかけたりしていた。
It was always a great affair, the Misses Morkan's annual dance.	いつも大事件だった、年に一度のモーカン三嬢の舞踏会は。
Everybody who knew them came to it, members of the family, old friends of the family, the members of Julia's choir, any of Kate's pupils that were grown up enough, and even some of Mary Jane's pupils too.	一族の一員、家族の旧友、ジュリアの聖歌隊の一員、すっかり成長したケイトの生徒たち、メアリー・ジェーンの生徒さえもまた幾人か、と、彼らを知る者は皆やってきた。
Never once had it fallen flat.	一度としてまったくの期待はずれに終わったことはなかった。
For years and years it had gone off in splendid style, as long as anyone could remember;	毎年毎年、思い出せる限りの長い間、それは華麗なスタイルで行われてきた。
ever since Kate and Julia, after the death of their brother Pat, had left the house in Stoney Batter and taken Mary Jane, their only niece, to live with them in the dark, gaunt house on Usher's Island, the upper part of which they had rented from Mr. Fulham, the corn-factor on the ground floor.	ケイトとジュリアが兄のパットが死んだ後、家をストーニー・バターに残し、ただ一人の姪、メアリー・ジェーンを連れ、一階で穀物問屋を営むフルハム氏から上階の部分を借りてアシャーズ・アイランドの暗く寂しい家に暮らすようになって以来だ。
That was a good thirty years ago if it was a day.	それはどうしたって優に三十年は前のことだ。
Mary Jane, who was then a little girl in short clothes, was now the main prop of the household, for she had the organ in Haddington Road.	あの頃短い服を着た小さな少女だったメアリー・ジェーンが今では家族の大黒柱として、ハディントン・ロードのオルガンを受け持っていた。
She had been through the Academy and gave a pupils' concert every year in the upper room of the Antient Concert Rooms.	彼女はアカデミーを修了し、毎年生徒のコンサートをアンシェント・コンサート・ルームスの上階の部屋で催していた。
Many of her pupils belonged to the better-class families on the Kingstown and Dalkey line.	彼女の生徒の多くはキングスタウンとダルキー沿線の上流階級の家庭に属していた。
Old as they were, her aunts also did their share.	老いたりとはいえ、叔母たちもまた役割を果たした。
Julia, though she was quite grey, was still the leading soprano in Adam and Eve's, and Kate, being too feeble to go about much, gave music lessons to beginners on the old square piano in the back room.	ジュリアは、すっかり白髪になったがいまだにアダムアンドイヴズでは第一ソプラノであり、ケイトは、体が弱くなってあまりがんばれなかったが奥の部屋の古いスクエアピアノで初心者に音楽を教えていた。
Lily, the caretaker's daughter, did housemaid's work for them.	管理人の娘、リリーは彼らのために家政婦の務めを果たしていた。
Though their life was modest, they believed in eating well;	彼らの暮らしは質素だったけれども、彼らは美食を信条としていた。
the best of everything:	何でも最上の物。
diamond-bone sirloins, three-shilling tea and the best bottled stout.	極上の骨付きサーロイン、三シリングの茶、そして最高の瓶詰めのスタウト。
But Lily seldom made a mistake in the orders, so that she got on well with her three mistresses.	しかしリリーはめったに指図を間違えることはないので、三人の女主人たちとうまくいっていた。
They were fussy, that was all.	彼らは小うるさい、それだけだった。
But the only thing they would not stand was back answers.	でも唯一つ、彼らが我慢できないのは口答えだった。
Of course, they had good reason to be fussy on such a night.	もちろん、彼らがこんな夜に小うるさくするのはちゃんとわけがあった。
And then it was long after ten o'clock and yet there was no sign of Gabriel and his wife.	そのうえ十時をだいぶ過ぎたのに、まだゲイブリエルと彼の妻の来る兆しがなかった。
Besides they were dreadfully afraid that Freddy Malins might turn up screwed.	それにまた彼らはフレディ・マリンズが酔っ払って現れるのではないかとものすごく心配していた。
They would not wish for worlds that any of Mary Jane's pupils should see him under the influence;	彼らは絶対にメアリー・ジェーンの生徒たちにご機嫌の彼を見せたくなかった。
and when he was like that it was sometimes very hard to manage him.	それにそんな時、彼はまったく手にあまることがあった。
Freddy Malins always came late, but they wondered what could be keeping Gabriel:	フレディ・マリンズはいつも遅れて来たが、ゲイブリエルを引き留めているのは何だろうと彼らは思った。
and that was what brought them every two minutes to the banisters to ask Lily had Gabriel or Freddy come.	それで彼らは二分ごとに階段の手すりのところに来てはゲイブリエルかフレディは来たかとリリーに尋ねるのだった。
"O, Mr. Conroy,"	「おお、コンロイさん、」
said Lily to Gabriel when she opened the door for him,	リリーがゲイブリエルのためにドアを開けて言った、
"Miss Kate and Miss Julia thought you were never coming.	「ミス・ケイトとミス・ジュリアはあなたがもう見えないのではと思ってましたわ。
Good-night, Mrs. Conroy."	今晩は、ミセス・コンロイ。」
"I'll engage they did,"	「さもありなんというところかな、」
said Gabriel,	ゲイブリエルが言った、
"but they forget that my wife here takes three mortal hours to dress herself."	「しかし叔母さんたちはここにいるうちの奥さんが身支度するのに延々三時間もかかるのを忘れてるよ。」
He stood on the mat, scraping the snow from his goloshes, while Lily led his wife to the foot of the stairs and called out:	彼はマットの上に立ち、ガロッシュの雪をこすり落としていたが、その間にリリーは彼の妻を階段の下まで案内し、大声で呼びかけた。
"Miss Kate, here's Mrs. Conroy."	「ミス・ケイト、ミセス・コンロイがおいでです。」
Kate and Julia came toddling down the dark stairs at once.	ケイトとジュリアがすぐに暗い階段をよちよちと下りてきた。
Both of them kissed Gabriel's wife, said she must be perished alive, and asked was Gabriel with her.	二人ともゲイブリエルの妻にキスをして、寒くて死にそうなんじゃないのと言い、ゲイブリエルは一緒かと尋ねた。
"Here I am as right as the mail, Aunt Kate!	「郵便のようにちゃんと来てますよ、ケイト叔母さん！
Go on up.	上へどうぞ。
I'll follow,"	後から行きます」
called out Gabriel from the dark.	とゲイブリエルは暗闇から大声で言った。
He continued scraping his feet vigorously while the three women went upstairs, laughing, to the ladies' dressing-room.	三人の女たちが笑いながら二階の婦人用化粧室へ行く間も、彼は元気よく足をこすり続けた。
A light fringe of snow lay like a cape on the shoulders of his overcoat and like toecaps on the toes of his goloshes;	軽い房飾りとなった雪が彼のオーバーの肩にはケープのように、ガロッシュのつま先には靴のつま先の革のようにのっていた。
and, as the buttons of his overcoat slipped with a squeaking noise through the snow-stiffened frieze, a cold, fragrant air from out-of-doors escaped from crevices and folds.	そして、彼のオーバーのボタンが雪でこわばったフリーズの穴をキーキー音を立ててすり抜けた時、冷たく、かぐわしい戸外の空気が割れ目やひだからもれ出た。
"Is it snowing again, Mr. Conroy?"	「また雪が降ってるんですね、コンロイさん？」
asked Lily.	とリリーは尋ねた。
She had preceded him into the pantry to help him off with his overcoat.	彼女は先に立って彼を食器室に案内して彼がオーバーを脱ぐのを手伝った。
Gabriel smiled at the three syllables she had given his surname and glanced at her.	ゲイブリエルは、彼女が彼の姓に与えた三音節を聞いてにっこりとし、彼女をちらっと見た。
She was a slim;	彼女はほっそりとして、
growing girl, pale in complexion and with hay-coloured hair.	発育盛りの娘で、顔色は青白く、干草色の髪をしていた。
The gas in the pantry made her look still paler.	食器室のガス灯は彼女の顔色をいっそう青白く見せた。
Gabriel had known her when she was a child and used to sit on the lowest step nursing a rag doll.	ゲイブリエルは、彼女が子どもで、よく階段の一番下に座ってぬいぐるみの人形を大事に抱いていた頃から知っていた。
"Yes, Lily,"	「ああ、リリー、」
he answered,	彼は答えた、
"and I think we're in for a night of it."	「きっと一晩降るんだと思うよ。」
He looked up at the pantry ceiling, which was shaking with the stamping and shuffling of feet on the floor above, listened for a moment to the piano and then glanced at the girl, who was folding his overcoat carefully at the end of a shelf.	彼は、上の階で足を踏み鳴らしたり引きずったりするので揺れている食器室の天井を見上げ、ちょっとピアノに耳を傾け、それから棚の端で入念にオーバーをたたんでいる娘に目をやった。
"Tell me.	「ねえ、
Lily,"	リリー、」
he said in a friendly tone,	彼は親しげな調子で言った、
"do you still go to school?"	「まだ学校に行っているの？」
"O no, sir,"	「ああ、いいえ」
she answered.	と彼女は答えた。
"I'm done schooling this year and more."	「今年っていうかもう学校は終わってます。」
"O, then,"	「ああ、それじゃあ、」
said Gabriel gaily,	ゲイブリエルが陽気に言った、
"I suppose we'll be going to your wedding one of these fine days with your young man, eh? "	「僕らは近いうちに君のいい人との結婚式に行くことになるかな、ええ？」
The girl glanced back at him over her shoulder and said with great bitterness:	少女は後ろの彼を肩越しにちらっと見て、きわめて辛らつに言った。
"The men that is now is only all palaver and what they can get out of you."	「今時の男たちったらみんな口先きだけの下心ばっかですね。」
Gabriel coloured, as if he felt he had made a mistake and, without looking at her, kicked off his goloshes and flicked actively with his muffler at his patent-leather shoes.	ゲイブリエルは、ああまずかったというように顔を赤らめ、彼女の方を見ずに、ガロッシュを蹴飛ばして脱ぎ、エナメル革の靴をマフラーでパッパッとさかんにはらった。
He was a stout, tallish young man.	彼は太って背はやや高く若い男だった。
The high colour of his cheeks pushed upwards even to his forehead, where it scattered itself in a few formless patches of pale red;	頬の血色は押し上がって額にまでいくつかの形のない、薄い赤の斑点となって散らばっていた。
and on his hairless face there scintillated restlessly the polished lenses and the bright gilt rims of the glasses which screened his delicate and restless eyes.	そしてひげのない顔には、繊細で落ち着きのない目を隠すメガネの磨かれたレンズと輝く金の縁が落ち着きなくきらめいていた。
His glossy black hair was parted in the middle and brushed in a long curve behind his ears where it curled slightly beneath the groove left by his hat.	彼のつやのある黒い髪は真ん中で分けられ、長く曲線を描いて耳の後ろでは帽子の跡より下の部分がかすかにカールしていた。
When he had flicked lustre into his shoes he stood up and pulled his waistcoat down more tightly on his plump body.	靴をパッパッとやって光沢の出たところで彼は立ち上がり、ふっくらしたからだにぴったりするようにベストを引っ張り下ろした。
Then he took a coin rapidly from his pocket.	それから彼はポケットからすばやく硬貨を取り出した。
"O Lily,"	「ああリリー、」
he said, thrusting it into her hands,	彼はそれを彼女の手に押し込みながら言った、
"it's Christmastime, isn't it?	「クリスマスの時期じゃないか。
Just...	ちょうど・・・
here's a little...."	ここに少し・・・」
He walked rapidly towards the door.	彼はさっとドアに向かって歩いた。
"O no, sir!"	「ああいけません！」
cried the girl, following him.	少女は彼を追って叫んだ。
"Really, sir, I wouldn't take it."	「本当に、いただけません。」
"Christmas-time!	「クリスマスの時期だ！
Christmas-time!"	クリスマスの時期だ！」
said Gabriel, almost trotting to the stairs and waving his hand to her in deprecation.	とゲイブリエルは階段までほとんど小走りになり、抗議する彼女に手を振りながら言った。
The girl, seeing that he had gained the stairs, called out after him:	少女は、彼が階段に到着したのを見て、彼の後ろから大声で呼んだ。
"Well, thank you, sir."	「それじゃ、ありがとうございます。」
He waited outside the drawing-room door until the waltz should finish, listening to the skirts that swept against it and to the shuffling of feet.	彼は客間のドアの外でワルツが終わるのを待ち、スカートのドアをこする音や足を引きずる音を聞いていた。
He was still discomposed by the girl's bitter and sudden retort.	彼はまだ少女の辛らつな、思いがけない反駁に落ち着きを失っていた。
It had cast a gloom over him which he tried to dispel by arranging his cuffs and the bows of his tie.	それは彼に暗い影を投げかけ、彼は払いのけようとしてカフスや蝶ネクタイを整えていた。
He then took from his waistcoat pocket a little paper and glanced at the headings he had made for his speech.	彼はそれからベストのポケットから小さな紙を取り出し、スピーチのために作った項目をざっと見た。
He was undecided about the lines from Robert Browning,	彼はロバート・ブラウニングの短詩については迷っていた。
for he feared they would be above the heads of his hearers.	というのはそれは聞き手には難しすぎるのではと思ったからだ。
Some quotation that they would recognise from Shakespeare or from the Melodies would be better.	シェークスピアからとか歌曲集からとか彼らにもわかる引用の方がよかろう。
The indelicate clacking of the men's heels and the shuffling of their soles reminded him that their grade of culture differed from his.	カタカタ鳴る男たちのかかとの下品な音や靴底を引きずる音が彼とは異なる彼らの文化程度を思い起こさせた。
He would only make himself ridiculous by quoting poetry to them which they could not understand.	彼らに理解できない詩を引用しても自分をこっけいに見せるだけだ。
They would think that he was airing his superior education.	彼らは彼が自分の受けた優れた教育を吹聴していると思うだろう。
He would fail with them just as he had failed with the girl in the pantry.	彼はしくじるだろう、食器室で少女をしくじったのとまったく同じように。
He had taken up a wrong tone.	彼はまずい調子を引きずってしまった。
His whole speech was a mistake from first to last, an utter failure.	彼のスピーチ全体が最初から最後まで間違いだ、まったくの失敗だ。
Just then his aunts and his wife came out of the ladies' dressing-room.	ちょうどその時彼の叔母たちと妻が婦人用化粧室から出てきた。
His aunts were two small, plainly dressed old women.	叔母たち二人は小さな、質素な服装の老婦人だった。
Aunt Julia was an inch or so the taller.	ジュリア叔母の方が一インチかそこら背が高かった。
Her hair, drawn low over the tops of her ears, was grey;	耳をかすめるように低く引っ張られた彼女の髪は灰色だった。
and grey also, with darker shadows, was her large flaccid face.	彼女のたるんだ大きな顔も黒い隈はあるが、やはり灰色だった。
Though she was stout in build and stood erect, her slow eyes and parted lips gave her the appearance of a woman who did not know where she was or where she was going.	彼女はがっしりした体格で真っ直ぐ立っていたが、そののろのろした目と開いた唇のため、どこにいるのか、どこに行こうとしているのかわからない女のように見えた。
Aunt Kate was more vivacious.	ケイト叔母はもっと活気があった。
Her face, healthier than her sister's, was all puckers and creases, like a shrivelled red apple, and her hair, braided in the same old-fashioned way, had not lost its ripe nut colour.	彼女の顔は、妹より健康的だが、しなびた赤りんごのようにすっかりしわしわで、彼女の髪は、同様に古風なやり方で編まれ、熟したナッツの色を失っていなかった。
They both kissed Gabriel frankly.	二人とも遠慮なくゲイブリエルにキスをした。
He was their favourite nephew the son of their dead elder sister, Ellen, who had married T. J. Conroy of the Port and Docks.	彼は二人の死んだ姉で港湾局のＴ・Ｊ・コンロイと結婚したエレンの息子でお気に入りの甥だった。
"Gretta tells me you're not going to take a cab back to Monkstown tonight, Gabriel,"	「グレタの話では今夜マンクスタウンに馬車で帰るつもりはないってね、ゲイブリエル」
said Aunt Kate.	とケイト叔母が言った。
"No,"	「ええ」
said Gabriel, turning to his wife,	と言ってゲイブリエルは妻のほうを向いた、
"we had quite enough of that last year, hadn't we?	「それはもう去年でたくさんだねえ？
Don't you remember, Aunt Kate, what a cold Gretta got out of it?	覚えてませんか、ケイト叔母さん、それでグレタがどんなことになったか？
Cab windows rattling all the way, and the east wind blowing in after we passed Merrion.	馬車の窓が道中ずっとがたがたいうし、メリオンを過ぎた後で東風は吹き込むし。
Very jolly it was.	もう笑っちゃいましたよ。
Gretta caught a dreadful cold."	グレタはひどい風邪をひきました。」
Aunt Kate frowned severely and nodded her head at every word.	ケイト叔母はきつく顔をしかめ、一言一言うなずいていた。
"Quite right, Gabriel, quite right,"	「そのとおりよ、ゲイブリエル、そのとおりよ」
she said.	と彼女は言った。
"You can't be too careful."	「注意はしすぎるぐらいじゃないと。」
"But as for Gretta there,"	「しかしこのグレタと言えば、」
said Gabriel,	ゲイブリエルは言った、
"she'd walk home in the snow if she were let."	「ほうっておけば雪の中を歩いて帰るでしょうよ。」
Mrs. Conroy laughed.	コンロイ夫人は笑った。
"Don't mind him, Aunt Kate,"	「彼にかまわないで、ケイト叔母さん」
she said.	と彼女は言った。
"He's really an awful bother, what with green shades for Tom's eyes at night and making him do the dumb-bells, and forcing Eva to eat the stirabout.	「彼はほんとにうるさい人なの、夜はトムの目のために緑のシェードだとか彼にダンベルをやらせろとか、それからエヴァにオートミールのおかゆを無理にも食べさせろとか。
The poor child!	かわいそうな子！
And she simply hates the sight of it!...	それであの子はまったくあれを見るのも嫌って！・・・
O, but you'll never guess what he makes me wear now!"	ああ、でも彼が今度私に何を着けさせたか、決して言い当てられないでしょう！」
She broke out into a peal of laughter and glanced at her husband, whose admiring and happy eyes had been wandering from her dress to her face and hair.	彼女はどっと笑い出し、夫をちらっと見たが、こちらはうっとりとした嬉しそうな目を彼女のドレスから彼女の顔、そして髪へとさまよわせていた。
The two aunts laughed heartily, too,	二人の叔母もまた心から笑った。
for Gabriel's solicitude was a standing joke with them.	というのもゲイブリエルの心配症はいつも彼らのジョークの種だったからだ。
"Goloshes!"	「ガロッシュ！」
said Mrs. Conroy.	とコンロイ夫人は言った。
"That's the latest.	「あれが最新モードよ。
Whenever it's wet underfoot I must put on my galoshes.	足もとが濡れている時はいつでもガロッシュをつけなくてはいけないの。
Tonight even, he wanted me to put them on, but I wouldn't.	今夜だって彼はあれを私につけさせたかったけど私はいやだったの。
The next thing he'll buy me will be a diving suit."	次に彼が私に買ってくれるのはダイビングスーツでしょうよ。」
Gabriel laughed nervously and patted his tie reassuringly, while Aunt Kate nearly doubled herself, so heartily did she enjoy the joke.	ゲイブリエルは神経質に笑い、不安を和らげるようにネクタイを軽く叩いていたが、ケイト叔母の方はほとんどからだを折り曲げるようにして、思う存分ジョークを楽しんでいた。
The smile soon faded from Aunt Julia's face and her mirthless eyes were directed towards her nephew's face.	ジュリア叔母の顔からはすぐに笑みが薄れ、彼女の笑っていない目は甥の顔に向けられた。
After a pause she asked:	ちゅうちょした後彼女は尋ねた。
"And what are goloshes, Gabriel?"	「それでガロッシュって何、ゲイブリエル？」
"Goloshes, Julia!"	「ガロッシュよ、ジュリア！」
exclaimed her sister	彼女の姉が大声で言った、
"Goodness me, don't you know what goloshes are?	「えっ、ガロッシュが何か知らないの？
You wear them over your...	つけるでしょあなたのほら・・・
over your boots, Gretta, isn't it?"	ブーツの上に、グレタ、そうじゃない？」
"Yes,"	「そうよ」
said Mrs. Conroy.	とコンロイ夫人は言った。
"Guttapercha things.	「グッタペルカでできたものよ。
We both have a pair now.	今じゃ私たち二人とも一組持ってるの。
Gabriel says everyone wears them on the Continent."	ゲイブリエルが言うには大陸ではみんなが着けるんですって。」
"O, on the Continent,"	「おお、大陸でね」
murmured Aunt Julia, nodding her head slowly.	とジュリア叔母はゆっくりうなずきながら小声で言った。
Gabriel knitted his brows and said, as if he were slightly angered:	ゲイブリエルはいくらか腹を立てたかのように、眉をひそめて言った。
"It's nothing very wonderful, but Gretta thinks it very funny because she says the word reminds her of Christy Minstrels."	「何も不思議なことはないですよ、でもグレタはその言葉がクリスティー・ミンストレルズを思い出させると言ってはすごくおもしろがっているんです。」
"But tell me, Gabriel,"	「でもねえ、ゲイブリエル」
said Aunt Kate, with brisk tact.	とケイト叔母がさっと機転をきかせて言った。
"Of course, you've seen about the room.	「もちろん部屋のことは何とかしたんでしょ。
Gretta was saying..."	グレタは言ってたわ・・・」
"0, the room is all right,"	「ああ、部屋は大丈夫です」
replied Gabriel.	とゲイブリエルは答えた。
"I've taken one in the Gresham."	「グレシャムに一つ取りました。」
"To be sure,"	「確かにね、」
said Aunt Kate,	ケイト叔母が言った、
"by far the best thing to do.	「その方がずっといいわ。
And the children, Gretta, you're not anxious about them?"	それで子どもたちは、グレタ、あの子たちのことは心配じゃない？」
"0, for one night,"	「ああ、一晩だし」
said Mrs. Conroy.	とコンロイ夫人は言った。
"Besides, Bessie will look after them."	「それにベシーがあの子たちの世話をしてくれるの。」
"To be sure,"	「確かにね」
said Aunt Kate again.	と、またケイト叔母は言った。
"What a comfort it is to have a girl like that, one you can depend on!	「そんな娘がいるのは、頼りにできる子がいるのはほんとに助かることね！
There's that Lily, I'm sure I don't know what has come over her lately.	ほらあのリリー、ほんとに最近彼女どうしちゃったのかしら、わからないわ。
She's not the girl she was at all."	彼女、全然前のあの娘じゃないわ。」
Gabriel was about to ask his aunt some questions on this point, but she broke off suddenly to gaze after her sister, who had wandered down the stairs and was craning her neck over the banisters.	ゲイブリエルはこの点について叔母に少々質問をしようとしかけたが、彼女は突然話をやめ、階段をぶらぶら下りていって手すり越しに首を伸ばしている妹をじいっと目で追っていた。
"Now, I ask you,"	「ねえ、どうしたの、」
she said almost testily,	彼女は短気を起こしそうになって言った、
"where is Julia going?	「どこへ行くのジュリアは？
Julia!	ジュリア！
Julia!	ジュリア！
Where are you going?"	どこへ行くの？」
Julia, who had gone half way down one flight, came back and announced blandly:	ジュリアは階段を途中まで下りてしまっていたが、戻ってきて落ち着きすまして告知した。
"Here's Freddy."	「フレディが来たわ。」
At the same moment a clapping of hands and a final flourish of the pianist told that the waltz had ended.	それと同時に手を叩く音とピアニストの最後の派手な一節がワルツの終わりを告げた。
The drawing-room door was opened from within and some couples came out.	客間のドアが内から開き、数組のカップルが出てきた。
Aunt Kate drew Gabriel aside hurriedly and whispered into his ear:	ケイト叔母は急いでゲイブリエルを脇へ引っ張っていき、彼の耳にささやいた。
"Slip down, Gabriel, like a good fellow and see if he's all right, and don't let him up if he's screwed.	「そっと下に行って、ゲイブリエル、悪いけど彼が大丈夫か確かめて、で彼が酔ってたら上に上げないで。
I'm sure he's screwed.	きっと酔ってるわ。
I'm sure he is."	きっとそうよ。」
Gabriel went to the stairs and listened over the banisters.	ゲイブリエルは階段のところへ行き、手すりの上から耳をすました。
He could hear two persons talking in the pantry.	二人の人物が食器室で話しているのが聞こえた。
Then he recognised Freddy Malins' laugh.	それから彼はフレディ・マリンズの笑い声を認めた。
He went down the stairs noisily.	彼は大きな音を立てて階段を下りた。
"It's such a relief,"	「とっても助かるわ、」
said Aunt Kate to Mrs. Conroy,	ケイト叔母はコンロイ夫人に言った、
"that Gabriel is here.	「ゲイブリエルがここにいて。
I always feel easier in my mind when he's here....	私はいつも気分がほっとするの、彼がここにいると・・・
Julia, there's Miss Daly and Miss Power will take some refreshment.	ジュリア、ほら、ミス・デイリーとミス・パワーが軽食を取られることよ。
Thanks for your beautiful waltz, Miss Daly.	すてきなワルツをありがとう、ミス・デイリー。
It made lovely time."	楽しかったわ。」
A tall wizen-faced man, with a stiff grizzled moustache and swarthy skin, who was passing out with his partner, said:	硬い白髪交じりの口ひげ、浅黒い肌、背は高く、しわだらけの顔の男がパートナーと共に出てきて言った。
"And may we have some refreshment, too, Miss Morkan?"	「私たちも少し軽食を取らせていただけますか、ミス・モーカン？」
"Julia,"	「ジュリア、」
said Aunt Kate summarily,	ケイト叔母が即座に言った、
"and here's Mr. Browne and Miss Furlong.	「それからこちらのミスター・ブラウンとミス・ファーロング。
Take them in, Julia, with Miss Daly and Miss Power."	一緒にお連れして、ジュリア、ミス・デイリーとミス・パワーと。」
"I'm the man for the ladies,"	「私はご婦人方の味方です」
said Mr. Browne, pursing his lips until his moustache bristled and smiling in all his wrinkles.	とブラウン氏は、口ひげが逆立つほど唇をすぼめ、顔をくしゃくしゃにして微笑みながら言った。
"You know, Miss Morkan, the reason they are so fond of me is----"	「何しろミス・モーカン、私がご婦人方に好かれるわけは−−−−」
He did not finish his sentence, but, seeing that Aunt Kate was out of earshot, at once led the three young ladies into the back room.	彼は言い終えなかった、が、ケイト叔母が言っても聞こえない所にいると見るや、直ちに三人の妙齢のご婦人方を率いて奥なる部屋へ入った。
The middle of the room was occupied by two square tables placed end to end, and on these Aunt Julia and the caretaker were straightening and smoothing a large cloth.	その部屋の中央は端と端をつないで置かれた二つの四角いテーブルでふさがり、その上にジュリア叔母と管理人が大きなテーブルクロスをまっすぐにしてしわを伸ばしていた。
On the sideboard were arrayed dishes and plates, and glasses and bundles of knives and forks and spoons.	食器棚には大皿や平皿、グラスやナイフ、フォーク、スプーンの束が整列していた。
The top of the closed square piano served also as a sideboard for viands and sweets.	閉じたスクエアピアノの上面もまた食料やデザートのための食器棚の役を務めていた。
At a smaller sideboard in one corner two young men were standing, drinking hop-bitters.	一隅のやや小さな食器棚の所には二人の若い男が立ち、ホップビターを飲んでいた。
Mr. Browne led his charges thither and invited them all, in jest, to some ladies' punch, hot, strong and sweet.	ブラウン氏は預かりものをそちらへ案内し、彼女たちみんなに、冗談で、ご婦人方用パンチの熱く、強く、甘いやつを勧めた。
As they said they never took anything strong, he opened three bottles of lemonade for them.	彼女たちが強いものはとても飲めないと言うので、彼は彼女たちのためにレモネードの瓶を三つ開けた。
Then he asked one of the young men to move aside, and, taking hold of the decanter, filled out for himself a goodly measure of whisky.	それから彼は若者の一人に脇に寄るように求め、そして、デカンターをつかみ、自ら相当量のウィスキーをなみなみとついだ。
The young men eyed him respectfully while he took a trial sip.	若者たちはうやうやしげに、試みにひとなめする彼に目を据えていた。
"God help me,"	「情けないことに、」
he said, smiling,	彼はにっこりとして言った、
"it's the doctor's orders."	「これが医者の命令でね。」
His wizened face broke into a broader smile, and the three young ladies laughed in musical echo to his pleasantry, swaying their bodies to and fro, with nervous jerks of their shoulders.	彼のしわくちゃの顔にあからさまな笑みがパッと広がり、三人の妙齢のご婦人方は彼の冗談に調子よく呼応して笑い、肩をぴくぴく震わせ、からだを前後に揺すっていた。
The boldest said:	最も勇敢な一人が言った。
"O, now, Mr. Browne, I'm sure the doctor never ordered anything of the kind."	「あら、まあ、ブラウンさん、間違いなくお医者様は決してそのようなことを命令なさいませんわ。」
Mr. Browne took another sip of his whisky and said, with sidling mimicry:	ブラウン氏はもう一口ウィスキーをすすり、からだを横にして歩くまねをして言った。
"Well, you see, I'm like the famous Mrs. Cassidy, who is reported to have said:	「おや、だってねえ、私は有名なキャシディ夫人みたいなもんで、伝えられるところによれば彼女はこう言ったそうですな、
'Now, Mary Grimes, if I don't take it, make me take it, for I feel I want it.'"	『まあ、メアリー・グライムズ、私が飲まなかったら、飲ませてちょうだい、私は飲みたいんだから。』」
His hot face had leaned forward a little too confidentially and he had assumed a very low Dublin accent so that the young ladies, with one instinct, received his speech in silence.	ちょっとあまりになれなれしく彼の熱した顔が前のめりになり、また彼が非常に下品なダブリンなまりを装ったので、妙齢のご婦人方は、一様に本能が働き、無言で彼の話を受けた。
Miss Furlong, who was one of Mary Jane's pupils, asked Miss Daly what was the name of the pretty waltz she had played;	メアリー・ジェーンの生徒の一人であるミス・ファーロングはミス・デイリーに彼女が弾いていた見事なワルツの名は何と言うのか尋ねた。
and Mr. Browne, seeing that he was ignored, turned promptly to the two young men who were more appreciative.	で、ブラウン氏は、無視されたと見て取ると、早速もっと話のわかる二人の若い男たちの方を向いた。
A red-faced young woman, dressed in pansy, came into the room, excitedly clapping her hands and crying:	パンジーの服を着た赤い顔の若い女が、興奮気味に手を叩き叫びながら部屋に入った。
"Quadrilles!	「カドリール！
Quadrilles!"	カドリール！」
Close on her heels came Aunt Kate, crying:	彼女のすぐ後にケイト叔母も続き、叫んだ。
"Two gentlemen and three ladies, Mary Jane!"	「殿方が二人とご婦人が三人よ、メアリー・ジェーン！」
"O, here's Mr. Bergin and Mr. Kerrigan,"	「ああ、こちらにミスター・バーギンとミスター・ケリガンが」
said Mary Jane.	とメアリー・ジェーンは言った。
"Mr. Kerrigan, will you take Miss Power?	「ケリガンさん、ミス・パワーといかが？
Miss Furlong, may I get you a partner, Mr. Bergin.	ミス・ファーロング、あなたのパートナーにバーギンさんでは。
O, that'll just do now."	ああ、ほら、それでちょうどいいわ。」
"Three ladies, Mary Jane,"	「ご婦人は三人よ、メアリー・ジェーン」
said Aunt Kate.	とケイト叔母が言った。
The two young gentlemen asked the ladies if they might have the pleasure, and Mary Jane turned to Miss Daly.	二人の若い紳士が婦人たちにお相手をさせていただけませんかと尋ね、メアリー・ジェーンはミス・デイリーに目を向けた。
"O, Miss Daly, you're really awfully good, after playing for the last two dances, but really we're so short of ladies tonight."	「ああ、ミス・デイリー、二曲ダンスの伴奏をなさったばかりで本当にすごく申し訳ないけれど、今夜は本当にご婦人がとても足りないの。」
"I don't mind in the least, Miss Morkan."	「ちっともかまいませんことよ、ミス・モーカン。」
"But I've a nice partner for you, Mr. Bartell D'Arcy, the tenor.	「でもあなたには素敵なパートナー、テノールのミスター・バーテル・ダーシーがいてよ。
I'll get him to sing later on.	私、彼に後で歌っていただくの。
All Dublin is raving about him."	ダブリン中が彼に夢中になってるわ。」
"Lovely voice, lovely voice!"	「すばらしい声、すばらしい声よ！」
said Aunt Kate.	とケイト叔母が言った。
As the piano had twice begun the prelude to the first figure Mary Jane led her recruits quickly from the room.	ピアノが最初のフィギュアのプレリュードを二度も始めていたので、メアリー・ジェーンは急いで補充メンバーを部屋から導いた。
They had hardly gone when Aunt Julia wandered slowly into the room, looking behind her at something.	彼らが出て行くとすぐにジュリア叔母が背後の何かを見ながらゆっくりと部屋にさまよいこんできた。
"What is the matter, Julia?"	「どうしたの、ジュリア？」
asked Aunt Kate anxiously.	ケイト叔母が心配そうに尋ねた、
"Who is it?"	「誰なの？」
Julia, who was carrying in a column of table-napkins, turned to her sister and said, simply, as if the question had surprised her:	円柱状のテーブルナプキンを持って入ってきたジュリアは、姉の方を向き、簡単に、その質問に驚いたかのように言った。
"It's only Freddy, Kate, and Gabriel with him."	「いえただフレディよ、ケイト、それとゲイブリエルも一緒。」
In fact right behind her Gabriel could be seen piloting Freddy Malins across the landing.	事実、彼女のすぐ後ろにゲイブリエルが見え、フレディ・マリンズを先導して階段の踊り場を横切っていた。
The latter, a young man of about forty, was of Gabriel's size and build, with very round shoulders.	後者は四十くらいの若い、ゲイブリエルと同じ背格好、体格で、かなり猫背の男だった。
His face was fleshy and pallid, touched with colour only at the thick hanging lobes of his ears and at the wide wings of his nose.	彼の顔は肉付きがよくて青白く、厚く垂れ下がった耳たぶと広がった小鼻だけが色に染まっていた。
He had coarse features, a blunt nose, a convex and receding brow, tumid and protruded lips.	彼は下品な顔立ち、だんご鼻、出っ張って髪の後退した額、腫れて突き出た唇をしていた。
His heavy-lidded eyes and the disorder of his scanty hair made him look sleepy.	重くまぶたの垂れた目や乏しい髪の乱れは彼を眠そうに見せていた。
He was laughing heartily in a high key at a story which he had been telling Gabriel on the stairs and at the same time rubbing the knuckles of his left fist backwards and forwards into his left eye.	彼は階段上でゲイブリエルにしていた自分の話に高調子に思い切り笑いながら、同時に左のこぶしの指のつけ根の関節で左の目を前に後にこすっていた。
"Good-evening, Freddy,"	「今晩は、フレディ」
said Aunt Julia.	とジュリア叔母が言った。
Freddy Malins bade the Misses Morkan good-evening in what seemed an offhand fashion by reason of the habitual catch in his voice and then, seeing that Mr. Browne was grinning at him from the sideboard, crossed the room on rather shaky legs and began to repeat in an undertone the story he had just told to Gabriel.	フレディ・マリンズはモーカン姉妹に、彼の声にいつもある引っかかりのためにぞんざいに思えるやり方で挨拶をし、それからブラウン氏が食器棚のところから彼に笑いかけているのを見てややふらつく足取りで部屋を横切り、今ゲイブリエルにしたばかりの話を小声で繰り返し始めた。
"He's not so bad, is he?"	「彼、そう悪くないわよね？」
said Aunt Kate to Gabriel.	とケイト叔母がゲイブリエルに言った。
Gabriel's brows were dark but he raised them quickly and answered:	眉を曇らせていたゲイブリエルだが、急いでそれを上げて答えた。
"O, no, hardly noticeable."	「おお、ええ、ほとんどわからない。」
"Now, isn't he a terrible fellow!"	「まあ、ひどい人じゃない！」
she said.	と彼女は言った。
"And his poor mother made him take the pledge on New Year's Eve.	「それに気の毒に彼のお母さん、大晦日に彼に禁酒の誓いをさせたのよ。
But come on, Gabriel, into the drawing-room."	でも行きましょう、ゲイブリエル、客間へ。」
Before leaving the room with Gabriel she signalled to Mr. Browne by frowning and shaking her forefinger in warning to and fro.	ゲイブリエルと一緒に部屋を出ていく前に、彼女はブラウン氏への合図として眉をひそめ、人差し指を警告として前後に振った。
Mr. Browne nodded in answer and, when she had gone, said to Freddy Malins:	ブラウン氏は応えてうなずき、そして彼女が行ってしまうとフレディ・マリンズに言った。
"Now, then, Teddy, I'm going to fill you out a good glass of lemonade just to buck you up."	「さあ、それじゃあ、テディ、ちょっと君を元気づけるためにグラスになみなみとレモネードを満たすとしよう。」
Freddy Malins, who was nearing the climax of his story, waved the offer aside impatiently but Mr. Browne, having first called Freddy Malins' attention to a disarray in his dress, filled out and handed him a full glass of lemonade.	話がクライマックスに近づいていたフレディ・マリンズは気短に申し出を退けたが、ブラウン氏はまず服装の乱れにフレディ・マリンズの注意を向けさせ、レモネードをグラスになみなみとついで彼に手渡した。
Freddy Malins' left hand accepted the glass mechanically, his right hand being engaged in the mechanical readjustment of his dress.	右手が機械的に服を直すことで忙しくしていたフレディ・マリンズの左手はグラスを機械的に受け取った。
Mr. Browne, whose face was once more wrinkling with mirth, poured out for himself a glass of whisky while Freddy Malins exploded, before he had well reached the climax of his story, in a kink of high-pitched bronchitic laughter and, setting down his untasted and overflowing glass, began to rub the knuckles of his left fist backwards and forwards into his left eye, repeating words of his last phrase as well as his fit of laughter would allow him.	もう一度顔に陽気なしわを寄せたブラウン氏は自分のグラスにウィスキーを注いだが、フレディ・マリンズの方は首尾よく話のクライマックスに達する前に、せきこんで痙攣するような高い笑い声を爆発させ、好みでないあふれんばかりのグラスを下に置くと、左のこぶしの指関節で左の目を前に後にこすり始め、笑いの発作の許すだけ最後の一節の言葉を繰り返していた。
Gabriel could not listen while Mary Jane was playing her Academy piece, full of runs and difficult passages, to the hushed drawing-room.	メアリー・ジェーンが静かな客間にルラードや難しい楽節を駆使した彼女のアカデミーでの曲を演奏する間、ゲイブリエルは耳を傾ける気になれなかった。
He liked music but the piece she was playing had no melody for him and he doubted whether it had any melody for the other listeners, though they had begged Mary Jane to play something.	彼は音楽が好きだったが、彼女の演奏している曲の調べは彼にとって少しも快い調べではなかったし、聞いている他の人たちだって何か弾いてくれとメアリー・ジェーンに懇願したとはいうものの、これが彼らにとっていくらかでも快いものかどうか彼は疑っていた。
Four young men, who had come from the refreshment-room to stand in the doorway at the sound of the piano, had gone away quietly in couples after a few minutes.	ピアノの音に軽食堂から来て戸口に立っていた四人の若い男たちは、数分後には二人ずつ静かに立ち去ってしまった。
The only persons who seemed to follow the music were Mary Jane herself, her hands racing along the key-board or lifted from it at the pauses like those of a priestess in momentary imprecation, and Aunt Kate standing at her elbow to turn the page.	その音楽から耳が離せないらしい人物は、その両手が鍵盤の上を疾走し、あるいはそこから持ち上げられて瞬間的に呪いをかける巫女のように休止するメアリー・ジェーンその人と、ページをめくるために彼女のひじ先に立っているケイト叔母だけだった。
Gabriel's eyes, irritated by the floor, which glittered with beeswax under the heavy chandelier, wandered to the wall above the piano.	ゲイブリエルの目は、大きなシャンデリアの下、蜜蝋でピカピカ光る床を見て痛くなったため、ピアノの上の壁をさまよっていた。
A picture of the balcony scene in Romeo and Juliet hung there and beside it was a picture of the two murdered princes in the Tower which Aunt Julia had worked in red, blue and brown wools when she was a girl.	そこにはロミオとジュリエットのバルコニーの場面の絵がかかり、そのそばにはジュリア叔母が少女だった頃に赤、青、茶色の毛糸で刺繍した、ロンドン塔で殺された二人の王子の絵があった。
Probably in the school they had gone to as girls that kind of work had been taught for one year.	おそらく少女たちが通っていた学校ではそのようなものの製作が一年間教えられたのだろう。
His mother had worked for him as a birthday present a waistcoat of purple tabinet, with little foxes' heads upon it, lined with brown satin and having round mulberry buttons.	彼の母親は彼に誕生日のプレゼントとして、子狐の頭をいっぱいつけ、茶色のサテンの裏地で赤紫の丸いボタンのついた、波紋のある紫色の絹布のベストを作ってくれた。
It was strange that his mother had had no musical talent	不思議なことに彼の母親には音楽の才能がなかった。
though Aunt Kate used to call her the brains carrier of the Morkan family.	ケイト叔母は彼女をモーカン一家の頭脳の泉と呼んでいたけれど。
Both she and Julia had always seemed a little proud of their serious and matronly sister.	ケイトもジュリアも常々まじめで落ち着いた姉をちょっと誇りに思っているようだった。
Her photograph stood before the pierglass.	彼女の写真は大鏡の前に立っていた。
She held an open book on her knees and was pointing out something in it to Constantine who, dressed in a man-o-war suit, lay at her feet.	彼女はひざの上に開いた本をのせ、水兵の服を着て彼女の足もとに横になっているコンスタンタインに、その中の何かを指し示していた。
It was she who had chosen the name of her sons	息子たちの名前を選んだのは彼女だった。
for she was very sensible of the dignity of family life.	というのも彼女は家庭生活の品位をとても意識していたからだ。
Thanks to her, Constantine was now senior curate in Balbrigan and, thanks to her, Gabriel himself had taken his degree in the Royal University.	彼女のおかげでコンスタンタインは今、バルブリガンで主席助任司祭だし、彼女のおかげでゲイブリエル自身は王立大学で学位を取ったのだった。
A shadow passed over his face as he remembered her sullen opposition to his marriage.	彼女が彼の結婚に意地悪く反対したことを思い出した彼の顔に影がよぎった。
Some slighting phrases she had used still rankled in his memory;	彼女の使った軽侮するような言い回しが彼の記憶のうちでまだしこりとなっていた。
she had once spoken of Gretta as being country cute and that was not true of Gretta at all.	彼女は一度グレタのことをいなか育ちの抜けめない娘と言ったが、それは本当のグレタとは全く違っていた。
It was Gretta who had nursed her during all her last long illness in their house at Monkstown.	彼女の晩年の長患いの間ずっと彼らのマンクスタウンの家で彼女を看病したのはグレタだった。
He knew that Mary Jane must be near the end of her piece for she was playing again the opening melody with runs of scales after every bar and while he waited for the end the resentment died down in his heart.	メアリー・ジェーンが小節ごとに装飾音のある冒頭のメロディーを再び演奏していたので、彼女の曲も終わりに近づいたに違いないと彼は知り、その終わりを待つ間に彼の心のうちの憤りも次第に消えていった。
The piece ended with a trill of octaves in the treble and a final deep octave in the bass.	高音部のオクターブのトリル、そして最後に低音部の荘重なオクターブをもってその曲は終わった。
Great applause greeted Mary Jane as, blushing and rolling up her music nervously, she escaped from the room.	顔を赤らめ、神経質に楽譜を丸めながら部屋を逃げ出すメアリー・ジェーンを大変な拍手喝采が迎えた。
The most vigorous clapping came from the four young men in the doorway who had gone away to the refreshment-room at the beginning of the piece but had come back when the piano had stopped.	最も力強い拍手の音は、曲の始まりに軽食堂へ行ってしまったのにピアノが止まると戻ってきた戸口の四人の若い男たちから聞こえた。
Lancers were arranged.	ランサーズが準備された。
Gabriel found himself partnered with Miss Ivors.	ゲイブリエルのパートナーはミス・アイバースになった。
She was a frank-mannered talkative young lady, with a freckled face and prominent brown eyes.	彼女は率直な態度の話し好きな若い女性で、そばかすのある顔、出っ張った茶色の目をしていた。
She did not wear a low-cut bodice and the large brooch which was fixed in the front of her collar bore on it an Irish device and motto.	彼女は襟ぐりの深いボディスは身につけず、襟の前に留められた大きなブローチはアイルランドの象徴と教えを表していた。
When they had taken their places she said abruptly:	彼らが決められた位置に着いた時、彼女が唐突に言った。
"I have a crow to pluck with you."	「あなたに文句があるの。」
"With me?"	「僕に？」
said Gabriel.	とゲイブリエルが言った。
She nodded her head gravely.	彼女は大まじめにうなずいた。
"What is it?"	「何です？」
asked Gabriel, smiling at her solemn manner.	とゲイブリエルは彼女のまじめくさった様子に微笑んで尋ねた。
"Who is G. C.?"	「Ｇ・Ｃというのは誰？」
answered Miss Ivors, turning her eyes upon him.	とミス・アイバースは目を彼に向けて答えた。
Gabriel coloured and was about to knit his brows, as if he did not understand, when she said bluntly:	ゲイブリエルが顔を赤らめ、理解できないかのように眉をひそめようとした時、彼女が無遠慮に言った。
"O, innocent Amy!	「おお、しらばっくれて！
I have found out that you write for The Daily Express.	あなたがデイリーエクスプレスに寄稿しているのを見つけたんだから。
Now, aren't you ashamed of yourself?"	さあ、恥ずかしくない？」
"Why should I be ashamed of myself?"	「なぜ僕が恥ずかしがらなければならないのです？」
asked Gabriel, blinking his eyes and trying to smile.	とゲイブリエルは瞬きをし、微笑もうと努めながら尋ねた。
"Well, I'm ashamed of you,"	「あら、私はあなたが恥ずかしいわ」
said Miss Ivors frankly.	とミス・アイバースは率直に言った。
"To say you'd write for a paper like that.	「あんな新聞に文章を書くなんて。
I didn't think you were a West Briton."	あなたがウェストブリトンとは思わなかった。」
A look of perplexity appeared on Gabriel's face.	当惑の表情がゲイブリエルの顔に現れた。
It was true that he wrote a literary column every Wednesday in The Daily Express, for which he was paid fifteen shillings.	彼がデイリーエクスプレスに毎週水曜日、文学のコラムを書き、それで十五シリングの報酬を受けているのは本当だった。
But that did not make him a West Briton surely.	しかしまさかそれで彼がウェストブリトンということにはならない。
The books he received for review were almost more welcome than the paltry cheque.	論評のために彼が受け取る本はわずかな金額の小切手よりもありがたいくらいだった。
He loved to feel the covers and turn over the pages of newly printed books.	彼は印刷されたばかりの本の表紙に触れ、ページをめくるのが好きだった。
Nearly every day when his teaching in the college was ended he used to wander down the quays to the second-hand booksellers, to Hickey's on Bachelor's Walk, to Web's or Massey's on Aston's Quay, or to O'Clohissey's in the bystreet.	ほとんど毎日カレッジでの授業を終わらせると、彼はバチェラーズウォークのヒッキイや、アストンズキーのウェブやマッシーや、裏通りのオクロヒッシーなどの古本屋のある河岸を歩き回っていた。
He did not know how to meet her charge.	彼は彼女の非難にどう対処すべきかわからなかった。
He wanted to say that literature was above politics.	彼は文学は政治を超越していると言いたかった。
But they were friends of many years' standing and their careers had been parallel, first at the University and then as teachers:	しかし彼らは長年にわたる友人であり、最初に大学、それから教師として、と経歴もよく似ていているので、
he could not risk a grandiose phrase with her.	あえて彼女にえらそうな言葉を使うことはできなかった。
He continued blinking his eyes and trying to smile and murmured lamely that he saw nothing political in writing reviews of books.	彼は相変わらず瞬きをして微笑もうと努め、本の評論を書くことに政治的なものがあるとは思えないと小声で力なく言った。
When their turn to cross had come he was still perplexed and inattentive.	彼らがクロスする番になっても彼はまだ当惑してぼんやりしていた。
Miss Ivors promptly took his hand in a warm grasp and said in a soft friendly tone:	ミス・アイバースは機敏に彼の手を取って温かく握りしめ、穏やかな優しい調子で言った。
"Of course, I was only joking.	「もちろん、ただの冗談よ。
Come, we cross now."	さあ、私たちクロスするの、今よ。」
When they were together again she spoke of the University question and Gabriel felt more at ease.	彼らが再び一緒になった時、彼女は大学問題について話し、ゲイブリエルはほっとした。
A friend of hers had shown her his review of Browning's poems.	彼女の友人が彼女に彼のブラウニングの詩の評論を見せていた。
That was how she had found out the secret:	それで彼女は秘密を見つけ出したのだが
but she liked the review immensely.	彼女はその評論が非常に気に入った。
Then she said suddenly:	それから彼女は突然言った。
"O, Mr. Conroy, will you come for an excursion to the Aran Isles this summer?	「ああ、コンロイさん、今度の夏、アラン諸島へ旅行に行きません？
We're going to stay there a whole month.	私たちまる一月そこに泊まるつもりなの。
It will be splendid out in the Atlantic.	大西洋に出るのはすてきでしょう。
You ought to come.	あなたも来るべきだわ。
Mr. Clancy is coming, and Mr. Kilkelly and Kathleen Kearney.	クランシーさんも来るし、キルケリーさんとキャスリーン・カーニーも。
It would be splendid for Gretta too if she'd come.	もし来ればグレタにとってもすばらしいでしょうよ。
She's from Connacht, isn't she?"	彼女はコナハトの出身よね？」
"Her people are,"	「彼女の実家はね」
said Gabriel shortly.	とゲイブリエルは短く答えた。
"But you will come, won't you?"	「でもあなた行くでしょう？」
said Miss Ivors, laying her arm hand eagerly on his arm.	とミス・アイバースは、温かい手をしきりに彼の腕に置いては言った。
"The fact is,"	「実は、」
said Gabriel,	ゲイブリエルは言った、
"I have just arranged to go----"	「ちょうど出かける手はずをしたところで−−」
"Go where?"	「どこへ行くの？」
asked Miss Ivors.	ミス・アイバースは尋ねた。
"Well, you know, every year I go for a cycling tour with some fellows and so----"	「ええっとね、毎年僕は何人かの仲間と自転車旅行に行って、それで−−」
"But where?"	「でもどこへ？」
asked Miss Ivors.	とミス・アイバースは尋ねた。
"Well, we usually go to France or Belgium or perhaps Germany,"	「ええと、僕らはいつもフランスかベルギー、あるいはドイツに行く」
said Gabriel awkwardly.	とゲイブリエルはきまり悪そうに言った。
"And why do you go to France and Belgium,"	「それでなぜフランスやベルギーに行くわけ、」
said Miss Ivors,	ミス・アイバースは言った、
"instead of visiting your own land?"	「自分自身の国を訪れるかわりに？」
"Well,"	「ええと、」
said Gabriel,	ゲイブリエルは言った、
"it's partly to keep in touch with the languages and partly for a change."	「一部はそこの言語に触れるため、一部は変化を求めて。」
"And haven't you your own language to keep in touch with--	「それで自分自身の言語に触れなくてはだめでしょう−−
Irish?"	アイルランド語に？」
asked Miss Ivors.	とミス・アイバースは尋ねた。
"Well,"	「ええと、」
said Gabriel,	ゲイブリエルは言った、
"if it comes to that, you know, Irish is not my language."	「そういうことになるとしても、ね、アイルランド語は僕の言葉ではないから。」
Their neighbours had turned to listen to the cross- examination.	まわりの人たちが厳しい追及を聞こうと顔を向けていた。
Gabriel glanced right and left nervously and tried to keep his good humour under the ordeal which was making a blush invade his forehead.	ゲイブリエルは神経質に左右をちらっと見て、彼の額に赤みを押し広げている苦しい試練の下、上機嫌を保とうとしていた。
"And haven't you your own land to visit,"	「それに訪れなくていいの、」
continued Miss Ivors,	ミス・アイバースは続けた、
"that you know nothing of, your own people, and your own country?"	「あなたが何も知らないあなた自身の地を、あなた自身の兄弟を、あなた自身の祖国を？」
"0, to tell you the truth,"	「おう、実のところ、」
retorted Gabriel suddenly,	ゲイブリエルは不意に言い返した、
"I'm sick of my own country, sick of it!"	「僕は自分自身の国にうんざりしているんだ、うんざりなんだ！」
"Why?"	「なぜ？」
asked Miss Ivors.	ミス・アイバースが尋ねた。
Gabriel did not answer for his retort had heated him.	ゲイブリエルは反駁して興奮していたので答えなかった。
"Why?"	「なぜ？」
repeated Miss Ivors.	とミス・アイバースは繰り返した。
They had to go visiting together and, as he had not answered her, Miss Ivors said warmly:	彼らは共にほかの組に近づかなければならず、彼が答えなかったので、ミス・アイバースは熱くなって言った。
"Of course, you've no answer."	「もちろん、答えられないわね。」
Gabriel tried to cover his agitation by taking part in the dance with great energy.	ゲイブリエルは動揺を隠そうとして非常に精力的にダンスをこなした。
He avoided her eyes for he had seen a sour expression on her face.	彼は彼女の顔に不機嫌な表情を見たので彼女の目を避けた。
But when they met in the long chain he was surprised to feel his hand firmly pressed.	しかし彼らが長いチェインで接触したとき、彼は手を固く握られたのを感じて驚いた。
She looked at him from under her brows for a moment quizzically until he smiled.	彼女は彼が微笑むまでのちょっとの間、眉の下からいぶかしげに彼を眺めた。
Then, just as the chain was about to start again, she stood on tiptoe and whispered into his ear:	それから、ちょうどチェインが再び始まろうとしかけた時、彼女はつま先立ちで彼の耳にささやいた。
"West Briton!"	「ウェストブリトン！」
When the lancers were over Gabriel went away to a remote corner of the room where Freddy Malins' mother was sitting.	ランサーズが終わるとゲイブリエルはフレディ・マリンズの母親が座っている部屋の遠くの隅へと立ち去った。
She was a stout feeble old woman with white hair.	彼女は太ってからだの弱った白髪の老婦人だった。
Her voice had a catch in it like her son's and she stuttered slightly.	彼女の声には息子と同じように引っかかりがあり、また彼女は少しどもっていた。
She had been told that Freddy had come and that he was nearly all right.	彼女はフレディが来ていること、彼がほとんど大丈夫なことを聞かされていた。
Gabriel asked her whether she had had a good crossing.	ゲイブリエルは彼女に渡航は快適だったかと尋ねた。
She lived with her married daughter in Glasgow and came to Dublin on a visit once a year.	彼女は結婚した娘とグラスゴーに住んでいて、年に一度、ダブリンに来て滞在した。
She answered placidly that she had had a beautiful crossing and that the captain had been most attentive to her.	彼女は船旅はすばらしく船長は彼女にとても親切だったと穏やかに答えた。
She spoke also of the beautiful house her daughter kept in Glasgow, and of all the friends they had there.	彼女はまた、娘が守るグラスゴーのすばらしい家について、そしてそこにいる友達みんなについて話した。
While her tongue rambled on Gabriel tried to banish from his mind all memory of the unpleasant incident with Miss Ivors.	彼女が取りとめなくしゃべる間、ゲイブリエルはミス・アイバースとの不愉快な出来事の記憶をすべて心から追い払おうとした。
Of course the girl or woman, or whatever she was, was an enthusiast but there was a time for all things.	もちろん、あの娘というか女というか、何であるにせよ彼女は、熱狂家ではあるが、何事にも時というものがある。
Perhaps he ought not to have answered her like that.	おそらく彼はあんなふうに答えるべきではなかったのだろう。
But she had no right to call him a West Briton before people, even in joke.	しかし彼女にはたとえジョークにせよ、人前で彼をウェストブリトンと呼ぶ権利はない。
She had tried to make him ridiculous before people, heckling him and staring at him with her rabbit's eyes.	彼女はうるさく質問したりあのウサギの目でじろじろ見たりして、人前で彼を笑いものにしようとしたのだ。
He saw his wife making her way towards him through the waltzing couples.	彼は妻が、ワルツを踊るカップルたちの間を彼の方へ進んでくるのを見た。
When she reached him she said into his ear:	彼のところに着いた彼女は彼に耳打ちした。
"Gabriel.	「ゲイブリエル。
Aunt Kate wants to know won't you carve the goose as usual.	あなたがいつものようにガチョウを切り分けてくれるかケイト叔母さんが聞いてくれって。
Miss Daly will carve the ham and I'll do the pudding."	ミス・デイリーが豚のもも肉を切るし、私はプディングをやるわ。」
"All right,"	「オーケー」
said Gabriel.	とゲイブリエルは言った。
"She's sending in the younger ones first as soon as this waltz is over so that we'll have the table to ourselves."	「彼女がこのワルツが終わり次第まず若い人たちを部屋に入れて、それから私たち食事が取れるわ。」
"Were you dancing?"	「君は踊っていた？」
asked Gabriel.	とゲイブリエルは尋ねた。
"Of course I was.	「もちろん踊ったわ。
Didn't you see me?	見なかった？
What row had you with Molly Ivors?"	あなたはモリー・アイバースと何をけんかしたの？」
"No row.	「けんかなんかしないよ。
Why?	何で？
Did she say so?"	彼女がそう言った？」
"Something like that.	「そのようなことをね。
I'm trying to get that Mr. D'Arcy to sing.	私はあのダーシーさんに歌ってもらおうと思うの。
He's full of conceit, I think."	彼はすごいうぬぼれ屋のようね。」
"There was no row,"	「けんかなんかなかったよ、」
said Gabriel moodily,	ゲイブリエルはむっつりとして言った、
"only she wanted me to go for a trip to the west of Ireland and I said I wouldn't."	「ただ彼女が僕を西アイルランドへの旅行に誘ったんだが僕はその気はないと言ったんだ。」
His wife clasped her hands excitedly and gave a little jump.	彼女は興奮して手を握りしめ、ちょっとジャンプした。
"O, do go, Gabriel,"	「おお、ぜひ行きましょう、ゲイブリエル」
she cried.	と彼女は叫んだ。
"I'd love to see Galway again."	「またゴールウェイを見に行きたいわ。」
"You can go if you like,"	「よかったら君は行けばいい」
said Gabriel coldly.	とゲイブリエルは冷たく言った。
She looked at him for a moment, then turned to Mrs. Malins and said:	彼女はちょっとの間彼を見ていたが、それからマリンズ夫人の方を向いて言った。
"There's a nice husband for you, Mrs. Malins."	「素敵なご主人でしょう、マリンズさん。」
While she was threading her way back across the room Mrs. Malins, without adverting to the interruption, went on to tell Gabriel what beautiful places there were in Scotland and beautiful scenery.	彼女が部屋を縫うように横切り戻っていく間、マリンズ夫人は中断を意に介さず、スコットランドにはどんなに美しいところ、美しい風景があるかをゲイブリエルに話し続けていた。
Her son-in-law brought them every year to the lakes and they used to go fishing.	彼女の婿が毎年彼女たちを湖に連れていき、みんなでいつも釣りをしに行く。
Her son-in-law was a splendid fisher.	娘婿は釣りの名人だ。
One day he caught a beautiful big fish and the man in the hotel cooked it for their dinner.	いつか彼はすばらしい大きな大きな魚を捕まえ、ホテルの人がそれをディナーに料理してくれた。
Gabriel hardly heard what she said.	ゲイブリエルは彼女が言ったことをほとんど聞いていなかった。
Now that supper was coming near he began to think again about his speech and about the quotation.	今や夜食が近づいたので、彼は再びスピーチのことを、あの引用のことを考え始めた。
When he saw Freddy Malins coming across the room to visit his mother Gabriel left the chair free for him and retired into the embrasure of the window.	フレディ・マリンズが母親に挨拶するために部屋を横切ってくるのを見てゲイブリエルは彼のために椅子をあけ、窓のくぼみのところに退いた。
The room had already cleared and from the back room came the clatter of plates and knives.	部屋は既にがらんとして、奥の部屋からは皿やナイフのガチャガチャ鳴る音が聞こえた。
Those who still remained in the drawing room seemed tired of dancing and were conversing quietly in little groups.	まだ客間に残っている人たちは踊り飽きたらしく、小人数に分かれて静かに談話を交わしていた。
Gabriel's warm trembling fingers tapped the cold pane of the window.	ゲイブリエルの熱く震える指は冷たい窓ガラスをコツコツ叩いた。
How cool it must be outside!	さぞかし外はひんやりするだろう！
How pleasant it would be to walk out alone, first along by the river and then through the park!	一人で外を歩いたらどんなに気持ちよかろう、まずは川沿いに、それから公園を通って！
The snow would be lying on the branches of the trees and forming a bright cap on the top of the Wellington Monument.	雪は木々の枝に積もり続け、ウェリントンの記念碑のてっぺんに輝く帽子を形作っているだろう。
How much more pleasant it would be there than at the supper-table!	夜食の席よりどんなにか気持ちよかろう！
He ran over the headings of his speech:	彼はスピーチの項目をざっと見直した。
Irish hospitality, sad memories, the Three Graces, Paris, the quotation from Browning.	アイルランド人の親切なもてなし、悲しい思い出、三美神、パリス、ブラウニングからの引用。
He repeated to himself a phrase he had written in his review:	彼は評論に書いた言葉を胸のうちで繰り返した。
"One feels that one is listening to a thought- tormented music."	「人は思想の苦しむ調べに耳を傾ける自分を感じる。」
Miss Ivors had praised the review.	ミス・アイバースは評論を称賛した。
Was she sincere?	心からなのか？
Had she really any life of her own behind all her propagandism?	あの政治的宣伝主義にほかならぬものの後ろに彼女自身の生活が本当にあるのか？
There had never been any ill-feeling between them until that night.	その夜以前、彼らの間に悪感情は決してなかった。
It unnerved him to think that she would be at the supper-table, looking up at him while he spoke with her critical quizzing eyes.	彼女が夕食の席にいて、彼が話す間彼を批判的な詰問するような目で見上げることを考えると彼は怖気づいた。
Perhaps she would not be sorry to see him fail in his speech.	たぶん彼女は彼がスピーチを失敗するのを見ても気の毒には思わないだろう。
An idea came into his mind and gave him courage.	ある考えが心に浮かんで彼を勇気づけた。
He would say, alluding to Aunt Kate and Aunt Julia:	ケイト叔母とジュリア叔母をほのめかして彼は言うのだ、
"Ladies and Gentlemen, the generation which is now on the wane among us may have had its faults but for my part I think it had certain qualities of hospitality, of humour, of humanity, which the new and very serious and hypereducated generation that is growing up around us seems to me to lack."	「皆さん、今、私たちの間で衰えつつある世代に欠点はあったかもしれませんが、私の考えでは彼らは親切なもてなし、ユーモア、人間愛といった性質を持っており、それは私たちの周りに育ちつつある新しい、非常にまじめな、過剰な教育を受けた世代には欠けているように思えます。」
Very good:	とてもいい。
that was one for Miss Ivors.	ミス・アイバースへのあてつけだ。
What did he care that his aunts were only two ignorant old women?	彼の叔母たちがただの二人の無知な老婦人だとて彼が何をかまうものか。
A murmur in the room attracted his attention.	部屋のざわめきが彼の注意を引いた。
Mr. Browne was advancing from the door, gallantly escorting Aunt Julia, who leaned upon his arm, smiling and hanging her head.	ブラウン氏が、彼の腕に寄りかかり、微笑み、頭を垂れているジュリア叔母を丁重にエスコートしながらドアから進み出ていた。
An irregular musketry of applause escorted her also as far as the piano and then, as Mary Jane seated herself on the stool, and Aunt Julia, no longer smiling, half turned so as to pitch her voice fairly into the room, gradually ceased.	不規則な小銃射撃のような拍手喝采もまたピアノのところまで彼女に付き添い、その後それは、メアリー・ジェーンがスツールに着席し、そしてジュリア叔母がもはや微笑みを消して室内にはっきりとした声を響かせるために半ば向き直ると、次第にやんでいった。
Gabriel recognised the prelude.	ゲイブリエルは前奏曲に覚えがあった。
It was that of an old song of Aunt Julia's	ジュリア叔母のあの懐かしい歌
--Arrayed for the Bridal.	−−『花嫁の衣装を着て』だった。
Her voice, strong and clear in tone, attacked with great spirit the runs which embellish the air and though she sang very rapidly she did not miss even the smallest of the grace notes.	彼女の声は力強く、さえた音色で、すばらしい気迫でメロディーを装飾するルラードに取り掛かり、そして非常に速いテンポにもかかわらず、彼女は最も小さな装飾音さえ飛ばさずに歌った。
To follow the voice, without looking at the singer's face, was to feel and share the excitement of swift and secure flight.	歌い手の顔を見ることなく声を追うと、迅速で確かな飛翔の興奮を感じ、共有できた。
Gabriel applauded loudly with all the others at the close of the song and loud applause was borne in from the invisible supper-table.	ゲイブリエルは歌が終わった時、他の皆と共に大きな拍手喝采を送り、また大きな喝采は見えない夜食のテーブルからも聞こえてきた。
It sounded so genuine that a little colour struggled into Aunt Julia's face as she bent to replace in the music-stand the old leather-bound songbook that had her initials on the cover.	その響きは心からのものであり、表紙に彼女のイニシャルのある古い革張りの歌の本を譜面台に戻すためにかがんだジュリア叔母の顔にも赤らみがやっとかすかに浮かんだ。
Freddy Malins, who had listened with his head perched sideways to hear her better, was still applauding when everyone else had ceased and talking animatedly to his mother who nodded her head gravely and slowly in acquiescence.	フレディ・マリンズは、よく聞こえるように首を斜めにして耳を傾けていたが、他の皆がやめてもまだ拍手を続け、生き生きとして母親に話しかけていたが、彼女は逆らわず、重々しくゆっくりとうなずいていた。
At last, when he could clap no more, he stood up suddenly and hurried across the room to Aunt Julia whose hand he seized and held in both his hands, shaking it when words failed him or the catch in his voice proved too much for him.	とうとう、もう手を叩けないとなると彼は突然立ち上がって急いでジュリア叔母のところへと部屋を横切り、彼女の手をつかんで両手で握り、言葉が出ない、あるいは声が引っかかってどうにもならないとなると、それを揺すぶっていた。
"I was just telling my mother,"	「今も母に言っていたところです、」
he said,	彼は言った、
"I never heard you sing so well, never.	「こんなに上手に歌うのを聞いたことはありません、決して。
No, I never heard your voice so good as it is tonight.	いや、今夜のように見事なあなたの声を聞いたことがありません。
Now!	さあ！
Would you believe that now?	もう信じてください。
That's the truth.	本当です。
Upon my word and honour that's the truth.	名誉にかけて誓って本当です。
I never heard your voice sound so fresh and so...	僕は聞いたことがない、あなたの声がとても生き生きとして、そしてとても・・・
so clear and fresh, never."	とてもさえざえとして生き生きとして、決して。」
Aunt Julia smiled broadly and murmured something about compliments as she released her hand from his grasp.	ジュリア叔母は彼に握られた手を振りほどきながら、口を大きく開けて笑い、賛辞について何か小声で言った。
Mr. Browne extended his open hand towards her and said to those who were near him in the manner of a showman introducing a prodigy to an audience:	ブラウン氏は広げた手を彼女の方に伸ばし、近くにいる人たちに、聴衆に驚嘆すべきものを紹介する興行師のように言った。
"Miss Julia Morkan, my latest discovery!"	「ミス・ジュリア・モーカン、我が最新の発見です！」
He was laughing very heartily at this himself when Freddy Malins turned to him and said:	彼がこう言って自分で思う存分たっぷりと笑っていると、フレディ・マリンズが彼の方を向いて言った。
"Well, Browne, if you're serious you might make a worse discovery.	「ねえ、ブラウン、君が真剣としてもこれ以上の発見はするまいよ。
All I can say is I never heard her sing half so well as long as I am coming here.	僕に言えるのは、僕がここに来ている間、この半分も上手に彼女が歌うのを聞いたことがない、ということだけだ。
And that's the honest truth."	そしてそれは嘘偽りない真実だ。」
"Neither did I,"	「私だってそう思う」
said Mr. Browne.	とブラウン氏は言った。
"I think her voice has greatly improved."	「彼女の声は大いに良くなったと思うよ。」
Aunt Julia shrugged her shoulders and said with meek pride:	ジュリア叔母は肩をすくめ、おとなしい自尊心をのぞかせて言った。
"Thirty years ago I hadn't a bad voice as voices go."	「声ということでは三十年前は私、悪い声ではなかったわ。」
"I often told Julia,"	「よくジュリアに言ったものよ、」
said Aunt Kate emphatically,	ケイト叔母が力を込めて言った、
"that she was simply thrown away in that choir.	「あの聖歌隊にただ使い捨てにされるだけと。
But she never would be said by me."	でも彼女は決して私に耳を貸さなかった。」
She turned as if to appeal to the good sense of the others against a refractory child while Aunt Julia gazed in front of her, a vague smile of reminiscence playing on her face.	彼女は手に負えない子どもに対抗して他の人たちの良識に訴えるかのように振り向いたが、ジュリア叔母の方は前をじっと見つめ、追憶によるあいまいな微笑が顔にゆらめいていた。
"No,"	「そうよ、」
continued Aunt Kate,	ケイト叔母は続けた、
"she wouldn't be said or led by anyone, slaving there in that choir night and day, night and day.	「彼女は誰に言われたって聞かないで、昼も夜も、昼も夜も、あの聖歌隊で奴隷のように働いた。
Six o'clock on Christmas morning!	クリスマスの朝の六時！
And all for what?"	そしてみんな何のため？」
"Well, isn't it for the honour of God, Aunt Kate?"	「あら、それは神の栄光のためじゃない、ケイト叔母さん？」
asked Mary Jane, twisting round on the piano-stool and smiling.	とメアリー・ジェーンが、ピアノのスツールの上でからだをねじって微笑みながら尋ねた。
Aunt Kate turned fiercely on her niece and said:	ケイト叔母は猛烈な勢いで姪に向かって言った。
"I know all about the honour of God, Mary Jane, but I think it's not at all honourable for the pope to turn out the women out of the choirs that have slaved there all their lives and put little whipper-snappers of boys over their heads.	「神の栄光についてはよおく知ってますよ、メアリー・ジェーン、でも生涯奴隷のように働いた女たちを聖歌隊から追い出し、彼女たちをさしおいて小生意気な少年たちを据えるなんてちっとも教皇の名誉にならないと思うわ。
I suppose it is for the good of the Church if the pope does it.	教皇がそうするんだったらそれは教会のためなんでしょう。
But it's not just, Mary Jane, and it's not right."	でも公正じゃないわ、メアリー・ジェーン、そして正当じゃないわ。」
She had worked herself into a passion and would have continued in defence of her sister for it was a sore subject with her but Mary Jane, seeing that all the dancers had come back, intervened pacifically:	彼女はそのことで心を痛めていたので次第に激昂し、妹の擁護を続けるつもりでいたが、メアリー・ジェーンは踊り手が皆戻ってきたのを見て、平和的に介入した。
"Now, Aunt Kate, you're giving scandal to Mr. Browne who is of the other persuasion."	「ほら、ケイト叔母さん、宗派が違うブラウンさんの反感を買ってますよ。」
Aunt Kate turned to Mr. Browne, who was grinning at this allusion to his religion, and said hastily:	ケイト叔母は、この、彼の宗教への言及ににやついているブラウン氏の方を向いて急いで言った。
"O, I don't question the pope's being right.	「ああ、教皇の正しいことを疑うわけじゃないんですの。
I'm only a stupid old woman and I wouldn't presume to do such a thing.	私はただのばかな年寄り女ですし、そのようなことをしようとは考えてもいません。
But there's such a thing as common everyday politeness and gratitude.	でも普通の日常の礼儀とか感謝とかがあるじゃないですか。
And if I were in Julia's place I'd tell that Father Healey straight up to his face..."	だから私がジュリアの立場だったらあのヒーリー神父にまっすぐ面と向かって言って・・・」
"And besides, Aunt Kate,"	「その上にね、ケイト叔母さん、」
said Mary Jane,	メアリー・ジェーンが言った、
"we really are all hungry and when we are hungry we are all very quarrelsome."	「私たち本当にみんなお腹がすいているし、お腹がすいている時は私たちみんなすごくけんか腰になるわ。」
"And when we are thirsty we are also quarrelsome,"	「それとのどが渇いた時も私たちはやはりけんか腰ですな」
added Mr. Browne.	とブラウン氏が付け加えた。
"So that we had better go to supper,"	「だから私たち夜食にした方がいいわね、」
said Mary Jane,	メアリー・ジェーンは言った、
"and finish the discussion afterwards."	「そして討論はその後済ましましょう。」
On the landing outside the drawing-room Gabriel found his wife and Mary Jane trying to persuade Miss Ivors to stay for supper.	ゲイブリエルが客間の外の踊り場に出ると、妻とメアリー・ジェーンが夜食に残るようにとミス・アイバースを説得しようとしていた。
But Miss Ivors, who had put on her hat and was buttoning her cloak, would not stay.	しかしミス・アイバースは帽子をかぶり、マントのボタンをかけ、とどまろうとしなかった。
She did not feel in the least hungry and she had already overstayed her time.	彼女はちっともお腹がすいていないし、もう予定より長居してしまったのだった。
"But only for ten minutes, Molly,"	「でもほんの十分、モリー」
said Mrs. Conroy.	とコンロイ夫人は言った。
"That won't delay you."	「それで遅くなりはしないわ。」
"To take a pick itself,"	「つつくだけでも、」
said Mary Jane,	メアリー・ジェーンが言った、
"after all your dancing."	「あれだけ踊った後ですもの。」
"I really couldn't,"	「ほんとにだめなの」
said Miss Ivors.	とミス・アイバースは言った。
"I am afraid you didn't enjoy yourself at all,"	「少しも楽しく過ごせなかったのじゃないかしら」
said Mary Jane hopelessly.	とメアリー・ジェーンが絶望して言った。
"Ever so much, I assure you,"	「とっても楽しかったわ、ほんとよ、」
said Miss Ivors,	ミス・アイバースは言った、
"but you really must let me run off now."	「でも本当にもう帰らせて。」
"But how can you get home?"	「でもどうやって家まで帰り着くの？」
asked Mrs. Conroy.	とコンロイ夫人が尋ねた。
"O, it's only two steps up the quay."	「おお、河岸沿いをほんの一足だもの。」
Gabriel hesitated a moment and said:	ゲイブリエルはちょっとちゅうちょして言った。
"If you will allow me, Miss Ivors, I'll see you home if you are really obliged to go."	「よかったら、ミス・アイバース、本当に行かなくちゃならないなら僕が家へ送りましょう。」
But Miss Ivors broke away from them.	しかしミス・アイバースは彼らから逃げ出した。
"I won't hear of it,"	「とんでもないわ」
she cried.	と彼女は叫んだ。
"For goodness' sake go in to your suppers and don't mind me.	「お願いだから夜食にいらして、そして私のことはおかまいなく。
I'm quite well able to take care of myself."	私は自分の面倒はよおっく見られますから。」
"Well, you're the comical girl, Molly,"	「まあ、あなたっておかしな娘ね、モリー」
said Mrs. Conroy frankly.	とコンロイ夫人が率直に言った。
"Beannacht libh,"	「ごきげんよう！」
cried Miss Ivors, with a laugh, as she ran down the staircase.	とミス・アイバースは笑って階段を駆け下りながらゲール語で叫んだ。
Mary Jane gazed after her, a moody puzzled expression on her face, while Mrs. Conroy leaned over the banisters to listen for the hall-door.	メアリー・ジェーンはむっつりとした当惑の表情を顔に浮かべじっと彼女を目で追っていたが、コンロイ夫人は手すりから身を乗り出して玄関のドアに聞き耳を立てていた。
Gabriel asked himself was he the cause of her abrupt departure.	ゲイブリエルは彼女が唐突に出て行ったのは彼が原因かと自問した。
But she did not seem to be in ill humour:	しかし彼女は不機嫌には見えなかった。
she had gone away laughing.	彼女は笑いながら行ったのだから。
He stared blankly down the staircase.	彼はぼんやりと階段を見つめていた。
At the moment Aunt Kate came toddling out of the supper-room, almost wringing her hands in despair.	その時ケイト叔母が夜食の部屋から絶望に手を絞らんばかりにして、よちよちと現れた。
"Where is Gabriel?"	「ゲイブリエルはどこなの？」
she cried.	彼女は叫んだ。
"Where on earth is Gabriel?	「いったいゲイブリエルはどこ？
There's everyone waiting in there, stage to let, and nobody to carve the goose!"	あちらで皆さん待っているのよ、幕は開いたわ、誰もガチョウを切り分ける人がいないの！」
"Here I am, Aunt Kate!"	「ここにいますよ、ケイト叔母さん！」
cried Gabriel, with sudden animation,	ゲイブリエルは突然活気をおびて叫んだ、
"ready to carve a flock of geese, if necessary."	「必要ならガチョウの群れでも喜んで切り分けますよ。」
A fat brown goose lay at one end of the table and at the other end, on a bed of creased paper strewn with sprigs of parsley, lay a great ham, stripped of its outer skin and peppered over with crust crumbs, a neat paper frill round its shin and beside this was a round of spiced beef.	太った茶色のガチョウがテーブルの一方の端に置かれ、他方の端にはひだをつけた紙にパセリの小枝をまき散らしたベッドの上に大きな豚のもも肉が外側の皮をむかれ、パンの皮の粉と共にコショウで味付けされて置かれ、そのすねの周りにはこぎれいな紙飾り、そしてこのそばにはスパイスされた牛のもも肉があった。
Between these rival ends ran parallel lines of side-dishes:	これら対抗する両端の間には、添え料理が平行線上に並んでいた。
two little minsters of jelly, red and yellow;	赤と黄色のゼリーでできた小さな聖堂が二つ、
a shallow dish full of blocks of blancmange and red jam, a large green leaf-shaped dish with a stalk-shaped handle, on which lay bunches of purple raisins and peeled almonds, a companion dish on which lay a solid rectangle of Smyrna figs, a dish of custard topped with grated nutmeg, a small bowl full of chocolates and sweets wrapped in gold and silver papers and a glass vase in which stood some tall celery stalks.	ブランマンジェの塊と赤いジャムでいっぱいの平皿、茎の形の柄のついた大きな緑の葉の形の皿の上には紫のレーズンの房と皮をむいたアーモンドが置かれ、対の皿にはスミュルナイチジクがぎっしり長方形に並べられ、ナツメグをすりおろしてかけたカスタードが一皿、金や銀の紙にくるんだチョコレートやキャンディーをいっぱいにした小さなボール、そして細長いセロリの茎を入れたガラスの瓶。
In the centre of the table there stood, as sentries to a fruit-stand which upheld a pyramid of oranges and American apples, two squat old-fashioned decanters of cut glass, one containing port and the other dark sherry.	テーブルの中央には、オレンジとアメリカリンゴのピラミッドを支えるフルーツ台の歩哨として、二つのずんぐりした古風なカットグラスのデカンターが立ち、一方にはポートワインが、他方には色の濃いシェリー酒が入っていた。
On the closed square piano a pudding in a huge yellow dish lay in waiting and behind it were three squads of bottles of stout and ale and minerals, drawn up according to the colours of their uniforms, the first two black, with brown and red labels, the third and smallest squad white, with transverse green sashes.	閉じたスクエアピアノの上には巨大な黄色い皿のプディングが侍し、その後にはスタウトとエールとミネラルウォーターの三分隊の瓶が、初めの二つは茶と赤のラベルのついた黒、三つ目のもっとも小さな分隊は緑の帯の横断する白、というふうにその制服の色に従って整列していた。
Gabriel took his seat boldly at the head of the table and, having looked to the edge of the carver, plunged his fork firmly into the goose.	ゲイブリエルは大胆に上座に着き、肉切り包丁の刃に注意を向けながら、ガチョウにフォークをしっかりと突き刺した。
He felt quite at ease now	彼は今やずっと気楽だった。
for he was an expert carver and liked nothing better than to find himself at the head of a well-laden table.	というのも彼は肉を切るのは熟練していたし、たっぷりごちそうのある席の上座に着くのは何より好きだった。
"Miss Furlong, what shall I send you?"	「ミス・ファーロング、あなたには何を差し上げましょう？」
he asked.	と彼は尋ねた。
"A wing or a slice of the breast?"	「手羽先、それとも胸肉のスライス？」
"Just a small slice of the breast."	「胸肉のスライスをほんの少し。」
"Miss Higgins, what for you?"	「ミス・ヒギンズ、あなたには何を？」
"O, anything at all, Mr. Conroy."	「ああ、何でも、コンロイさん。」
While Gabriel and Miss Daly exchanged plates of goose and plates of ham and spiced beef Lily went from guest to guest with a dish of hot floury potatoes wrapped in a white napkin.	ゲイブリエルとミス・デイリーがガチョウの皿と豚のもも肉とスパイスをしたビーフの皿をやり取りする間、リリーは白いナプキンに包んだ熱い粉ふきジャガイモの皿を客から客へと持っていった。
This was Mary Jane's idea and she had also suggested apple sauce for the goose but Aunt Kate had said that plain roast goose without any apple sauce had always been good enough for her and she hoped she might never eat worse.	これはメアリー・ジェーンのアイデアで、彼女はまたガチョウにアップルソースをと提案したが、ケイト叔母がアップルソースなんかつけないあっさりした焼いたガチョウでいつも十分おいしかったし、下手なことをするなら食べないほうがいいと言った。
Mary Jane waited on her pupils and saw that they got the best slices and Aunt Kate and Aunt Julia opened and carried across from the piano bottles of stout and ale for the gentlemen and bottles of minerals for the ladies.	メアリー・ジェーンは彼女の教え子たちの給仕をし、彼らが一切れずつ好きなのを選び取れるよう気をつけていたが、ケイト叔母とジュリア叔母はピアノから、殿方にはスタウトとエールの瓶を、ご婦人方にはミネラルウォーターの瓶を開け、持って行き来した。
There was a great deal of confusion and laughter and noise, the noise of orders and counter-orders, of knives and forks, of corks and glass-stoppers.	混乱に笑い声に騒音、注文や注文取りの、ナイフやフォークの、コルク栓やガラス栓の騒音でいっぱいだった。
Gabriel began to carve second helpings as soon as he had finished the first round without serving himself.	ゲイブリエルは最初の一回りを終えると自分の分を取らずにすぐにお代わりを切り始めた。
Everyone protested loudly so that he compromised by taking a long draught of stout for he had found the carving hot work.	皆が大声で抗議したので、肉を切るのはきつい仕事ととわかっていた彼はたっぷり注いだスタウトを飲むことで妥協した。
Mary Jane settled down quietly to her supper but Aunt Kate and Aunt Julia were still toddling round the table, walking on each other's heels, getting in each other's way and giving each other unheeded orders.	メアリー・ジェーンは落ち着いて食事に取り掛かったが、ケイト叔母とジュリア叔母は相変わらずよちよちとテーブルを回って、後になり先になりして歩き、互いに邪魔をして、互いに留意されない命令を出していた。
Mr. Browne begged of them to sit down and eat their suppers and so did Gabriel but they said there was time enough, so that, at last, Freddy Malins stood up and, capturing Aunt Kate, plumped her down on her chair amid general laughter.	ブラウン氏が彼らに席について食事をとるように懇願し、ゲイブリエルもそう言ったが、彼らは時間は十分にあると言い、それで、ついには、フレディ・マリンズが立ち上がり、ケイト叔母をなんとかとらえ、皆の笑いの中、彼女の席にどさっと下ろした。
When everyone had been well served Gabriel said, smiling:	皆に十分食べ物がいきわたったところでゲイブリエルが微笑みながら言った。
"Now, if anyone wants a little more of what vulgar people call stuffing let him or her speak."	「さて、どなたか俗に言う丸焼きをいま少しお望みでしたらそう言ってください。」
A chorus of voices invited him to begin his own supper and Lily came forward with three potatoes which she had reserved for him.	一斉に声が上がって彼に自分の食事を始めるように請い、リリーが彼のために取っておいたジャガイモ三つを持って進み出た。
"Very well,"	「大変結構、」
said Gabriel amiably, as he took another preparatory draught,	ゲイブリエルは、予備のもう一杯を飲みながら愛想よく言った、
"kindly forget my existence, ladies and gentlemen, for a few minutes."	「皆さん、どうか数分間、僕の存在を忘れてください。」
He set to his supper and took no part in the conversation with which the table covered Lily's removal of the plates.	彼は夜食に着手し、リリーによる皿の移動を覆い隠すテーブルを囲む人たちの会話にも加わらなかった。
The subject of talk was the opera company which was then at the Theatre Royal.	話題になっていたのはその時王立劇場に来ていたオペラの劇団だった。
Mr. Bartell D'Arcy, the tenor, a dark- complexioned young man with a smart moustache, praised very highly the leading contralto of the company but Miss Furlong thought she had a rather vulgar style of production.	バーテル・ダーシー氏、テノールの、浅黒い肌、スマートな口ひげの若い男は、劇団の主役のコントラルトを非常に高く称えたが、ミス・ファーロングは彼女の演技のスタイルはむしろ俗悪だと思った。
Freddy Malins said there was a Negro chieftain singing in the second part of the Gaiety pantomime who had one of the finest tenor voices he had ever heard.	フレディ・マリンズがゲイアティの芝居の二部で歌っていた黒人の酋長はかって聞いた中でも最も見事なテノールだったと言った。
"Have you heard him?"	「あなたは彼のを聞きましたか？」
he asked Mr. Bartell D'Arcy across the table.	と彼はテーブル越しにバーテル・ダーシー氏に尋ねた。
"No,"	「いや」
answered Mr. Bartell D'Arcy carelessly.	とバーテル・ダーシー氏はぞんざいに答えた。
"Because,"	「というのは、」
Freddy Malins explained,	フレディ・マリンズが説明した、
"now I'd be curious to hear your opinion of him.	「今彼についてのあなたの意見が聞かせてもらえたらと思ったのでね。
I think he has a grand voice."	僕は彼は堂々たる声だと思います。」
"It takes Teddy to find out the really good things,"	「テディじゃなくちゃ本当にいいものは見つからないな」
said Mr. Browne familiarly to the table.	とブラウン氏がテーブルを囲む人々になれなれしく言った。
"And why couldn't he have a voice too?"	「それでなぜ彼だっていい声であってはいけないんですか？」
asked Freddy Malins sharply.	とフレディ・マリンズは鋭く尋ねた。
"Is it because he's only a black?"	「彼が黒人にすぎないから？」
Nobody answered this question and Mary Jane led the table back to the legitimate opera.	誰もこの質問には答えず、メアリー・ジェーンは一座の話題を正統なオペラに戻した。
One of her pupils had given her a pass for Mignon.	彼女の教え子の一人が彼女に『ミニョン』の入場券を贈ったのだった。
Of course it was very fine, she said, but it made her think of poor Georgina Burns.	もちろんそれはとてもすばらしかったけれどかわいそうなジョージナ・バーンズのことを考えさせられた、と彼女は言った。
Mr. Browne could go back farther still, to the old Italian companies that used to come to Dublin--Tietjens, Ilma de Murzka, Campanini, the great Trebelli, Giuglini, Ravelli, Aramburo.	ブラウン氏はさらにもっと、昔ダブリンによく来ていたイタリアの一座のことにさかのぼったのだった−−ティーチェンス、イルマ・ド・ムルズカ、カンパニーニ、偉大なトレベリ、ジャグリーニ、ラベーリ、アランブロ。
Those were the days, he said, when there was something like singing to be heard in Dublin.	あの頃はダブリンでも歌らしいものが聞けたものだった、と彼は言った。
He told too of how the top gallery of the old Royal used to be packed night after night, of how one night an Italian tenor had sung five encores to Let me like a Soldier fall, introducing a high C every time, and of how the gallery boys would sometimes in their enthusiasm unyoke the horses from the carriage of some great prima donna and pull her themselves through the streets to her hotel.	彼はまた、かっての王立劇場の天井桟敷が毎晩毎晩埋め尽くされたさまを、ある晩イタリアのテノールが必ずハイツェーを挿入して『レットミーライクアソルジャーフォール』まで五回もアンコールに応えて歌ったさまを、そして大向こうの少年たちがある時熱狂のあまりどうしても自分たちで彼女をと、ある偉大なプリマドンナの馬車の馬のくびきをはずし、ホテルまでの通りをずっと引いていったさまを語った。
Why did they never play the grand old operas now, he asked, Dinorah, Lucrezia Borgia?	彼は尋ねた、なぜ今では華やかな昔のオペラ、ディノーラ、ルクレツィア・ボルジアを演じないのか？
Because they could not get the voices to sing them:	それはそれらを歌うだけの声を獲得できないからだ。
that was why.	それが理由だ。
"Oh, well,"	「おお、でも、」
said Mr. Bartell D'Arcy,	とバーテル・ダーシー氏は言った、
"I presume there are as good singers today as there were then."	「今日でも当時と同じように良い歌手はいると私は思います。」
"Where are they?"	「どこにいます？」
asked Mr. Browne defiantly.	とブラウン氏が挑戦的に言った。
"In London, Paris, Milan,"	「ロンドン、パリ、ミラノに」
said Mr. Bartell D'Arcy warmly.	とバーテル・ダーシー氏は熱心に言った。
"I suppose Caruso, for example, is quite as good, if not better than any of the men you have mentioned."	「たとえば、カルーソーはあなたが触れられた人たちの誰かに優るとは言わないまでも、まったく同じくらいうまいと思います。」
"Maybe so,"	「そうかもしれませんな」
said Mr. Browne.	とブラウン氏は言った。
"But I may tell you I doubt it strongly."	「でもねえ強い疑いを禁じえませんね。」
"O, I'd give anything to hear Caruso sing,"	「ああ、カルーソーが歌うのを聞けるなら何でもあげるわ」
said Mary Jane.	とメアリー・ジェーンが言った。
"For me,"	「私にとっては、」
said Aunt Kate, who had been picking a bone,	骨をつついて取っていたケイト叔母が言った、
"there was only one tenor.	「テノールはただ一人だけよ。
To please me, I mean.	私のお気に入りは、という意味よ。
But I suppose none of you ever heard of him."	でもあなたたち誰も彼を聞いたことないでしょうね。」
"Who was he, Miss Morkan?"	「それは誰ですか、ミス・モーカン？」
asked Mr. Bartell D'Arcy politely.	バーテル・ダーシー氏が礼儀正しく尋ねた。
"His name,"	「彼の名は、」
said Aunt Kate,	ケイト叔母は言った、
"was Parkinson.	「パーキンソン。
I heard him when he was in his prime and I think he had then the purest tenor voice that was ever put into a man's throat."	私は彼の全盛期に聞いて、そのときの彼はかって男性ののどに与えられた中で最も澄んだテノールだと思ったわ。」
"Strange,"	「知らない」
said Mr. Bartell D'Arcy.	とバーテル・ダーシー氏は言った。
"I never even heard of him."	「名前を聞いたことすらありません。」
"Yes, yes, Miss Morkan is right,"	「そう、そうです、ミス・モーカンの言う通りです」
said Mr. Browne.	とブラウン氏が言った。
"I remember hearing of old Parkinson but he's too far back for me."	「懐かしいパーキンソンを聞いたことを思い出しますが、あまりに昔のことなので。」
"A beautiful, pure, sweet, mellow English tenor,"	「美しく、澄んで、甘く、豊かなイギリス人のテノール」
said Aunt Kate with enthusiasm.	とケイト叔母は熱狂して言った。
Gabriel having finished, the huge pudding was transferred to the table.	ゲイブリエルが済ませたので、巨大なプディングがテーブルに移された。
The clatter of forks and spoons began again.	フォークとスプーンのガチャガチャいう音が再び始まった。
Gabriel's wife served out spoonfuls of the pudding and passed the plates down the table.	ゲイブリエルの妻がプディングをスプーン一杯ずつ取り分け、皿がテーブルを回された。
Midway down they were held up by Mary Jane, who replenished them with raspberry or orange jelly or with blancmange and jam.	途中でそれらはメアリー・ジェーンに止められ、キイチゴかオレンジのゼリーあるいはブランマンジェとジャムで満たされた。
The pudding was of Aunt Julia's making and she received praises for it from all quarters	プディングはジュリア叔母が作ったもので、彼女は四方八方からそれを称賛された。
She herself said that it was not quite brown enough.	彼女自身は茶色が今ひとつだと言った。
"Well, I hope, Miss Morkan,"	「ちょっと、ミス・モーカン、」
said Mr. Browne,	ブラウン氏が言った、
"that I'm brown enough for you because, you know, I'm all brown."	「どうです、茶色なら私は十分お気に召すでしょう、だってねえ、私は紛れもないブラウンですから。」
All the gentlemen, except Gabriel, ate some of the pudding out of compliment to Aunt Julia.	紳士一同こぞって、ゲイブリエルは別だが、ジュリア叔母に敬意を表してプディングを少々食べた。
As Gabriel never ate sweets the celery had been left for him.	ゲイブリエルは決して甘いものを食べなかったので、彼にはセロリが残っていた。
Freddy Malins also took a stalk of celery and ate it with his pudding.	フレディ・マリンズもセロリの茎を取り、プディングと一緒にそれを食べた。
He had been told that celery was a capital thing for the blood and he was just then under doctor's care.	彼はセロリは血液のためにとてもよいものだと言われていたし、彼はちょうどその時医者に診てもらっていた。
Mrs. Malins, who had been silent all through the supper, said that her son was going down to Mount Melleray in a week or so.	食事の間ずっと黙っていたマリンズ夫人はが、息子が一週間かそこらたったらメラレイ山に行くことになっていると言った。
The table then spoke of Mount Melleray, how bracing the air was down there, how hospitable the monks were and how they never asked for a penny-piece from their guests.	それからテーブルの人々はメラレイ山について、いかにそこでは空気がすがすがしいか、いかに修道士が厚くもてなしてくれるか、そして何と彼らがペニー銅貨一枚、客から求めないことを話した。
"And do you mean to say,"	「それじゃ何ですか、」
asked Mr. Browne incredulously,	ブラウン氏が容易に信じないで尋ねた、
"that a chap can go down there and put up there as if it were a hotel and live on the fat of the land and then come away without paying anything?"	「男がそこへ出かけていってまるでホテルのように泊まり、贅沢に過ごしてそれで何も払わないで出てこられると言うんですか？」
"O, most people give some donation to the monastery when they leave."	「ああ、たいていの人は出発の時に修道院にいくらか寄付をしますわ」
said Mary Jane.	とメアリー・ジェーンが言った。
"I wish we had an institution like that in our Church,"	「私たちの教会にもそのような施設があればいいですなあ」
said Mr. Browne candidly.	とブラウン氏は腹蔵なく言った。
He was astonished to hear that the monks never spoke, got up at two in the morning and slept in their coffins.	彼は修道士たちが決して口をきかず、朝の二時に起きて、棺で眠ると聞いてびっくりした。
He asked what they did it for.	彼は何のために彼らがそうするのか尋ねた。
"That's the rule of the order,"	「修道会の規則ですわ」
said Aunt Kate firmly.	とケイト叔母がきっぱりと言った。
"Yes, but why?"	「そうですか、でもなぜ？」
asked Mr. Browne.	とブラウン氏は尋ねた。
Aunt Kate repeated that it was the rule, that was all.	ケイト叔母はそれは規則であり、それだけだと繰り返した。
Mr. Browne still seemed not to understand.	ブラウン氏はまだ理解できないようだった。
Freddy Malins explained to him, as best he could, that the monks were trying to make up for the sins committed by all the sinners in the outside world.	フレディ・マリンズが彼に、修道士たちは外の世界のすべての罪びとたちが犯した罪の埋め合わせをしようとしていると精一杯説明した。
The explanation was not very clear for Mr. Browne grinned and said:	その説明はあまり明瞭ではなく、ブラウン氏はにやにやして言った。
"I like that idea very much but wouldn't a comfortable spring bed do them as well as a coffin?"	「その考え方は非常に気に入ったけれど、棺もいいが快適なばねのあるベッドも彼らの役に立つんじゃないのかな？」
"The coffin,"	「棺は、」
said Mary Jane,	メアリー・ジェーンは言った、
"is to remind them of their last end."	「彼らに来るべき最期を思い起こさせるためです。」
As the subject had grown lugubrious it was buried in a silence of the table during which Mrs. Malins could be heard saying to her neighbour in an indistinct undertone:	話が陰気になってしまったのでその話題はテーブルを囲む人たちの沈黙の中に葬られたが、その間もマリンズ夫人の隣に話しかける不明瞭な小声が聞こえた。
"They are very good men, the monks, very pious men."	「彼らは非常に善良な人たちです、修道士たちは、非常に敬虔な人たちです。」
The raisins and almonds and figs and apples and oranges and chocolates and sweets were now passed about the table and Aunt Julia invited all the guests to have either port or sherry.	今度はレーズンとアーモンドとイチジクとリンゴとオレンジとチョコレートとキャンディーがテーブルのあちこちへ次々と回され、ジュリア叔母は客全員にポートワインかシェリー酒はいかがと勧めた。
At first Mr. Bartell D'Arcy refused to take either but one of his neighbours nudged him and whispered something to him upon which he allowed his glass to be filled.	バーテル・ダーシー氏は初めどちらも断ったが、隣席の一人がそっと彼をつついて何かをささやくと、それで彼はグラスを満たされるがままにした。
Gradually as the last glasses were being filled the conversation ceased.	最後に残ったグラスも満たされていくと、次第に会話もやんでいった。
A pause followed, broken only by the noise of the wine and by unsettlings of chairs.	ワインの音、落ち着かない椅子の動きだけが乱す間が続いた。
The Misses Morkan, all three, looked down at the tablecloth.	ミス・モーカンは、三人ともうつむいてテーブルクロスを見ていた。
Someone coughed once or twice and then a few gentlemen patted the table gently as a signal for silence.	誰かが一、二度せきをして、それから数人の紳士が静粛の合図としてテーブルを優しく叩いた。
The silence came and Gabriel pushed back his chair.	静寂が訪れてゲイブリエルは椅子を後に押しやった。
The patting at once grew louder in encouragement and then ceased altogether.	テーブルを叩く激励の音がすぐに大きくなり、それからすっかりやんだ。
Gabriel leaned his ten trembling fingers on the tablecloth and smiled nervously at the company.	ゲイブリエルは十本の震える指をテーブルクロスにつき、神経質に一座に微笑みかけた。
Meeting a row of upturned faces he raised his eyes to the chandelier.	居並ぶ上向きの顔、顔に出会って、彼はシャンデリアへと目を上げた。
The piano was playing a waltz tune and he could hear the skirts sweeping against the drawing-room door.	ピアノはワルツの旋律を奏で、客間のドアにぶつかってすれるスカートの音が彼には聞こえた。
People, perhaps, were standing in the snow on the quay outside, gazing up at the lighted windows and listening to the waltz music.	人々はたぶん、雪の中、外の河岸に立ち、明かりのついた窓を見上げ、ワルツの調べに聞き入っているのだろう。
The air was pure there.	そこは空気がきれいだ。
In the distance lay the park where the trees were weighted with snow.	遠くには公園があり、木々は雪でたわんでいる。
The Wellington Monument wore a gleaming cap of snow that flashed westward over the white field of Fifteen Acres.	ウェリントンの記念碑はきらきらする雪の帽子をかぶって、西の方のフィフティーン・エイカーズの白い広場の上に光を放っている。
He began:	彼は始めた。
"Ladies and Gentlemen,	「皆さん、
"It has fallen to my lot this evening, as in years past, to perform a very pleasing task but a task for which I am afraid my poor powers as a speaker are all too inadequate."	今宵も過ぎ去った年同様、私が、非常に楽しい役目を、しかし残念ながら私では話し手としてあまりに力不足と思われる役目を果たす巡り合わせになりました。」
"No, no!"	「とんでもない！」
said Mr. Browne.	とブラウン氏が言った。
"But, however that may be, I can only ask you tonight to take the will for the deed and to lend me your attention for a few moments while I endeavour to express to you in words what my feelings are on this occasion.	「しかし、そうであろうとも、私は今宵皆さんに、行為はその意志で見よの諺に倣い、この集まりにおいて私の感ずるところを言葉で言い表そうと努めるしばらくの間、私に耳をお貸しいただくようお願いするほかはありません。
"Ladies and Gentlemen, it is not the first time that we have gathered together under this hospitable roof, around this hospitable board.	皆さん、私たちがこの厚いもてなしの屋根の下に、この厚いもてなしの食卓の周りに、共に集うのは初めてではありません。
It is not the first time that we have been the recipients	私たちがある善良な婦人たちの親切なもてなしを受けたのは
--or perhaps, I had better say, the victims	−−いや、あるいは、犠牲者になったと言った方がよいかもしれません
--of the hospitality of certain good ladies."	−−初めてではありません。」
He made a circle in the air with his arm and paused.	彼は腕で空中に円を描きちょっと休止した。
Everyone laughed or smiled at Aunt Kate and Aunt Julia and Mary Jane who all turned crimson with pleasure.	誰もが、喜びに赤く染まったケイト叔母、ジュリア叔母、メアリー･ジェーンに笑いかけ、あるいは微笑みかけた。
Gabriel went on more boldly:	ゲイブリエルはさらに大胆に続けた。
"I feel more strongly with every recurring year that our country has no tradition which does it so much honour and which it should guard so jealously as that of its hospitality.	「年が巡りくるたびになおさら強く感じるのですが、我が国にはその親切なもてなしの伝統ほど、その名誉となり、油断なく死守すべき伝統はありません。
It is a tradition that is unique as far as my experience goes (and I have visited not a few places abroad) among the modern nations.	それは私の知る限り、近代国家においては（そして私はかなり多数の外国の地を訪れたことがありますが）比類なき伝統であります。
Some would say, perhaps, that with us it is rather a failing than anything to be boasted of.	あるいは私たちにとってそれは自慢できる何かというよりむしろ欠点であると言う人もあるでしょう。
But granted even that, it is, to my mind, a princely failing, and one that I trust will long be cultivated among us.	しかしたとえそうであったとしても、それは、私の考えでは、王侯の欠点であり、長く私たちの間で養われていくものであると私は信じます。
Of one thing, at least, I am sure.	一つのことを、少なくとも、私は確信します。
As long as this one roof shelters the good ladies aforesaid	この一屋根がさきに申し上げた善良な婦人たちを保護する限り
--and I wish from my heart it may do so for many and many a long year to come	−−そして私はこの先ずっとずっと長年にわたってそうなることを心から望みますが
--the tradition of genuine warm-hearted courteous Irish hospitality, which our forefathers have handed down to us and which we in turn must hand down to our descendants, is still alive among us."	−−私たちの祖先が私たちに伝え、今度は私たちが子孫に伝えなければならない、正真正銘の親切な思いやりのあるアイルランドの厚いもてなしの伝統は私たちの間にまだ生きているのです。」
A hearty murmur of assent ran round the table.	心からの同意のささやきがテーブルを走った。
It shot through Gabriel's mind that Miss Ivors was not there and that she had gone away discourteously:	ミス・アイバースがそこにいないこと、そして彼女が不作法に立ち去ったことがゲイブリエルの心をさっとかすめた。
and he said with confidence in himself:	そして彼は自信を持って言った。
"Ladies and Gentlemen,	「皆さん、
"A new generation is growing up in our midst, a generation actuated by new ideas and new principles.	新しい世代が私たちの中に育っています、新しい考え方、新しい原則に動かされる世代です。
It is serious and enthusiastic	まじめで熱狂的な世代です。
for these new ideas and its enthusiasm, even when it is misdirected, is, I believe, in the main sincere.	というのもその新しい考え方やその熱狂は、それが間違った方向に向けられた時でさえ、思うに、概して嘘偽りのないものだからです。
But we are living in a sceptical and, if I may use the phrase, a thought-tormented age:	しかし私たちは懐疑的なそして、こんな言い回しを使ってかまわなければ、思想の苦しむ時代に生きています。
and sometimes I fear that this new generation, educated or hypereducated as it is, will lack those qualities of humanity, of hospitality, of kindly humour which belonged to an older day.	そして時々私は、この、教育のある、あるいは実のところ過剰に教育のある新しい世代は、あの、より古い時代に属する人間性、親切なもてなす心、思いやりのある気性といった資質を欠くことになるのではないかと思います。
Listening tonight to the names of all those great singers of the past it seemed to me, I must confess, that we were living in a less spacious age.	今夜、すべての昔の偉大な歌手たちの名前を聞いて、私たちは広々としたところの少ない時代に生きているように思える、と告白しなければなりません。
Those days might, without exaggeration, be called spacious days:	あの頃は、誇張でなく、広々とした日々と呼んでよいでしょう。
and if they are gone beyond recall let us hope, at least, that in gatherings such as this we shall still speak of them with pride and affection, still cherish in our hearts the memory of those dead and gone great ones whose fame the world will not willingly let die."	そしてあの日々は去って取り戻すことはできないとしても、少なくとも、このような集まりで私たちはこれからも誇りと愛情を持ってあの日々ことを語り、あの、名声がこの世から消えゆくことはないであろう、亡くなった偉大な人たちの記憶をこれからも心に抱いて大事にしていこうじゃありませんか。」
"Hear, hear!"	「賛成、賛成！」
said Mr. Browne loudly.	とブラウン氏が大声で言った。
"But yet,"	「しかしそれでも、」
continued Gabriel, his voice falling into a softer inflection,	ゲイブリエルは声をより静かな音調に落として続けた、
"there are always in gatherings such as this sadder thoughts that will recur to our minds:	「このような集まりにおいていつも私たちの心に戻り来る悲しい思いがあります。
thoughts of the past, of youth, of changes, of absent faces that we miss here tonight.	過去についての、青年期についての、いろいろな変化についての、今夜残念ながらここに見られない顔についての思いです。
Our path through life is strewn with many such sad memories:	私たちの人生行路にはそのような悲しい思い出が数多く散りばめられています。
and were we to brood upon them always we could not find the heart to go on bravely with our work among the living.	そしていつもそれをくよくよ考えていては、生者の中にあって勇敢に仕事を続けていく気力が湧きません。
We have all of us living duties and living affections which claim, and rightly claim, our strenuous endeavours.	私たちには誰しも皆、生者の義務、生者の愛情があり、それには大変な努力が必要です、当然、必要です。
"Therefore, I will not linger on the past.	したがって私は過去にぐずぐずするつもりはありません。
I will not let any gloomy moralising intrude upon us here tonight.	今夜ここで憂鬱な説教に私たちの邪魔をさせるつもりもありません。
Here we are gathered together for a brief moment from the bustle and rush of our everyday routine.	ここに私たちは毎日の決まりきった仕事のせわしさ、あわただしさの中から短い時間集まりました。
We are met here as friends, in the spirit of good-fellowship, as colleagues, also to a certain extent, in the true spirit of camaraderie, and as the guests of	私たちはここに友人として、友達のよしみの気持ちで、またある意味では同僚として、真の友愛の精神で、そして
--what shall I call them?	−−彼らを何と呼んだらいいでしょう
--the Three Graces of the Dublin musical world."	−−ダブリンの音楽の世界の三美神、の客として、集まっています。」
The table burst into applause and laughter at this allusion.	テーブルを囲む人たちはこの引喩にどっと拍手喝采し、笑い出した。
Aunt Julia vainly asked each of her neighbours in turn to tell her what Gabriel had said.	ジュリア叔母は次々と隣の人たちにゲイブリエルが何と言ったのか教えてとむなしく頼んでいた。
"He says we are the Three Graces, Aunt Julia,"	「彼は私たちが三美神だと言ってるのよ、ジュリア叔母さん」
said Mary Jane.	とメアリー・ジェーンが言った。
Aunt Julia did not understand but she looked up, smiling, at Gabriel, who continued in the same vein:	ジュリア叔母はわからなかったが、顔を上げ、微笑んで、変わらぬ調子で続けるゲイブリエルを見た。
"Ladies and Gentlemen,	「皆さん、
"I will not attempt to play tonight the part that Paris played on another occasion.	私はあの時パリスが演じた役割を今宵演じてみようとは思いません。
I will not attempt to choose between them.	彼らのうちから選んでみようとは思いません。
The task would be an invidious one and one beyond my poor powers.	その仕事は公平を欠くものであり、私の乏しい能力を超えたものです。
For when I view them in turn, whether it be our chief hostess herself, whose good heart, whose too good heart, has become a byword with all who know her, or her sister, who seems to be gifted with perennial youth and whose singing must have been a surprise and a revelation to us all tonight, or, last but not least, when I consider our youngest hostess, talented, cheerful, hard-working and the best of nieces, I confess, Ladies and Gentlemen, that I do not know to which of them I should award the prize."	というのも私が彼女たちを順に、それが、その善良な心、その善良すぎる心が彼女を知る人すべての中で代名詞になってしまった主たる女主人その人なのか、それとも永遠の若さを与えられたかのような、そしてその歌声が今夜、私たちみんなにとって驚きであり新しい発見となったにちがいない彼女の妹なのかを見る時、あるいは、最後とはいえとっておき、有能、快活、勤勉にして最高の姪である私たちの最も若い女主人を考慮する時、実を言うと、皆さん、私は彼女たちのうち誰にその賞を与えるべきかわかりません。」
Gabriel glanced down at his aunts and, seeing the large smile on Aunt Julia's face and the tears which had risen to Aunt Kate's eyes, hastened to his close.	ゲイブリエルは視線を下げて叔母たちをちらっと眺め、そしてジュリア叔母の顔に広がる笑みとケイト叔母の目にあふれた涙を見て、結論を急いだ。
He raised his glass of port gallantly, while every member of the company fingered a glass expectantly, and said loudly:	彼はポートワインのグラスを勇ましく持ち上げ、集まったメンバー全員が心待ちにして指でグラスをいじる中、大きな声で言った。
"Let us toast them all three together.	「三人まとめて全員のために乾杯しましょう。
Let us drink to their health, wealth, long life, happiness and prosperity and may they long continue to hold the proud and self-won position which they hold in their profession and the position of honour and affection which they hold in our hearts."	彼らの健康、富、長命、幸福、繁栄を祝して乾杯しましょう、そして願わくは彼らの専門における誇らしい、自ら勝ち取った地位を、そして私たちの心に占める名誉と愛情ある地位を彼らが長く持ち続けますように。」
All the guests stood up, glass in hand, and turning towards the three seated ladies, sang in unison, with Mr. Browne as leader:	すべてのゲストが立ち上がり、グラスを手に、三人の座っている婦人たちの方を向き、ブラウン氏が音頭をとって斉唱した。
For they are jolly gay fellows,	陽気で素敵な仲間だから、
For they are jolly gay fellows,	陽気で素敵な仲間だから、
For they are jolly gay fellows,	陽気で素敵な仲間だから、
Which nobody can deny.	誰もそれを否定できない。
Aunt Kate was making frank use of her handkerchief and even Aunt Julia seemed moved.	ケイト叔母は遠慮なくハンカチを使い、ジュリア叔母すら感動したように見えた。
Freddy Malins beat time with his pudding-fork and the singers turned towards one another, as if in melodious conference, while they sang with emphasis:	フレディ・マリンズはプディングのフォークで拍子を取り、歌い手たちはあたかも音楽にのせた相談のように互いに向き合い、力をこめて歌った。
Unless he tells a lie,	嘘をつかない限り、
Unless he tells a lie,	嘘をつかない限り、
Then, turning once more towards their hostesses, they sang:	それから、もう一度女主人たちの方を向き、彼らは歌った。
For they are jolly gay fellows,	陽気で素敵な仲間だから、
For they are jolly gay fellows,	陽気で素敵な仲間だから、
For they are jolly gay fellows,	陽気で素敵な仲間だから、
Which nobody can deny.	誰もそれを否定できない。
The acclamation which followed was taken up beyond the door of the supper-room by many of the other guests and renewed time after time, Freddy Malins acting as officer with his fork on high.	続いて大きな喝采が夜食の部屋のドアの向こうの多くのほかのゲストにも移り、何度も何度も繰り返され、フレディ・マリンズはフォークを高々と、指揮者の役を務めていた。
The piercing morning air came into the hall where they were standing so that Aunt Kate said:	身にしみる朝の空気が彼らの立つホールに入ってきてケイト叔母が言った。
"Close the door, somebody.	「誰かドアを閉めて。
Mrs. Malins will get her death of cold."	マリンズ夫人がひどい風邪をひくわ。」
"Browne is out there, Aunt Kate,"	「ブラウンが外にいるわ、ケイト叔母さん」
said Mary Jane.	とメアリー・ジェーンが言った。
"Browne is everywhere,"	「ブラウンは神出鬼没よ」
said Aunt Kate, lowering her voice.	とケイト叔母が声を低めて言った。
Mary Jane laughed at her tone.	メアリー・ジェーンは彼女の口調を笑った。
"Really,"	「本当に、」
she said archly,	彼女はいたずらっぽく言った、
"he is very attentive."	「彼はとてもよく気がつくわ。」
"He has been laid on here like the gas,"	「彼はガス設備のようなものだったのよ、」
said Aunt Kate in the same tone,	ケイト叔母が同じ調子で言った、
"all during the Christmas."	「クリスマスの間ずっと。」
She laughed herself this time good-humouredly and then added quickly:	彼女は今度は上機嫌に笑いこけ、それから急いで付け加えた。
"But tell him to come in, Mary Jane, and close the door.	「でも彼に中に入るように言って、メアリー・ジェーン、そしてドアを閉めるように。
I hope to goodness he didn't hear me."	私の言うことが聞こえてなければいいんだけど。」
At that moment the hall-door was opened and Mr. Browne came in from the doorstep, laughing as if his heart would break.	その時玄関のドアが開き、ブラウン氏が心臓が破裂するほど笑いながら戸口の段から入ってきた。
He was dressed in a long green overcoat with mock astrakhan cuffs and collar and wore on his head an oval fur cap.	彼は紛い物のアストラカンの袖口と襟のついた緑の長いコートを着て、頭には楕円形の毛皮の帽子をかぶっていた。
He pointed down the snow-covered quay from where the sound of shrill prolonged whistling was borne in.	彼が雪をかぶった河岸を指さすと、そこから長々とした鋭い口笛が聞こえてきた。
"Teddy will have all the cabs in Dublin out,"	「テディはダブリン中の馬車を引っ張り出しちまうぞ」
he said.	と彼は言った。
Gabriel advanced from the little pantry behind the office, struggling into his overcoat and, looking round the hall, said:	ゲイブリエルがコートに苦闘しながら事務所の後の小さな食器室から進み出で、玄関ホールを見回しながら言った。
"Gretta not down yet?"	「グレタはまだ下りてこない？」
"She's getting on her things, Gabriel,"	「彼女はコートを着ているわ、ゲイブリエル」
said Aunt Kate.	とケイト叔母が言った。
"Who's playing up there?"	「誰があそこでいたずらしているんです？」
asked Gabriel.	とゲイブリエルは尋ねた。
"Nobody.	「誰も。
They're all gone."	みんな行ってしまったわ。」
"O no, Aunt Kate,"	「ああ違うわ、ケイト叔母さん」
said Mary Jane.	とメアリー・ジェーンが言った。
"Bartell D'Arcy and Miss O'Callaghan aren't gone yet."	「バーテル・ダーシーとミス・オキャラハンがまだ出ていないわ。」
"Someone is fooling at the piano anyhow,"	「とにかく誰かがピアノのところで遊んでますよ」
said Gabriel.	とゲイブリエルは言った。
Mary Jane glanced at Gabriel and Mr. Browne and said with a shiver:	メアリー・ジェーンはゲイブリエルとブラウン氏をちらっと見て体を震わせて言った。
"It makes me feel cold to look at you two gentlemen muffled up like that.	「あなた方二人がそんなふうに着込んでいるのを見ると寒さを感じるわ。
I wouldn't like to face your journey home at this hour."	この時間に帰っていただきたくないわ。」
"I'd like nothing better this minute,"	「私だったら今すぐ何よりやりたいのは、」
said Mr. Browne stoutly,	とブラウン氏は勇敢にも言った、
"than a rattling fine walk in the country or a fast drive with a good spanking goer between the shafts."	「いなかの快適な早歩きか、ながえの間に元気のいい馬をつけて飛ばす遠乗りですな。」
"We used to have a very good horse and trap at home,"	「昔は家にとてもいい馬とトラップ馬車があったわよね」
said Aunt Julia sadly.	とジュリア叔母が悲しそうに言った。
"The never-to-be-forgotten Johnny,"	「決して忘れられないジョニーね」
said Mary Jane, laughing.	とメアリー・ジェーンが笑いながら言った。
Aunt Kate and Gabriel laughed too.	ケイト叔母とゲイブリエルも笑った。
"Why, what was wonderful about Johnny?"	「ほう、ジョニーに何かすてきなことがあったんですか？」
asked Mr. Browne.	とブラウン氏が尋ねた。
"The late lamented Patrick Morkan, our grandfather, that is,"	「亡くなったパトリック・モーカン、僕らのおじいさんですがね、」
explained Gabriel,	ゲイブリエルが説明した、
"commonly known in his later years as the old gentleman, was a glue-boiler."	「晩年は老紳士としてよく知られた人でしたが、にかわを煮出していました。」
"O, now, Gabriel,"	「あら、まあ、ゲイブリエル、」
said Aunt Kate, laughing,	ケイト叔母が笑いながら言った、
"he had a starch mill."	「彼はでんぷんの製粉所を持っていたのよ。」
"Well, glue or starch,"	「まあ、にかわだかでんぷんだかです、」
said Gabriel,	ゲイブリエルが言った、
"the old gentleman had a horse by the name of Johnny.	「老紳士にはジョニーという名の馬がいました。
And Johnny used to work in the old gentleman's mill, walking round and round in order to drive the mill.	そしてジョニーはいつも老紳士の製粉所で働いていて、製粉機を動かすためにぐるぐるぐるぐると回っていました。
That was all very well;	それはまったく結構なことだったんですが。
but now comes the tragic part about Johnny.	ここからがジョニーの悲劇です。
One fine day the old gentleman thought he'd like to drive out with the quality to a military review in the park."	ある晴れた日、老紳士は公園の観兵式を見に上流の人たちと一緒に出かけたいと思いました。」
"The Lord have mercy on his soul,"	「彼の魂にお慈悲を」
said Aunt Kate compassionately.	とケイト叔母が哀れみ深い声で言った。
"Amen,"	「アーメン」
said Gabriel.	とゲイブリエルが言った。
"So the old gentleman, as I said, harnessed Johnny and put on his very best tall hat and his very best stock collar and drove out in grand style from his ancestral mansion somewhere near Back Lane, I think."	「そこで老紳士は、そういうわけで、ジョニーに馬具をつけ、いちばん上等のシルクハットといちばん上等の硬く幅広い襟を着け、堂々たるスタイルで、確かどこかバックレーンの近くの先祖代々の邸宅から乗り出しました。」
Everyone laughed, even Mrs. Malins, at Gabriel's manner and Aunt Kate said:	みんなが、マリンズ夫人さえも、ゲイブリエルの話し振りを笑い、ケイト叔母が言った。
"O, now, Gabriel, he didn't live in Back Lane, really.	「あら、まあ、ゲイブリエル、バックレーンなんかに住んでいませんでしたよ、本当に。
Only the mill was there."	ただ製粉所がそこにあっただけで。」
"Out from the mansion of his forefathers,"	「先祖の邸宅から出て、」
continued Gabriel,	ゲイブリエルは続けた、
"he drove with Johnny.	「彼はジョニーと共に行きました。
And everything went on beautifully until Johnny came in sight of King Billy's statue:	そしてジョニーがビリー王の彫像が目に入るところに来るまでは何もかも申し分なく進んだのでしたが。
and whether he fell in love with the horse King Billy sits on or whether he thought he was back again in the mill, anyhow he began to walk round the statue."	彼はビリー王が乗る馬に恋をしたのか、それとも元の製粉所に戻ったと思ったのか、とにかく彼は彫像のまわりを歩き始めました。」
Gabriel paced in a circle round the hall in his goloshes amid the laughter of the others.	ゲイブリエルは他の人たちの笑いの中をガロッシュを着けた足で、円を描いてホールをぐるっと一定歩調で歩いた。
"Round and round he went,"	「彼はぐるぐるぐるぐるとまわり、」
said Gabriel,	ゲイブリエルは言った、
"and the old gentleman, who was a very pompous old gentleman, was highly indignant.	「そして老紳士は、非常に気取った老紳士でしたので、すっかり怒ってしまいました。
'Go on, sir!	『行くんだ、こら！
What do you mean, sir?	何のつもりだ、おい？
Johnny!	ジョニー！
Johnny!	ジョニー！
Most extraordinary conduct!	なんてとっぴなことをするんだ！
Can't understand the horse!"	わからん馬だ！』」
The peal of laughter which followed Gabriel's imitation of the incident was interrupted by a resounding knock at the hall door.	ゲイブリエルのその出来事の模倣に続くとどろくような笑い声は玄関のドアに鳴り響くノックに中断させられた。
Mary Jane ran to open it and let in Freddy Malins.	メアリー・ジェーンが走っていってそれを開け、フレディ・マリンズを通した。
Freddy Malins, with his hat well back on his head and his shoulders humped with cold, was puffing and steaming after his exertions.	フレディ・マリンズは、帽子をぐっと後頭部に載せ、寒さに肩を丸め、奮闘した後なので息を切らし、湯気を立てていた。
"I could only get one cab,"	「馬車は一つしかつかまえられなかった」
he said.	と彼は言った。
"O, we'll find another along the quay,"	「おお、僕たちは河岸の方でもう一つ探すとしましょう」
said Gabriel.	とゲイブリエルが言った。
"Yes,"	「そうね」
said Aunt Kate.	とケイト叔母は言った。
"Better not keep Mrs. Malins standing in the draught."	「マリンズ夫人をすきま風の中に立たせておかないほうがいいわ。」
Mrs. Malins was helped down the front steps by her son and Mr. Browne and, after many manoeuvres, hoisted into the cab.	マリンズ夫人は息子とブラウン氏の手を借りて正面玄関の階段を下り、巧みに巧みに操られて、馬車の中に押し上げられた。
Freddy Malins clambered in after her and spent a long time settling her on the seat, Mr. Browne helping him with advice.	フレディ・マリンズは彼女の後からよじ登り、ブラウン氏の助言を受けながら彼女を席に落ち着かせるのにだいぶ時間を要した。
At last she was settled comfortably and Freddy Malins invited Mr. Browne into the cab.	やっと彼女が快適に座り、フレディ・マリンズはブラウン氏に馬車に乗るように誘った。
There was a good deal of confused talk, and then Mr. Browne got into the cab.	話は散々混乱したあげく、ブラウン氏は馬車に乗り込んだ。
The cabman settled his rug over his knees, and bent down for the address.	御者はひざ掛けをひざに置き、身をかがめて行く先を尋ねた。
The confusion grew greater and the cabman was directed differently by Freddy Malins and Mr. Browne, each of whom had his head out through a window of the cab.	混乱は大きくなり、御者は、それぞれ頭を馬車の窓から出しているフレディ・マリンズとブラウン氏から異なる指図を受けた。
The difficulty was to know where to drop Mr. Browne along the route, and Aunt Kate, Aunt Julia and Mary Jane helped the discussion from the doorstep with cross-directions and contradictions and abundance of laughter.	難しいのは道筋のどこでブラウン氏を降ろすかで、ケイト叔母とジュリア叔母とメアリー・ジェーンは戸口からいろいろ指図したり反対したり大いに笑ったりして議論を助けた。
As for Freddy Malins he was speechless with laughter.	フレディ・マリンズはと言えば笑って口がきけなかった。
He popped his head in and out of the window every moment to the great danger of his hat, and told his mother how the discussion was progressing, till at last Mr. Browne shouted to the bewildered cabman above the din of everybody's laughter:	彼は窓から頭をひょいひょい出し入れしてそのたびに帽子を危険にさらし、母親に議論の進み具合を話していたが、ついにブラウン氏が、皆がやかましく笑うのを上で聞いて当惑している御者に大声で叫んだ。
"Do you know Trinity College?"	「トリニティーカレッジを知っているかね？」
"Yes, sir,"	「はい、だんな」
said the cabman.	と御者は言った。
"Well, drive bang up against Trinity College gates,"	「それでは、トリニティーカレッジの門にどーんと乗りつけてくれ、」
said Mr. Browne,	ブラウン氏は言った、
"and then we'll tell you where to go.	「そうしたらどこへ行くか教えてやろう。
You understand now?"	わかったかな？」
"Yes, sir,"	「はい、だんな」
said the cabman.	と御者は言った。
"Make like a bird for Trinity College."	「トリニティーカレッジへスーッとやってくれ。」
"Right, sir,"	「オーケー、だんな」
said the cabman.	と御者は言った。
The horse was whipped up and the cab rattled off along the quay amid a chorus of laughter and adieus.	馬に鞭が当てられ馬車は笑い声とアデューのコーラスの中、河岸に沿ってがたがたと走り出した。
Gabriel had not gone to the door with the others.	ゲイブリエルはほかの人たちのいるドアのところへ行かなかった。
He was in a dark part of the hall gazing up the staircase.	彼は玄関ホールの暗い部分にいて階段をじっと見上げていた。
A woman was standing near the top of the first flight, in the shadow also.	一人の女が最初の階段の頂上近く、やはり陰の中に立っていた。
He could not see her face but he could see the terra-cotta and salmon-pink panels of her skirt which the shadow made appear black and white.	彼には彼女の顔が見えなかったが、陰が黒と白に見せる、赤褐色とサーモンピンクの布のはぎ合わせのスカートが見えた。
It was his wife.	それは彼の妻だった。
She was leaning on the banisters, listening to something.	彼女は手すりにもたれて何かに耳を傾けていた。
Gabriel was surprised at her stillness and strained his ear to listen also.	ゲイブリエルはじっと動かない彼女に驚き、彼も聞こうとして耳をすました。
But he could hear little save the noise of laughter and dispute on the front steps, a few chords struck on the piano and a few notes of a man's voice singing.	しかし彼には、正面の戸口の段上の騒がしい笑い声と議論を除けばほとんど、ピアノを打ち鳴らす和音が少しと男の歌声が少ししか聞こえなかった。
He stood still in the gloom of the hall, trying to catch the air that the voice was singing and gazing up at his wife.	彼はホールの暗がりにじっと立ち、その声が歌っているメロディーを聞き取ろうと努め、妻をじっと見上げていた。
There was grace and mystery in her attitude as if she were a symbol of something.	彼女の姿勢にはまるで彼女が何かの象徴であるかのような優雅と神秘があった。
He asked himself what is a woman standing on the stairs in the shadow, listening to distant music, a symbol of.	陰の中、階段に立ち、遠い音楽に耳を傾ける女は何の象徴であるのか、彼は自問した。
If he were a painter he would paint her in that attitude.	彼が画家であったならあの姿勢の彼女を描くだろう。
Her blue felt hat would show off the bronze of her hair against the darkness and the dark panels of her skirt would show off the light ones.	彼女の青いフェルトの帽子は暗闇を背景に彼女の髪のブロンズ色を引き立て、はぎ合わせのスカートの暗色は明色を引き立てるだろう。
Distant Music he would call the picture if he were a painter.	遠い音楽、と彼が画家ならその絵を名づけるだろう。
The hall-door was closed;	玄関のドアが閉まり、
and Aunt Kate, Aunt Julia and Mary Jane came down the hall, still laughing.	ケイト叔母とジュリア叔母とメアリー・ジェーンがまだ笑いながらホールをやってきた。
"Well, isn't Freddy terrible?"	「まあ、フレディったらひどいじゃない？」
said Mary Jane.	とメアリー・ジェーンが言った。
"He's really terrible."	「彼は本当にひどいわ。」
Gabriel said nothing but pointed up the stairs towards where his wife was standing.	ゲイブリエルは何も言わず、階段の上の妻が立っている方を指差した。
Now that the hall-door was closed the voice and the piano could be heard more clearly.	今は玄関のドアが閉まっているので声もピアノもよりはっきり聞こえていた。
Gabriel held up his hand for them to be silent.	ゲイブリエルは彼らに静かにするようにと手を上げた。
The song seemed to be in the old Irish tonality and the singer seemed uncertain both of his words and of his voice.	その歌は古いアイルランドの音階によるものらしかったが、歌い手はその歌詞にもその声にも自信が持てないようだった。
The voice, made plaintive by distance and by the singer's hoarseness, faintly illuminated the cadence of the air with words expressing grief:	離れているため、そして歌い手の声がかすれているため、悲しげに聞こえる歌声は、そのアリアのカデンツァを悲痛な思いを表す言葉でほのかに飾った。
O, the rain falls on my heavy locks	おお、雨は私の重い頭髪に落ちる
And the dew wets my skin,	そしてしずくは私の肌をぬらす、
My babe lies cold...	私の赤ん坊は冷たく横たわり・・・
"O,"	「おお」
exclaimed Mary Jane.	とメアリー・ジェーンが声を上げた。
"It's Bartell D'Arcy singing and he wouldn't sing all the night.	「バーテル・ダーシーが歌っている、一晩中歌おうとしなかったのに。
O, I'll get him to sing a song before he goes."	おお、彼が行く前に一曲歌わせるわ。」
"O, do, Mary Jane,"	「おお、ぜひにもね、メアリー・ジェーン」
said Aunt Kate.	とケイト叔母が言った。
Mary Jane brushed past the others and ran to the staircase, but before she reached it the singing stopped and the piano was closed abruptly.	メアリー・ジェーンはほかの人たちのそばをかすめ過ぎ、階段へ走ったが、彼女がそこに着く前に歌声はやみ、ピアノは唐突に閉じられた。
"O, what a pity!"	「ああ、残念！」
she cried.	と彼女は叫んだ。
"Is he coming down, Gretta?"	「彼は下りてくるの、グレタ？」
Gabriel heard his wife answer yes and saw her come down towards them.	ゲイブリエルは妻がええと答えるのを聞き、彼女が彼らの方に下りてくるのを見た。
A few steps behind her were Mr. Bartell D'Arcy and Miss O'Callaghan.	彼女の何歩か後ろにバーテル・ダーシー氏とミス・オキャラハンがいた。
"O, Mr. D'Arcy,"	「おお、ダーシーさん、」
cried Mary Jane,	メアリー・ジェーンが叫んだ、
"it's downright mean of you to break off like that when we were all in raptures listening to you."	「私たちがみんなうっとりと聞き入っているのにあんなふうにやめてしまうなんて、あなたまったくけちですわ。」
"I have been at him all the evening,"	「私一晩中彼にうるさくせがんだのですけれど、」
said Miss O'Callaghan,	ミス・オキャラハンが言った、
"and Mrs. Conroy, too, and he told us he had a dreadful cold and couldn't sing."	「それとコンロイ夫人も、それで彼が言うには、彼はひどい風邪をひいて歌えないんですって。」
"O, Mr. D'Arcy,"	「ああ、ダーシーさん、」
said Aunt Kate,	ケイト叔母が言った、
"now that was a great fib to tell."	「もうそれは大変な嘘をおっしゃってたってことね。」
"Can't you see that I'm as hoarse as a crow?"	「私の声がカラスのようにしゃがれているのがわからないんですか？」
said Mr. D'Arcy roughly.	とダーシー氏は乱暴に言った。
He went into the pantry hastily and put on his overcoat.	彼は急いで食器室に入り、コートを着た。
The others, taken aback by his rude speech, could find nothing to say.	他の人たちは彼の無作法な言葉にあっけにとられ、何も言うことが見つからなかった。
Aunt Kate wrinkled her brows and made signs to the others to drop the subject.	ケイト叔母は眉にしわを寄せ、その話題はやめるよう、他の人たちに合図した。
Mr. D'Arcy stood swathing his neck carefully and frowning.	ダーシー氏は首を入念に包みながら顔をしかめて立っていた。
"It's the weather,"	「この天候よ」
said Aunt Julia, after a pause.	とジュリア叔母が間をおいて言った。
"Yes, everybody has colds,"	「そうね、誰も彼も風邪をひいてるわ、」
said Aunt Kate readily,	ケイト叔母がすぐに言った、
"everybody."	「誰も彼も。」
"They say,"	「なんでも、」
said Mary Jane,	メアリー・ジェーンが言った、
"we haven't had snow like it for thirty years;	「三十年もこんな雪はなかったそうよ。
and I read this morning in the newspapers that the snow is general all over Ireland."	それに今朝新聞で読んだけど雪はアイルランド中どこもですって。」
"I love the look of snow,"	「雪を見るのは好きだわ」
said Aunt Julia sadly.	とジュリア叔母が悲しそうに言った。
"So do I,"	「私もそう」
said Miss O'Callaghan.	とミス・オキャラハンが言った。
"I think Christmas is never really Christmas unless we have the snow on the ground."	「クリスマスも一面の雪でなければ決して本当のクリスマスと思えないわ。」
"But poor Mr. D'Arcy doesn't like the snow,"	「だけどお気の毒に、ダーシーさんはその雪が好きじゃないわ」
said Aunt Kate, smiling.	とケイト叔母が微笑みながら言った。
Mr. D'Arcy came from the pantry, fully swathed and buttoned, and in a repentant tone told them the history of his cold.	ダーシー氏はすっかりくるまりボタンをかけて食器室から出てきて、後悔の口調で彼の風邪の経緯を彼らに語った。
Everyone gave him advice and said it was a great pity and urged him to be very careful of his throat in the night air.	皆が彼に助言を与え、とても気の毒だと言い、夜の外出ではのどをよほど大切にするようにしきりに忠告した。
Gabriel watched his wife, who did not join in the conversation.	ゲイブリエルは会話に加わらない妻をじっと見ていた。
She was standing right under the dusty fanlight and the flame of the gas lit up the rich bronze of her hair, which he had seen her drying at the fire a few days before.	彼女はくすんだ明り取りの真下に立ち、ガス灯の炎が鮮やかなブロンズ色の髪を、数日前彼女が暖炉で乾かしているのを彼が見たばかりの髪を照らしていた。
She was in the same attitude and seemed unaware of the talk about her.	彼女は同じ姿勢で、周りの話には気づいていないように見えた。
At last she turned towards them and Gabriel saw that there was colour on her cheeks and that her eyes were shining.	やっと彼女が彼らの方を向き、ゲイブリエルは彼女の頬が赤らみ、目が輝いているのを見た。
A sudden tide of joy went leaping out of his heart.	突然の喜びの潮が彼の心から躍り出た。
"Mr. D'Arcy,"	「ダーシーさん、」
she said,	彼女は言った、
"what is the name of that song you were singing?"	「歌っていらした歌の名は何と言いますの？」
"It's called The Lass of Aughrim,"	「『オグリムの娘』と呼ばれています、」
said Mr. D'Arcy,	ダーシー氏は言った、
"but I couldn't remember it properly.	「しかし私は正確に思い出せませんでした。
Why?	おや？
Do you know it?"	あなたはご存知で？」
"The Lass of Aughrim,"	「オグリムの娘」
she repeated.	と彼女は繰り返した。
"I couldn't think of the name."	「その名前を思い出せませんでしたの。」
"It's a very nice air,"	「とても素敵な曲ね」
said Mary Jane.	とメアリー・ジェーンが言った。
"I'm sorry you were not in voice tonight."	「今夜あなたの声の調子が悪いのは残念ですわ。」
"Now, Mary Jane,"	「ほら、メアリー・ジェーン、」
said Aunt Kate,	ケイト叔母が言った、
"don't annoy Mr. D'Arcy.	「ダーシーさんに厭な思いをさせないで。
I won't have him annoyed."	厭な思いをさせたくないわ。」
Seeing that all were ready to start she shepherded them to the door, where good-night was said:	皆、出発の用意が整ったと見て、彼女は彼らをドアに導き、そこでさようならが言われた。
"Well, good-night, Aunt Kate, and thanks for the pleasant evening."	「では、さようなら、ケイト叔母さん、それから楽しい宵をありがとう。」
"Good-night, Gabriel.	「さようなら、ゲイブリエル、
Good-night, Gretta!"	さようなら、グレタ！」
"Good-night, Aunt Kate, and thanks ever so much.	「さようなら、ケイト叔母さん、それからほんとにありがとう。
Goodnight, Aunt Julia."	さようなら、ジュリア叔母さん。」
"O, good-night, Gretta, I didn't see you."	「あら、さようなら、グレタ、あなたに気づかなかったわ。」
"Good-night, Mr. D'Arcy.	「さようなら、ダーシーさん。
Good-night, Miss O'Callaghan."	さようなら、ミス・オキャラハン。」
"Good-night, Miss Morkan."	「さようなら、ミス・モーカン。」
"Good-night, again."	「もう一度、さようなら。」
"Good-night, all.	「さようなら、皆さん。
Safe home."	無事なご帰宅を。」
"Good-night.	「さようなら、
Good night."	さようなら。」
The morning was still dark.	朝はまだ暗かった。
A dull, yellow light brooded over the houses and the river;	鈍い、黄色い光が家々や川を抱いていた。
and the sky seemed to be descending.	そして空が降りてこようとしているように見えた。
It was slushy underfoot;	足元はぬかるんでいた。
and only streaks and patches of snow lay on the roofs, on the parapets of the quay and on the area railings.	そして雪はただ縞模様、まだら模様となって屋根の上、河の岸壁の上、地下勝手口の柵の上にのっていた。
The lamps were still burning redly in the murky air and, across the river, the palace of the Four Courts stood out menacingly against the heavy sky.	ランプは依然、もやった空気の中で赤く輝き、そして川の向こうにフォアコーツの宮殿が重苦しい空を背景に威嚇するようにくっきり見えていた。
She was walking on before him with Mr. Bartell D'Arcy, her shoes in a brown parcel tucked under one arm and her hands holding her skirt up from the slush.	彼女は彼の前をバーテル・ダーシー氏とともに、茶色の包みに入れた靴を小脇にはさみ、ぬかるみを避けて両手でスカートを持ち上げて歩いていた。
She had no longer any grace of attitude, but Gabriel's eyes were still bright with happiness.	彼女の姿勢はもはや優雅なものではなかったが、ゲイブリエルの目はなおも幸福に輝いていた。
The blood went bounding along his veins;	血は静脈で踊りだし、
and the thoughts went rioting through his brain, proud, joyful, tender, valorous.	思いは脳全体に、誇らしく、喜ばしく、優しく、勇ましく沸き立っていた。
She was walking on before him so lightly and so erect that he longed to run after her noiselessly, catch her by the shoulders and say something foolish and affectionate into her ear.	彼女が彼の前をとても軽々と、真っ直ぐに立って歩いていたので、彼は音もなく彼女の後を追って彼女の肩をつかみ、何かばかげていて愛情のこもったことを彼女の耳元で言いたくてたまらなかった。
She seemed to him so frail that he longed to defend her against something and then to be alone with her.	彼女がとてもかよわく見えるので、彼は彼女を何ものかから守り、それから彼女と二人だけでいたいとの思いを募らせた。
Moments of their secret life together burst like stars upon his memory.	彼らが共にすごした数々の秘密の瞬間が星のように彼の心にパッと蘇った。
A heliotrope envelope was lying beside his breakfast-cup and he was caressing it with his hand.	薄紫色の封筒が彼の朝食用のカップのそばに置かれ、彼はそれを手で愛撫していた。
Birds were twittering in the ivy and the sunny web of the curtain was shimmering along the floor:	鳥たちはつたの中でさえずり、陽を浴びたカーテンの網目が床の上を揺らめいていた。
he could not eat for happiness.	彼は幸せで食べることもできなかった。
They were standing on the crowded platform and he was placing a ticket inside the warm palm of her glove.	彼らは込み合ったプラットホームに立ち、彼は切符を彼女の手袋の暖かい手のひらの中に置いていた。
He was standing with her in the cold, looking in through a grated window at a man making bottles in a roaring furnace.	彼は彼女と共に寒さの中に立ち、轟音を上げるかまどの中でビンを作っている男を格子窓から覗き込んでいた。
It was very cold.	とても寒かった。
Her face, fragrant in the cold air, was quite close to his;	冷たい空気の中でよい香りのする彼女の顔が彼の顔のすぐ近くにあった。
and suddenly he called out to the man at the furnace:	そして不意に彼女がかまどの男に呼びかけた。
"Is the fire hot, sir?"	「ねえ、火は熱いの？」
But the man could not hear with the noise of the furnace.	しかしかまどの騒音で男には聞こえなかった。
It was just as well.	それでよかったんだ。
He might have answered rudely.	彼は無作法な答えをしたかもしれない。
A wave of yet more tender joy escaped from his heart and went coursing in warm flood along his arteries.	さらにいっそう優しい喜びの波が彼の心臓から流れ出て、暖かい洪水となって動脈を巡った。
Like the tender fire of stars moments of their life together, that no one knew of or would ever know of, broke upon and illumined his memory.	星々の優しいきらめきのように、誰一人知らない、また決して知るはずもない彼らが共にすごした瞬間が突然現れて彼の追憶に灯をともした。
He longed to recall to her those moments, to make her forget the years of their dull existence together and remember only their moments of ecstasy.	彼は、彼女にそうした瞬間を思い起こさせ、互いに単調な存在であった年月は忘れさせ、彼らの歓喜の瞬間だけを思い出させたいと心から望んだ。
For the years, he felt, had not quenched his soul or hers.	年月は彼の、また彼女の心を消してしまわなかった、と彼は思った。
Their children, his writing, her household cares had not quenched all their souls' tender fire.	彼らの子供たち、彼の著述、彼女の家族の世話が彼らの心の優しい炎をすべて消してしまうことはなかった。
In one letter that he had written to her then he had said:	あのころ彼は彼女に書いた一通の手紙の中で言ったことがあった。
"Why is it that words like these seem to me so dull and cold?	「このような言葉が僕にはとても退屈で冷たく思えるのはなぜだろう？
Is it because there is no word tender enough to be your name?"	君の名にふさわしいだけの優しい言葉がないからではないだろうか？」
Like distant music these words that he had written years before were borne towards him from the past.	遠い音楽のように彼が何年も前に書いたこれらの言葉が過去から運ばれてきた。
He longed to be alone with her.	彼は彼女と二人だけになりたくてたまらなかった。
When the others had gone away, when he and she were in the room in the hotel, then they would be alone together.	ほかの人たちが行ってしまったら、彼と彼女がホテルの部屋に入ったら、そのときは彼らだけ、一緒だ。
He would call her softly:	彼は彼女をそっと呼ぶだろう。
"Gretta!"	「グレタ！」
Perhaps she would not hear at once:	たぶんすぐには彼女に聞こえないだろう。
she would be undressing.	彼女は服を脱いでいるだろうから。
Then something in his voice would strike her.	そのとき彼の声の何かが彼女の心を打つ。
She would turn and look at him....	彼女は振り向いて彼を見る・・・
At the corner of Winetavern Street they met a cab.	ワインタバーン・ストリートの角で彼らは馬車に出会った。
He was glad of its rattling noise as it saved him from conversation.	彼はそのガタガタ鳴る騒音を、会話をしないで済むので喜んだ。
She was looking out of the window and seemed tired.	彼女は窓から外を眺め、疲れているようだった。
The others spoke only a few words, pointing out some building or street.	他の人たちは建物か通りか何かを指して二言三言話しただけだった。
The horse galloped along wearily under the murky morning sky, dragging his old rattling box after his heels, and Gabriel was again in a cab with her, galloping to catch the boat, galloping to their honeymoon.	馬は後ろの古いガタガタ鳴るボックスを引いて、もやもやした朝の空の下をだるそうに駆けて行き、ゲイブリエルは、彼女と共に船に間に合うように駆ける、彼らのハネムーンへと駆ける馬車の中に戻っていた。
As the cab drove across O'Connell Bridge Miss O'Callaghan said:	馬車がオコゥネル橋を渡る時、ミス・オキャラハンが言った。
"They say you never cross O'Connell Bridge without seeing a white horse."	「オコゥネル橋を渡ると必ず白馬を見るんですってね。」
"I see a white man this time,"	「今は白い男が見える」
said Gabriel.	とゲイブリエルが言った。
"Where?"	「どこに？」
asked Mr. Bartell D'Arcy.	バーテル・ダーシー氏が言った。
Gabriel pointed to the statue, on which lay patches of snow.	ゲイブリエルはまだら模様に雪ののった彫像を指さした。
Then he nodded familiarly to it and waved his hand.	それから彼はそれに向かって親しげに会釈し、手を振った。
"Good-night, Dan,"	「おやすみ、ダン」
he said gaily.	と彼は陽気に言った。
When the cab drew up before the hotel, Gabriel jumped out and, in spite of Mr. Bartell D'Arcy's protest, paid the driver.	馬車がホテルの前で止まると、ゲイブリエルは飛び降り、バーテル・ダーシー氏が抗議したけれども、御者に支払いをした。
He gave the man a shilling over his fare.	彼は男に運賃の上一シリング与えた。
The man saluted and said:	男は敬礼して言った。
"A prosperous New Year to you, sir."	「今年もよい年になりますよう、だんな。」
"The same to you,"	「君もね」
said Gabriel cordially.	とゲイブリエルは心をこめて言った。
She leaned for a moment on his arm in getting out of the cab and while standing at the curbstone, bidding the others good- night.	彼女は彼の腕にもたれて馬車から降り、少しの間そのままに、歩道の縁石に立ち、他の人たちに別れの挨拶をした。
She leaned lightly on his arm, as lightly as when she had danced with him a few hours before.	彼女は数時間前、彼と踊った時と同じように軽く彼の腕にもたれていた。
He had felt proud and happy then, happy that she was his, proud of her grace and wifely carriage.	あのとき彼は誇りと幸福を、彼女が彼のものであることに幸福を、彼女の優雅な、妻にふさわしい身のこなしに誇りを感じた。
But now, after the kindling again of so many memories, the first touch of her body, musical and strange and perfumed, sent through him a keen pang of lust.	しかし今、数々の思い出を再び燃え立たせた後で、音楽的で不思議でかぐわしい彼女の体に触れた途端、彼の体を情欲の鋭い痛みが走った。
Under cover of her silence he pressed her arm closely to his side;	彼女の沈黙をいいことに彼は彼女の腕を自分の脇へぴったりと押し付けた。
and, as they stood at the hotel door, he felt that they had escaped from their lives and duties, escaped from home and friends and run away together with wild and radiant hearts to a new adventure.	そして、ホテルのドアの前に立った時、彼は彼らが、彼らの生活や義務から逃れ、家や友人たちから逃れ、荒々しい、光りを放つ心で一緒に新たな冒険へと出発するのだと感じた。
An old man was dozing in a great hooded chair in the hall.	ホールでは一人の老人が大きなほろつきの椅子でうたた寝をしていた。
He lit a candle in the office and went before them to the stairs.	彼は事務所でろうそくに火をつけ、階段まで彼らの前に立った。
They followed him in silence, their feet falling in soft thuds on the thickly carpeted stairs.	彼らは黙って、厚いじゅうたんの階段に柔らかくドスッドスッと足を下ろしながら彼について行った。
She mounted the stairs behind the porter, her head bowed in the ascent, her frail shoulders curved as with a burden, her skirt girt tightly about her.	彼女はのぼりで頭をかがめ、か弱い肩を重荷を負ったように曲げ、スカートをぴったり体に巻きつけ、ボーイの後から昇った。
He could have flung his arms about her hips and held her still, for his arms were trembling with desire to seize her and only the stress of his nails against the palms of his hands held the wild impulse of his body in check.	彼がいきなり彼女の腰に手を伸ばして彼女をじっと抱いていることもできたろうが、その腕は彼女をつかみたいという欲望に震えながらも、ただ手のひらに当たるつめの圧力だけが彼のからだの激しい衝動を抑制していた。
The porter halted on the stairs to settle his guttering candle.	ボーイは消えそうなろうそくを落ち着かせるために階段上で立ち止まった。
They halted, too, on the steps below him.	彼らもまた彼の下の段で立ち止まった。
In the silence Gabriel could hear the falling of the molten wax into the tray and the thumping of his own heart against his ribs.	静寂の中でゲイブリエルに、溶けたろうが受け皿に落ちる音、そして彼自身の肋骨にあたる心臓のどきどきする音が聞こえた。
The porter led them along a corridor and opened a door.	ボーイは彼らを廊下を通って案内し、ドアを開けた。
Then he set his unstable candle down on a toilet-table and asked at what hour they were to be called in the morning.	それから彼は不安定なろうそくを化粧台の上に置き、朝何時に起こしたらいいか尋ねた。
"Eight,"	「八時」
said Gabriel.	とゲイブリエルは言った。
The porter pointed to the tap of the electric-light and began a muttered apology, but Gabriel cut him short.	ボーイは電灯のタップを指さし、わびごとをつぶやき始めたが、ゲイブリエルがさえぎった。
"We don't want any light.	「明かりは何もいらない。
We have light enough from the street.	通りの明かりで十分だ。
And I say,"	それにね、」
he added, pointing to the candle,	と彼はろうそくを指して加えた、
"you might remove that handsome article, like a good man."	「そのハンサムな物もどけてもらえないか、悪いけど。」
The porter took up his candle again, but slowly,	ボーイはろうそくを再び、しかしのろのろと手に取った。
for he was surprised by such a novel idea.	そのような新奇な考えに驚いたのだ。
Then he mumbled good-night and went out.	それから彼はもぐもぐとお休みを言い、出て行った。
Gabriel shot the lock to.	ゲイブリエルはさっと錠をかけて閉めた。
A ghastly light from the street lamp lay in a long shaft from one window to the door.	青ざめた街灯の光が長々と一筋、一つの窓からドアへと流れていた。
Gabriel threw his overcoat and hat on a couch and crossed the room towards the window.	ゲイブリエルはコートと帽子をカウチにほうり投げ、窓の方へ部屋を横切った。
He looked down into the street in order that his emotion might calm a little.	彼は感情を少しでも静めるために下の通りを覗き込んだ。
Then he turned and leaned against a chest of drawers with his back to the light.	それから彼は振り返り、光を背に整理ダンスに寄りかかった。
She had taken off her hat and cloak and was standing before a large swinging mirror, unhooking her waist.	彼女は帽子とマントを脱ぎ、大きな回転鏡の前に立ち、服のホックをはずしていた。
Gabriel paused for a few moments, watching her, and then said:	ゲイブリエルはちょっとためらい、彼女をじっと見て、それから言った。
"Gretta!"	「グレタ！」
She turned away from the mirror slowly and walked along the shaft of light towards him.	彼女はゆっくりと鏡から顔をそむけ、光の筋に沿って彼の方へ歩いた。
Her face looked so serious and weary that the words would not pass Gabriel's lips.	彼女の顔がとてもまじめで疲れたように見えたので、言葉はゲイブリエルの唇にとどまっていた。
No, it was not the moment yet.	いや、まだその時ではない。
"You looked tired,"	「疲れているようだね」
he said.	と彼は言った。
"I am a little,"	「少しね」
she answered.	と彼女は答えた。
"You don't feel ill or weak?"	「具合が悪かったり弱ったりしてない？」
"No, tired:	「いいえ、疲れたの。
that's all."	それだけよ。」
She went on to the window and stood there, looking out.	彼女は窓のところへ行き、そこに立ち、外を見ていた。
Gabriel waited again and then, fearing that diffidence was about to conquer him, he said abruptly:	ゲイブリエルは再び待ち、気後れに打ち負かされそうだと思い、唐突に言った。
"By the way, Gretta!"	「ところでね、グレタ！」
"What is it?"	「何？」
"You know that poor fellow Malins?"	「あのマリンズってやつを知ってるよね？」
he said quickly.	と彼は急いで言った。
"Yes.	「ええ。
What about him?"	彼がどうしたの？」
"Well, poor fellow, he's a decent sort of chap, after all,"	「うん、哀れなやつだが、とにかく彼はきちんとした男だ」
continued Gabriel in a false voice.	とゲイブリエルは偽りの声で続けた。
"He gave me back that sovereign I lent him, and I didn't expect it, really.	「彼は僕が貸したソブリンを返してよこしたよ、実のところ僕は期待してなかった。
It's a pity he wouldn't keep away from that Browne, because he's not a bad fellow, really."	彼があのブラウンを遠ざけられないのは残念だな、実際彼は悪いやつじゃないからね。」
He was trembling now with annoyance.	彼はもう悩ましさに震えていた。
Why did she seem so abstracted?	なぜ彼女はこんなにぼんやりしているように見えるのか？
He did not know how he could begin.	彼はどのように始めたらいいかわからなかった。
Was she annoyed, too, about something?	彼女も何かに悩んでいるのか？
If she would only turn to him or come to him of her own accord!	ただ彼女が自分から彼の方を見るか彼の方へ来てくれたら！
To take her as she was would be brutal.	今のまま彼女を抱くのは粗暴になる。
No, he must see some ardour in her eyes first.	いや、彼はまず彼女の目に少しでも熱情を見なければならない。
He longed to be master of her strange mood.	彼は彼女の不思議な気分を支配したいと強く願った。
"When did you lend him the pound?"	「いつその一ポンドを彼に貸したの？」
she asked, after a pause.	としばらくして彼女が尋ねた。
Gabriel strove to restrain himself from breaking out into brutal language about the sottish Malins and his pound.	ゲイブリエルは飲んだくれのマリンズと彼の一ポンドのことで突然粗暴なことを言い出すのを抑えようと努めた。
He longed to cry to her from his soul, to crush her body against his, to overmaster her.	彼は魂から彼女に叫び、彼女のからだを彼ので押しつぶし、彼女を征服したくてたまらなかった。
But he said:	しかし彼は言った。
"O, at Christmas, when he opened that little Christmas-card shop in Henry Street."	「ああ、クリスマスに、彼がヘンリー街に小さなクリスマスカードの店を開いた時だ。」
He was in such a fever of rage and desire that he did not hear her come from the window.	彼は熱情と欲望に興奮していて彼女が窓から来るのが聞こえなかった。
She stood before him for an instant, looking at him strangely.	彼女は一瞬彼の前に立って奇妙な具合に彼を眺めた。
Then, suddenly raising herself on tiptoe and resting her hands lightly on his shoulders, she kissed him.	それから、不意につま先立ちで伸び上がり、両手を彼の肩に軽くのせ、彼にキスした。
"You are a very generous person, Gabriel,"	「あなたはとても思いやりのある人ね、ゲイブリエル」
she said.	と彼女は言った。
Gabriel, trembling with delight at her sudden kiss and at the quaintness of her phrase, put his hands on her hair and began smoothing it back, scarcely touching it with his fingers.	ゲイブリエルは不意の彼女のキスと彼女の言い回しの古風なおもむきに大喜びで打ち震え、彼女の髪に両手を置き、ほとんど指で触れることなくそれを後ろになでつけ始めた。
The washing had made it fine and brilliant.	それは洗髪により美しく輝いていた。
His heart was brimming over with happiness.	彼の心に幸せが満ち溢れていた。
Just when he was wishing for it she had come to him of her own accord.	まさに彼がそれを望んだ時に彼女が自分から彼のところへ来たのだ。
Perhaps her thoughts had been running with his.	ことによると彼女の思いは彼のと一緒に流れていたのかもしれない。
Perhaps she had felt the impetuous desire that was in him, and then the yielding mood had come upon her.	ことによると彼女は彼の内にある衝動的な欲望を感じ、それで彼女は従順な気分に襲われたのかもしれない。
Now that she had fallen to him so easily, he wondered why he had been so diffident.	今や彼女は簡単に彼の手に落ちたわけで、彼はなぜあれほど気後れしていたのだろうと思った。
He stood, holding her head between his hands.	彼は両手の間に彼女の頭を持って立っていた。
Then, slipping one arm swiftly about her body and drawing her towards him, he said softly:	それから彼はすばやく片腕を彼女のからだにすべらせ、彼女を彼のほうへ引き寄せながら、そっと言った。
"Gretta, dear, what are you thinking about?"	「グレタ、ねえ、何を考えているの？」
She did not answer nor yield wholly to his arm.	彼女は答えず、また完全には彼の腕に身をゆだねなかった。
He said again, softly:	彼は再びそっと言った。
"Tell me what it is, Gretta.	「何だか言ってよ、グレタ。
I think I know what is the matter.	僕にもわかっていることだよね。
Do I know?"	そうだろ？」
She did not answer at once.	彼女はすぐには答えなかった。
Then she said in an outburst of tears:	それから彼女はわっと泣きながら言った。
"O, I am thinking about that song, The Lass of Aughrim."	「おお、私はあの歌のことを考えているの、オグリムの娘。」
She broke loose from him and ran to the bed and, throwing her arms across the bed-rail, hid her face.	彼女は彼から逃れ、ベッドへ走り、腕をベッドの柵越しに投げ出して顔を隠した。
Gabriel stood stockstill for a moment in astonishment and then followed her.	ゲイブリエルは驚いてちょっとの間棒立ちになり、それから彼女の後を追った。
As he passed in the way of the cheval-glass he caught sight of himself in full length, his broad, well-filled shirt-front, the face whose expression always puzzled him when he saw it in a mirror, and his glimmering gilt-rimmed eyeglasses.	途中で大きな姿見のところを通り過ぎる時、彼自身の全身、彼の幅が広くてはちきれそうなワイシャツの胸、その表情を鏡に見る時いつも彼を当惑させる顔、ちらちら光る金縁のメガネが彼の目に入った。
He halted a few paces from her and said:	彼は彼女から数歩のところで立ち止まって言った。
"What about the song?	「あの歌がどうしたの？
Why does that make you cry?"	なぜ君を泣かせるの？」
She raised her head from her arms and dried her eyes with the back of her hand like a child.	彼女は腕から頭を上げ、子供のように手の甲で目をぬぐった。
A kinder note than he had intended went into his voice.	彼の声は意図したより優しい調子になった。
"Why, Gretta?"	「なぜ、グレタ？」
he asked.	と彼は尋ねた。
"I am thinking about a person long ago who used to sing that song."	「あの歌をいつも歌っていたずっと前の人のことを考えているの。」
"And who was the person long ago?"	「それでそのずっと前の人って誰？」
asked Gabriel, smiling.	とゲイブリエルは微笑みながら尋ねた。
"It was a person I used to know in Galway when I was living with my grandmother,"	「昔、私が祖母と一緒に暮らしていた頃、ゴールウェイで知っていた人よ」
she said.	と彼女は言った。
The smile passed away from Gabriel's face.	ゲイブリエルの顔から微笑が消えた。
A dull anger began to gather again at the back of his mind and the dull fires of his lust began to glow angrily in his veins.	鈍い怒りが再び彼の心の奥に集まり始め、情欲の鈍い火が静脈の中で憤然と燃え始めた。
"Someone you were in love with?"	「君が恋に落ちた誰かかい？」
he asked ironically.	と彼は皮肉に尋ねた。
"It was a young boy I used to know,"	「私が昔知っていた若い男の子よ、」
she answered,	彼女は答えた、
"named Michael Furey.	「マイケル・フューレイという名の。
He used to sing that song, The Lass of Aughrim.	彼はいつもあの歌、オグリムの娘を歌っていたわ。
He was very delicate."	彼はとても華奢だった。」
Gabriel was silent.	ゲイブリエルは黙っていた。
He did not wish her to think that he was interested in this delicate boy.	彼はこの華奢な少年に興味があると彼女に思われたくなかった。
"I can see him so plainly,"	「私には彼がとてもはっきり見えるわ」
she said, after a moment.	と、しばらくして彼女は言った。
"Such eyes as he had: big, dark eyes!	「彼の目はそれは、大きくて黒い目！
And such an expression in them	そしてその中の表情
--an expression!"	−−表情と言ったら！」
"O, then, you are in love with him?"	「ああ、それじゃあ君は彼に恋をしてる？」
said Gabriel.	とゲイブリエルは言った。
"I used to go out walking with him,"	「いつも私は彼と外を歩いたわ、」
she said,	彼女は言った、
"when I was in Galway."	「ゴールウェイにいた時。」
A thought flew across Gabriel's mind.	ある考えがゲイブリエルの頭をさっとよぎった。
"Perhaps that was why you wanted to go to Galway with that Ivors girl?"	「たぶんそれで君はあのアイバースという娘とゴールウェイに行きたいんだね？」
he said coldly.	と彼は冷やかに言った。
She looked at him and asked in surprise:	彼女は驚いて彼を見て尋ねた。
"What for?"	「何のために？」
Her eyes made Gabriel feel awkward.	彼女の目はゲイブリエルをきまり悪くさせた。
He shrugged his shoulders and said:	彼は肩をすくめて言った。
"How do I know?	「どうして僕にわかる？
To see him, perhaps."	彼に会うため、たぶん。」
She looked away from him along the shaft of light towards the window in silence.	彼女は黙って彼から目をそらし一条の光に沿って窓の方を見た。
"He is dead,"	「彼は死んだわ」
she said at length.	と彼女はようやく言った。
"He died when he was only seventeen.	「彼はたった十七歳の時に死んだの。
Isn't it a terrible thing to die so young as that?"	そんなに若くて死ぬなんて恐ろしいじゃない？」
"What was he?"	「彼は何者？」
asked Gabriel, still ironically.	とゲイブリエルは依然、皮肉をこめて言った。
"He was in the gasworks,"	「彼はガス工場にいたわ」
she said.	と彼女は言った。
Gabriel felt humiliated by the failure of his irony and by the evocation of this figure from the dead, a boy in the gasworks.	ゲイブリエルは皮肉の失敗と、死者たちの中からこの人物を、ガス工場の少年を呼び起こしたことを恥ずかしく思った。
While he had been full of memories of their secret life together, full of tenderness and joy and desire, she had been comparing him in her mind with another.	彼が共に過ごした秘密の生活の思い出に夢中になっていた時、やさしさと喜びと欲望でいっぱいになっていた時、彼女は心の中で彼をもう一人と比較していたのだ。
A shameful consciousness of his own person assailed him.	自分自身を恥じる意識が彼を襲った。
He saw himself as a ludicrous figure,	彼には自分がこっけいな姿に映った。
acting as a pennyboy for his aunts, a nervous, well-meaning sentimentalist, orating to vulgarians and idealising his own clownish lusts, the pitiable fatuous fellow he had caught a glimpse of in the mirror.	叔母たちの使い走り、神経質な善意の感傷的人物として行動し、無教養な連中に演説をぶち、自身のぶざまな情欲を理想化する、鏡の中にちらと見たばかりの哀れな間抜け野朗。
Instinctively he turned his back more to the light lest she might see the shame that burned upon his forehead.	本能的に彼は、額に燃えあがる羞恥を彼女に見られないように、いっそう光に背を向けた。
He tried to keep up his tone of cold interrogation, but his voice when he spoke was humble and indifferent.	彼は冷たい尋問調を続けようとしたが、話してみるとその声は控えめでどっちつかずだった。
"I suppose you were in love with this Michael Furey, Gretta,"	「君はそのマイケル・フューレイに恋をしていたんだろうね、グレタ」
he said.	と彼は言った。
"I was great with him at that time,"	「私はその頃彼と仲よしだったわ」
she said.	と彼女は言った。
Her voice was veiled and sad.	彼女の声は不明瞭で悲しげだった。
Gabriel, feeling now how vain it would be to try to lead her whither he had purposed, caressed one of her hands and said, also sadly:	ゲイブリエルは、いまや彼の意図した所へ彼女を導こうとするのはなんとも無益だと感じて、彼女の片方の手を愛撫して、こちらも悲しそうに言った。
"And what did he die of so young, Gretta?	「それでそんなに若い彼が何で死んだの、グレタ？
Consumption, was it?"	肺病、そう？」
"I think he died for me,"	「彼は私のせいで死んだと思うの」
she answered.	と彼女は答えた。
A vague terror seized Gabriel at this answer,	この答えに漠然とした恐怖がゲイブリエルをとらえた。
as if, at that hour when he had hoped to triumph, some impalpable and vindictive being was coming against him, gathering forces against him in its vague world.	まるで、彼が勝利を望んだその時に、何か実体のない執念深い存在が彼に対抗して現れ、彼に対抗してその漠然とした世界の中で力を結集しているかのように感じた。
But he shook himself free of it with an effort of reason and continued to caress her hand.	しかし彼は理性の努力によりそれを振り払い、彼女の手を愛撫し続けた。
He did not question her again,	彼はもう彼女に質問しなかった。
for he felt that she would tell him of herself.	彼女が自ら語るだろうと思ったからだ。
Her hand was warm and moist:	彼女の手は温かく湿っていた。
it did not respond to his touch, but he continued to caress it just as he had caressed her first letter to him that spring morning.	それは彼が触れても反応しなかったが、彼はそれを、あの春の朝、彼女の最初の彼への手紙を愛撫したのとまったく同じように愛撫し続けた。
"It was in the winter,"	「冬だったわ、」
she said,	彼女は言った、
"about the beginning of the winter when I was going to leave my grandmother's and come up here to the convent.	「冬の初めの頃、私がおばあさんのところを離れてこっちの修道院へ出てこようとしていた時。
And he was ill at the time in his lodgings in Galway and wouldn't be let out, and his people in Oughterard were written to.	その時彼は病気でゴールウェイの下宿にいて外に出してもらえず、オウテラードの彼の家族には手紙で知らされたわ。
He was in decline, they said, or something like that.	彼は衰弱しているとか、そのようなことだったわ。
I never knew rightly."	私にははっきりとはわからなかった。」
She paused for a moment and sighed.	彼女はちょっと休んで、ため息をついた。
"Poor fellow,"	「かわいそうに、」
she said.	彼女は言った、
"He was very fond of me and he was such a gentle boy.	「彼は私のことがとても好きだったしすごくやさしい少年だった。
We used to go out together, walking, you know, Gabriel, like the way they do in the country.	私たちはいつも一緒に出かけて、歩いたわ、ねえ、ゲイブリエル、いなかの人がするように。
He was going to study singing only for his health.	彼は健康さえ許せば歌を勉強しに行っていたの。
He had a very good voice, poor Michael Furey."	彼はとてもいい声だった、かわいそうなマイケル・フューレイ。」
"Well;	「そう、
and then?"	それで？」
asked Gabriel.	とゲイブリエルは尋ねた。
"And then when it came to the time for me to leave Galway and come up to the convent he was much worse and I wouldn't be let see him so I wrote him a letter saying I was going up to Dublin and would be back in the summer, and hoping he would be better then."	「それから私がゴールウェイを離れて修道院に出てくるという時には彼はずっと悪くなって、私は彼に会わせてもらえないので彼へ手紙を書いて、私はダブリンに出るところで夏には戻ってくる、その頃には彼もよくなっているだろうと言ったの。」
She paused for a moment to get her voice under control, and then went on:	彼女はちょっと休んで声を抑制し、それから続けた。
"Then the night before I left, I was in my grandmother's house in Nuns' Island, packing up, and I heard gravel thrown up against the window.	「そして私が出発する前の夜、私はナンズアイランドのおばあさんの家で、荷物を詰めていて、投げた砂利が窓にぶつかるのを聞いたの。
The window was so wet I couldn't see, so I ran downstairs as I was and slipped out the back into the garden and there was the poor fellow at the end of the garden, shivering."	窓はすっかりぬれていて見えなかった、それで私はそのまま階段を駆け下りて、そっと裏から庭に出ると、庭のはずれにかわいそうに、彼がいたの、震えながら。」
"And did you not tell him to go back?"	「それで彼に帰るように言わなかったの？」
asked Gabriel.	とゲイブリエルは尋ねた。
"I implored of him to go home at once and told him he would get his death in the rain.	「私は彼にすぐに家へ帰るように懇願したし雨の中で彼は死んでしまうと言ったわ。
But he said he did not want to live.	でも彼は生きていたくないと言った。
I can see his eyes as well as well!	私には彼の目がよくよく見える！
He was standing at the end of the wall where there was a tree."	彼は木が一本ある壁の端に立っていたわ。」
"And did he go home?"	「それで彼は家へ帰った？」
asked Gabriel.	とゲイブリエルは尋ねた。
"Yes, he went home.	「ええ、彼は家へ帰った。
And when I was only a week in the convent he died and he was buried in Oughterard, where his people came from.	そして私が修道院に来てたった一週間で彼は死んで、一家の郷里のオウテラードに葬られた。
O, the day I heard that, that he was dead!"	ああ、あの、彼が死んだことを聞いた日！」
She stopped, choking with sobs, and, overcome by emotion, flung herself face downward on the bed, sobbing in the quilt.	彼女は話を止め、すすり泣きにむせび、そして、激しい感情に圧倒され、うつぶせにベッドに身を投げ出し、キルトの中ですすり泣いていた。
Gabriel held her hand for a moment longer, irresolutely, and then, shy of intruding on her grief, let it fall gently and walked quietly to the window.	ゲイブリエルは一瞬長く、優柔不断に彼女の手を取っていたが、それから、彼女の悲しみに思い切って立ち入ることができず、優しくそれを置き、静かに窓へと歩いた。
She was fast asleep.	彼女は熟睡した。
Gabriel, leaning on his elbow, looked for a few moments unresentfully on her tangled hair and half-open mouth, listening to her deep-drawn breath.	ゲイブリエルはひじをつき、しばらくの間、腹を立てることもなく彼女のもつれた髪と開き気味の口を眺め、彼女が深く息を吸い込む音を聞いていた。
So she had had that romance in her life:	そうすると彼女の人生にはあんなロマンスがあったのだ。
a man had died for her sake.	一人の男が彼女のために死んだとは。
It hardly pained him now to think how poor a part he, her husband, had played in her life.	彼が、彼女の夫が彼女の人生でいかに哀れな役割を演じたかを考えても、今、ほとんど彼の心は痛まなかった。
He watched her while she slept, as though he and she had never lived together as man and wife.	彼は彼女が眠っている間、まるで彼と彼女が夫婦として共に暮らしたことなどなかったかのように、彼女をじっと見ていた。
His curious eyes rested long upon her face and on her hair:	彼の好奇心に満ちた目は長く彼女の顔、彼女の髪に留まっていた。
and, as he thought of what she must have been then, in that time of her first girlish beauty, a strange, friendly pity for her entered his soul.	そして彼女がその時、その乙女の美しさの初露の時にどんなだったろうかと考えると、彼女に対する不思議な、友愛的な哀れみが彼の心に入り込んだ。
He did not like to say even to himself that her face was no longer beautiful, but he knew that it was no longer the face for which Michael Furey had braved death.	彼は、彼女の顔がもはや美しくないとは自分ひとりにさえ言いたくなかったが、それがもはやマイケル・フューレイがそのために死に勇敢に立ち向かった顔ではないこともわかっていた。
Perhaps she had not told him all the story.	たぶん彼女はすべてを彼に語ったのではないだろう。
His eyes moved to the chair over which she had thrown some of her clothes.	彼の目は彼女が服の一部を脱ぎ捨てた椅子に移った。
A petticoat string dangled to the floor.	ペチコートの紐が床に垂れ下がっていた。
One boot stood upright, its limp upper fallen down:	ブーツの片方は直立し、その柔らかな甲革は折れていた。
the fellow of it lay upon its side.	相棒はその傍らに横になっていた。
He wondered at his riot of emotions of an hour before.	彼は一時間前に沸き立った感情を不思議に思った。
From what had it proceeded?	どこから生じたのだろう？
From his aunt's supper, from his own foolish speech, from the wine and dancing, the merry-making when saying good-night in the hall, the pleasure of the walk along the river in the snow.	叔母たちの夜食から、彼自身のばかな演説から、ワインとダンス、玄関でさよならを言った時のお祭り騒ぎ、雪の中を川沿いに歩く喜びから。
Poor Aunt Julia!	かわいそうなジュリア叔母さん！
She, too, would soon be a shade with the shade of Patrick Morkan and his horse.	彼女もすぐにパトリック・モーカンや彼の馬の陰とともに陰の存在になるだろう。
He had caught that haggard look upon her face for a moment when she was singing Arrayed for the Bridal.	彼は、彼女が『花嫁の衣装を着て』を歌っている時、一瞬、彼女の顔にやつれた様子を見つけた。
Soon, perhaps, he would be sitting in that same drawing-room, dressed in black, his silk hat on his knees.	もうすぐ、たぶん、彼はあの同じ客間に黒い服を着て、シルクハットをひざに座っていることになるだろう。
The blinds would be drawn down and Aunt Kate would be sitting beside him, crying and blowing her nose and telling him how Julia had died.	ブラインドは引きおろされ、ケイト叔母は彼のそばに、泣いたり鼻をかんだりジュリアがどんなふうに死んだか彼に話しながら座っているだろう。
He would cast about in his mind for some words that might console her, and would find only lame and useless ones.	彼は心の中で彼女を慰める言葉を探しまわり、そして役に立たないまずいやつを見つけるだけだろう。
Yes, yes:	そうだ、そうだ、
that would happen very soon.	それはまもなく起こるだろう。
The air of the room chilled his shoulders.	部屋の空気は彼の肩を冷え込ませた。
He stretched himself cautiously along under the sheets and lay down beside his wife.	彼はシーツの中でそおっとからだを伸ばし、妻のそばに横になった。
One by one, they were all becoming shades.	一人、一人と彼らは皆、陰になっていく。
Better pass boldly into that other world, in the full glory of some passion, than fade and wither dismally with age.	情熱に満ちた絶頂のうちに思い切ってあの世に行く方がいい、年をとって惨めに衰え、枯れるよりも。
He thought of how she who lay beside him had locked in her heart for so many years that image of her lover's eyes when he had told her that he did not wish to live.	彼は、そばに横たわる彼女がどのようにしてそれほど長い間、生きていたくないと彼女に言った時の恋人の目の面影を心の中にしまいこんでいたのかを考えた。
Generous tears filled Gabriel's eyes.	思いやりの涙がゲイブリエルの目に満ちた。
He had never felt like that himself towards any woman, but he knew that such a feeling must be love.	彼はどんな女に対してもそんな気持ちになったことは一度もなかったが、そのような感情が愛に違いないと知った。
The tears gathered more thickly in his eyes and in the partial darkness he imagined he saw the form of a young man standing under a dripping tree.	彼の目はさらに涙を深くたたえ、その部分的な暗闇の中に彼は雫滴る木の下に立つ若い男の姿を見たように思った。
Other forms were near.	そのほかの人々の影も近くにあった。
His soul had approached that region where dwell the vast hosts of the dead.	彼の魂は非常に多数の死者たちの住む領域に近づいていた。
He was conscious of, but could not apprehend, their wayward and flickering existence.	彼はそれら、言うことを聞かない揺らめく存在を意識してはいたが把握できなかった。
His own identity was fading out into a grey impalpable world:	彼が彼自身であることが灰色の実体のない世界の中に次第に消えていった。
the solid world itself, which these dead had one time reared and lived in, was dissolving and dwindling.	かってこれらの死者たちが建設し、そこに生きた実質のある世界自体が溶けていき、だんだん小さくなっていた。
A few light taps upon the pane made him turn to the window.	そっとガラスを叩く音が彼を窓へと振り向かせた。
It had begun to snow again.	再び雪が降り始めていた。
He watched sleepily the flakes, silver and dark, falling obliquely against the lamplight.	彼は眠りに誘われるように、街灯の明かりを背景に斜めに落ちる銀色や影色の雪片をじっと見ていた。
The time had come for him to set out on his journey westward.	彼が西への旅に出発する時が来ていた。
Yes, the newspapers were right:	そうだ、新聞は正しかった。
snow was general all over Ireland.	雪はアイルランド全土にわたっていた。
It was falling on every part of the dark central plain, on the treeless hills, falling softly upon the Bog of Allen and, farther westward, softly falling into the dark mutinous Shannon waves.	それは暗い中央の平原のあらゆる地域の上に、木のない丘々の上に降り、静かにアレン湿原の上に降りそして、さらに西の方、暗く反抗的なシャナンの波の中に静かに降っていた。
It was falling, too, upon every part of the lonely churchyard on the hill where Michael Furey lay buried.	それはまたマイケル・フューレイが埋葬されて横たわる丘の上の寂しい教会の墓地のあらゆるところにも降りかかっていた。
It was falling, too, upon every part of the lonely churchyard on the hill where Michael Furey lay buried.	それは吹き流され、歪んだ十字架や墓石の上に、小さな門の尖塔の上に、実を結ばないイバラの上に厚く積もっていた。
His soul swooned slowly as he heard the snow falling faintly through the universe and faintly falling, like the descent of their last end, upon all the living and the dead.	彼の魂は、全宇宙に幽かに降り続く、そして来たるべき最期が降りくるのに似て、すべての生者と死者の上に幽かに降り続く雪を聞きながら、ゆっくり意識を失っていった。
