The Horse Dealer's Daughter	馬商の娘馬商の娘
David Herbert Lawrence	デイヴィド・ハーバート・ロレンス
'Well, Mabel, and what are you going to do with yourself?'	「よう、メイベル、で、お前はこれからどうするつもりだ？」
asked Joe, with foolish flippancy.	と、ジョーは下卑た軽薄な調子で言った。
He felt quite safe himself.	自分のことは、彼はさほど心配していなかった。
Without listening for an answer, he turned aside, worked a grain of tobacco to the tip of his tongue, and spat it out.	相手の返事に耳を傾けるつもりもなく、脇を向いて、煙草のかすを舌先に押し出し、それから唾と吐き出した。
He did not care about anything,	彼は何事も想いわずらわなかった
since he felt safe himself.	──自分の身空は安心だと思っていたのだ。
The three brothers and the sister sat round the desolate breakfast table, attempting some sort of desultory consultation.	三人の兄弟とその妹は、寒々とした朝食の卓を囲んで坐り、何かしらぼやぼやと相談をつづけていた。
The morning's post had given the final tap to the family fortunes, and all was over.	その日の朝届いた郵便が、もはや、彼らに打つ術はないことを告げ、一家の命運にとどめを刺したのだった。
The dreary dining-room itself, with its heavy mahogany furniture, looked as if it were waiting to be done away with.	彼らのいる食堂は、重々しいマホガニーの調度と相俟って、あたかも観念して処分されるのを待っているかのように、暗澹として見えた。
But the consultation amounted to nothing.	相談はどこに行き着くはずもなかった。
There was a strange air of ineffectuality about the three men, as they sprawled at table, smoking and reflecting vaguely on their own condition.	三人の兄弟たちは、手足を卓に投げ出し、煙草を吸い、自分の身の上をあいまいに考えているうちに、得体の知れない無力感にとりまかれたようになった。
The girl was alone, a rather short, sullen-looking young woman of twenty-seven.	ひとり除け者になっている妹は、たいそう小柄な、無愛敬な顔つきの、二十七歳の娘だった。
She did not share the same life as her brothers.	つねから、兄弟たちとは考えや感じ方を共有することのない彼女だった。
She would have been good-looking, save for the impassive fixity of her face, 'bull-dog', as her brothers called it.	もしその間鈍い硬い表情が抜ければ、彼女も美しい見目だったろうが、兄弟たちからは普段「ブルドッグ」と揶揄されていた。
There was a confused tramping of horses' feet outside.	戸の外には、馬がのし歩く入り乱れた足音が響いていた。
The three men all sprawled round in their chairs to watch.	三人の兄弟は椅子にだらしなく腰掛けたまま、それを眺める恰好になった。
Beyond the dark holly-bushes that separated the strip of lawn from the highroad, they could see a cavalcade of shire horses swinging out of their own yard, being taken for exercise.	街道と前庭とを隔てる、色の濃いヒイラギの茂みの向うに、勁悍な馬たちが、身体を馴らすため厩舎から連れ出され、列をなして颯爽と歩いているのが見えた。
This was the last time.	これが見納めだった。
These were the last horses that would go through their hands.	その馬たちが、彼らが売買を仲立ちする最後の馬になるはずだった。
The young men watched with critical, callous look.	その馬の歩みぶりを、彼らは荒廃した、むごいような目付きで見ていた。
They were all frightened at the collapse of their lives, and the sense of disaster in which they were involved left them no inner freedom.	彼らはみな自分の零落を恐れ、心の安らぎを奪う悲運の念に憑かれていた。
Yet they were three fine, well-set fellows enough.	とはいえ彼ら三人は皆、いかにも見目良い、逞しさのあふれる男だった。
Joe, the eldest, was a man of thirty-three, broad and handsome in a hot, flushed way.	長男のジョーは三十五歳で、その燃えるように溌剌とした物腰は頑健で、人目を引くとさえ言えた。
His face was red, he twisted his black moustache over a thick finger, his eyes were shallow and restless.	平生、ジョーの顔は赤み帯び、太々した指で黒い口髭をひねっていて、眼差しははしこく、落ちつきがなかった。
He had a sensual way of uncovering his teeth when he laughed, and his bearing was stupid.	彼は肉感あらわに歯を見せて笑い、立ち居振舞いは不遜だった。
Now he watched the horses with a glazed look of helplessness in his eyes, a certain stupor of downfall.	だが今は、自分の生活の破綻に茫然となり、諦めのぼんやりした眼差しで馬を見送っているのだった。
The great draught-horses swung past.	魁偉な馬たちが躍々と歩き過ぎて行った。
They were tied head to tail, four of them, and they heaved along to where a lane branched off from the highroad, planting their great hoofs floutingly in the fine black mud, swinging their great rounded haunches sumptuously, and trotting a few sudden steps as they were led into the lane, round the corner.	彼らは四頭ずつ、尾から頭へと繋がれて連なり、街道から枝分かれする小径へ向っていたが、滑らかに黒い泥をものともせず、大きなひづめを地に突き立て、見事に引き締った腿肉を豪奢にうねらせながら、小径にさしかかると不意に敏捷な足取りになって、角を折れて行くのだった。
Every movement showed a massive, slumbrous strength, and a stupidity which held them in subjection.	馬たちの動息一つひとつに、重みのある、眠っているような落ち着いた力強さと、人にしたがえられている従順な愚かさがあった。
The groom at the head looked back, jerking the leading rope.	先に立つ馬丁は、振り向いては、引き綱を無理に引っ張った。
And the calvalcade moved out of sight up the lane, the tail of the last horse, bobbed up tight and stiff, held out taut from the swinging great haunches as they rocked behind the hedges in a motionlike sleep.	やがて馬の行列は小径に消えたが、その一番後ろを歩く馬の尾──短く断ち切って整えた尾は、垣根を透かして、あたかも眠りながらの動きのように揺れている、馬の見事な臀の流れるに従って、しなやかに靡いていた。
Joe watched with glazed hopeless eyes.	ぼんやりした絶望の眼差しで、ジョーはそれを見ていた。
The horses were almost like his own body to him.	馬たちの境遇が彼と無縁とは思えなかった。
He felt he was done for now.	自分はもう終わりだと、彼は思っていた。
Luckily he was engaged to a woman as old as himself, and therefore her father, who was steward of a neighbouring estate, would provide him with a job.	幸いにも、彼は自分と同い年の女性と婚約しており、従って、近隣の地所の家令をしているその父親が、彼に職を与えてくれることになっている。
He would marry and go into harness.	つまり、彼はいずれ結婚して轡をはめられるのだ。
His life was over, he would be a subject animal now.	人生はついえ、もはや彼は他に隷属する動物にすぎない。
He turned uneasily aside, the retreating steps of the horses echoing in his ears.	彼は苛立ち気味に向き直ったが、遠ざかっていく馬の足音はまだ彼の耳に響いていた。
Then, with foolish restlessness, he reached for the scraps of bacon-rind from the plates, and making a faint whistling sound, flung them to the terrier that lay against the fender.	ジョーは滑稽なほど落ち着きがなく、しばらくすると、皿からベーコンの上皮の切れ端をつまんで、短く口笛を吹き、それを暖炉の前囲いに身を寄せて寝ていたテリア犬に放ってやった。
He watched the dog swallow them, and waited till the creature looked into his eyes.	ベーコンをがつがつ呑み込む犬に、眼を据えて、その獣が、彼を物欲しげに見つめ返すのを待った。
Then a faint grin came on his face, and in a high, foolish voice he said:	それから、微かな嘲笑を浮べて、甲高い、下卑た声で言った。
'You won't get much more bacon,	「ベーコンもっと欲しいか？
shall you,	ええ？
you little b----?'	欲しいだろう、このちび奴！」
The dog faintly and dismally wagged its tail, then lowered his haunches, circled round, and lay down again.	犬は怖じ怖じと惨めに尻尾を振り、臀を垂れ、ぐるりと廻ってみせたが、また身を横たえてしまった。
There was another helpless silence at the table.	ふたたびやりきれない沈黙が卓のまわりに降りた。
Joe sprawled uneasily in his seat, not willing to go till the family conclave was dissolved.	ジョーは苛立たしげに、だらしなく椅子に腰掛け、この家族会議が済むまで発って行く気も起きないようだった。
Fred Henry, the second brother, was erect, clean-limbed, alert.	次男のフレッド・ヘンリーは、姿勢の良い、身綺麗な、隙のない男だった。
He had watched the passing of the horses with more _sang-froid_.	馬の行列が過ぎ去るのを、彼は、兄よりも平静に眺めていた。
If he was an animal, like Joe, he was an animal which controls, not one which is controlled.	彼もまた兄のジョーと同じく、動物に喩えるなら、支配される側の獣ではなく、支配する側の獣だった。
He was master of any horse, and he carried himself with a well-tempered air of mastery.	彼は今までいかなる馬も掌中で扱ってきたのだし、毅然とふるまう支配者としての物腰が、自然身に付いていた。
But he was not master of the situations of life.	しかし彼も、畢竟人生の異事の支配者ではなかった。
He pushed his coarse brown moustache upwards, off his lip, and glanced irritably at his sister, who sat impassive and inscrutable.	彼は唇を覆っている茶色の粗々した口髭を、指で押し上げ、そして不気味に、ずっと無表情に坐っている妹に向って、癇の強い一瞥を投げた。
'You'll go and stop with Lucy for a bit, shan't you?'	「お前はしばらく、ルーシーのところに厄介になるんだったな？」
he asked.	彼は訊いた。
The girl did not answer.	妹は応えなかった。
'I don't see what else you can do,'	「けっ、外に身の振りようがないだろうが、」
persisted Fred Henry.	とフレッド・ヘンリーは重ねて言った。
'Go as a skivvy,'	「女中にでもなりゃいいさ、」
Joe interpolated laconically.	ジョーが言葉を挟んだ。
The girl did not move a muscle.	彼女は身じろぎ一つしなかった。
'If I was her, I should go in for training for a nurse,'	「僕が姉さんだったら、これから看護婦見習いになるだろうな、」
said Malcolm, the youngest of them all.	と、末弟のマルコムが言った。
He was the baby of the family, a young man of twenty-two, with a fresh, jaunty _museau_.	彼は一家の“ちび”で、快活な、がんぜ無い面立ちをした、二十二歳の若者だった。
But Mabel did not take any notice of him.	だがメイベルは、マルコムの言葉にも表情を動かさなかった。
They had talked at her and round her for so many years, that she hardly heard them at all.	これまで幾年ものあいだ、彼らは彼女に話しかけ、彼女の周囲で言葉を交わしてきたのだが、もはや、彼女がそれを気にかけることはほとんどないのだった。
The marble clock on the mantel-piece softly chimed the half-hour, the dog rose uneasily from the hearthrug and looked at the party at the breakfast table.	マントルピースの上の大理石の時計が、柔らかな音で正時半を告げると、犬が、不安気に敷物から身を起し、朝食の卓のまわりの彼らを見やった。
But still they sat on in ineffectual conclave.	しかし、まだ、彼らは益体無い相談をつづける恰好で、椅子に坐っていた。
'Oh, all right,'	「よし、わかった、」
said Joe suddenly, _a propos_ of nothing.	と、何についての事か、曖昧に、ジョーは突然言った。
'I'll get a move on.'	「俺はそろそろ行くぜ。」
He pushed back his chair, straddled his knees with a downward jerk, to get them free, in horsy fashion, and went to the fire.	彼は椅子を後ろへ押しやり、股を開いて、馬に乗るときような恰好で、膝を曲げてほぐすと、立ち上がって暖炉のそばへ歩み寄った。
Still he did not go out of the room;	彼は部屋を出て行こうとはしなかった
he was curious to know what the others would do or say.	──というのも、他の者がこれから何を言い、何をしようとするのか、興味があったのだ。
He began to charge his pipe, looking down at the dog and saying, in a high, affected voice:	ジョーはパイプに煙草を詰め、犬を見下ろしながら、甲高い、わざとらしい作り声で話し掛けた。
'Going wi' me?	「おい、一緒に行くか？
Going wi' me are ter?	俺に付いてくるか、お前？
Tha'rt goin' further than tha counts on just now,	お前にゃ想いもよらねえ、ずっと遠くへ行くことになるぜ。
dost hear?'	おい、いいか？」
The dog faintly wagged its tail,	犬はかすかに尾を振った。
the man stuck out his jaw and covered his pipe with his hands, and puffed intently, losing himself in the tobacco, looking down all the while at the dog with an absent brown eye.	彼は顎をしゃくりながら、パイプを手に包んでひたすら煙草を吸い、引っ切りなしに煙を吐き出していたが、そのあいだずっと、茶色の空ろな眼で、犬を見下ろしていた。
The dog looked up at him in mournful distrust.	犬の方でも彼を見上げたが、それは哀しげな不信の目色だった。
Joe stood with his knees stuck out, in real horsy fashion.	ジョーは、馬乗りのような恰好で、膝を突き出して立っていた。
'Have you had a letter from Lucy?'	「ルーシーから手紙は来たか？」
Fred Henry asked of his sister.	フレッド・ヘンリーは妹に訊ねた。
'Last week,'	「先週ね。」
came the neutral reply.	と無機質な声が返った。
'And what does she say?'	「なんて書いてあった？」
There was no answer.	相手は応えなかった。
'Does she _ask_ you to go and stop there?'	「お前に家に来いって言ってるのか？」
persisted Fred Henry.	とフレッド・ヘンリーはしつこく訊いた。
'She says I can if I like.'	「そうしたければ、そうしていいって。」
'Well, then, you'd better.	「なら、そうすりゃいい。
Tell her you'll come on Monday.'	月曜には行くって彼女に伝えてやれよ。」
This was received in silence.	その言葉の後には、深い沈黙が降りた。
'That's what you'll do then,	「そうするしかないだろ？
is it?'	ええ？」
said Fred Henry, in some exasperation.	と、フレッド・ヘンリーはやや腹立ちまぎれに言った。
But she made no answer.	だが彼女は応えなかった。
There was a silence of futility and irritation in the room.	もの憂さと苛立ちとを含んだ沈黙が、部屋に充ちた。
Malcolm grinned fatuously.	マルコムは間抜けたように、にやにや笑っていた。
'You'll have to make up your mind between now and next Wednesday,'	「来週の水曜までにはどうするか決めなきゃならんだろうな、」
said Joe loudly,	と、ジョーは声を大きくして言った、
'or else find yourself lodgings on the kerbstone.'	「でなけりゃ、野ざらしになるかだな。」
The face of the young woman darkened, but she sat on immutable.	翳りが娘の顔に差したが、やはり彼女はじっと坐っていた。
'Here's Jack Fergusson!'	「あ、ジャック・ファーガソンがいるよ！」
exclaimed Malcolm, who was looking aimlessly out of the window.	ぼんやり窓の外に眼を向けていたマルコムが、突然叫んだ。
'Where?'	「どこに？」
exclaimed Joe, loudly.	とジョーが喧しく訊ねた。
'Just gone past.'	「もう通り過ぎてった。」
'Coming in?'	「こっちに来そうか？」
Malcolm craned his neck to see the gate.	マルコムは門口の方を見ようと首を伸ばした。
'Yes,'	「来るね、」
he said.	と彼は言った。
There was a silence.	言葉は途切れた。
Mabel sat on like one condemned, at the head of the table.	メイベルはあたかも非難されているかのように、卓の上座にさらされて坐っていた。
Then a whistle was heard from the kitchen.	やがて台所に口笛の音が立った。
The dog got up and barked sharply.	犬が起き上がり鋭く吠え立てた。
Joe opened the door and shouted:	扉を開けたジョーは、大声で言った。
'Come on.'	「入りな！」
After a moment a young man entered.	少し間をおいて若い男が入って来た。
He was muffled up in overcoat and a purple woollen scarf, and his tweed cap, which he did not remove, was pulled down on his head.	彼は外套と紫の毛織りのスカーフに身を包み、ツイードの帽子を目深にかぶって、それを脱がずに立っていた。
He was of medium height, his face was rather long and pale, his eyes looked tired.	身の丈は中くらい、顔はとても縦長で蒼白く、両眼には疲れを浮べていた。
'Hello, Jack!	「こんにちは、ジャック！」
Well, Jack!'	「よう、ジャック！」
exclaimed Malcolm and Joe.	とマルコムとジョーは騒いだ。
Fred Henry merely said,	フレッド・ヘンリーは、ただ
'Jack.'	「ジャックか。」
'What's doing?'	「どんな具合だい？」
asked the newcomer, evidently addressing Fred Henry.	と客人は、マルコムとジョーにではなく、フレッド・ヘンリーに向って、訊ねた。
'Same.	「変わらんよ。
We've got to be out by Wednesday.	水曜までにはここを立ち退かなきゃならん。
--Got a cold?'	──風邪を引いたのかい？」
'I have	「まあね。
--got it bad, too.'	──こっちの具合もかんばしくないってわけだ。」
'Why don't you stop in?'	「家で寝てりゃいいじゃないか。」
'_Me_ stop in?	「家で寝る？
When I can't stand on my legs, perhaps I shall have a chance.'	まあ、いよいよ身体を壊してぶっ倒れたなら、そんな機会もあるだろうな。」
The young man spoke huskily.	と、若い男はしゃがれ声で言った。
He had a slight Scotch accent.	少しスコットランド訛りのある語気だった。
'It's a knock-out, isn't it,'	「こいつはたまげたぜ、」
said Joe, boisterously,	と、ジョーが騒々しく口を挟んだ、
'if a doctor goes round croaking with a cold.	「風邪引いて、のど嗄らした医者が、診察に参るってわけだ。
Looks bad for the patients, doesn't it?'	患者にとっちゃ良い話じゃねえな？」
The young doctor looked at him slowly.	若い医師はゆっくりとジョーに眼を向けた。
'Anything the matter with _you_, then?'	「ではあなたも、どこか具合が悪いんですね？」
he asked sarcastically.	と、彼は皮肉っぽく訊ねた。
'Not as I know of.	「別に悪かねえよ。
Damn your eyes, I hope not.	悪いわけないだろ、縁起でもねえ。
Why?'	なぜそんなこと訊くんだ？」
'I thought you were very concerned about the patients, wondered if you might be one yourself.'	「いや、あまりに患者のことを心配されているから、あなたも患者になるご予定がおありかと思ってね。」
'Damn it, no, I've never been patient to no flaming doctor, and hope I never shall be,'	「へっ、俺は今まで藪医者の世話になったことはなし、今後も世話になるつもりはないね。」
returned Joe.	とジョーは言い返した。
At this point Mabel rose from the table, and they all seemed to become aware of her existence.	そのときメイベルが卓から立ち上がり、彼らは皆、彼女の動息に少し注意を向けた。
She began putting the dishes together.	彼女は皿を重ね片付けはじめた。
The young doctor looked at her, but did not address her.	若い医師は彼女の方を見たが、声を掛けはしなかった。
He had not greeted her.	彼はまだ挨拶すらしていなかった。
She went out of the room with the tray, her face impassive and unchanged.	盆を持って部屋を出て行く彼女の顔は、やはり無表情で頑なだった。
'When are you off then, all of you?'	「皆さんは、いつ頃ここを出発するんですか？」
asked the doctor.	と医師が訊ねた。
'I'm catching the eleven-forty,'	「僕は十一時四十分のに乗るよ、」
replied Malcolm.	とマルコムが応えた、
'Are you goin' down wi' th' trap, Joe?'	「ジョー兄さん、兄さんは軽馬車で行くんだっけ？」
'Yes,	「そうさ。
I've told you I'm going down wi' th' trap, haven't I?'	さっき言ったじゃねえか、軽馬車で行くってな。」
'We'd better be getting her in then.	「じゃあそろそろ、馬の仕度をした方がいいよね。
--So long, Jack,	──ジャック、それじゃさよなら。
if I don't see you before I go,'	これが最後になるかもしれないからね、」
said Malcolm, shaking hands.	とマルコムは言って、ジャックと握手をした。
He went out, followed by Joe, who seemed to have his tail between his legs.	マルコムが部屋を出て行くのに、ジョーも従いて行ったが、彼の様子には、どこか負け犬のような物悲しさがあった。
'Well, this is the devil's own,'	「やれやれ、とんだ悲劇だな、」
exclaimed the doctor, when he was left alone with Fred Henry.	と、医師はフレッド・ヘンリーと二人きりになってから、慨嘆した。
'Going before Wednesday, are you?'	「水曜にはもう行っちまうのかい？」
'That's the orders,'	「それが定めさ。」
replied the other.	相手は応えた。
'Where,	「何処へ？
to Northampton?'	ノーサンプトンか？」
'That's it.'	「そうなるね。」
'The devil!'	「まさに悲劇だ！」
exclaimed Fergusson, with quiet chagrin.	静かな無念を噛みしめ、ファーガソンは強く言った。
And there was silence between the two.	二人のあいだにしばらく沈黙が続いた。
'All settled up, are you?'	「借金の片は付いたんだろ？」
asked Fergusson.	と、ファーガソンが訊ねた。
'About.'	「大体ね。」
There was another pause.	ふたたび言葉が途切れた。
'Well, I shall miss yer, Freddy, boy,'	「フレディ、会えなくなるのは寂しいな、」
said the young doctor.	と若い医師は言った。
'And I shall miss thee, Jack,'	「俺もさ。」
returned the other.	相手は応えた。
'Miss you like hell,'	「まったく辛いな──」
mused the doctor.	と、医師は物思わしげに言った。
Fred Henry turned aside.	フレッド・ヘンリーは脇を向いた。
There was nothing to say.	もう言うべきことは何もなかった。
Mabel came in again, to finish clearing the table.	そこへ、卓を仕舞いまで片付けるために、メイベルがふたたび入って来た。
'What are _you_ going to do, then, Miss Pervin?'	「あなたはこれからどうされるんですか、ミス・パーヴィン？」
asked Fergusson.	とファーガソンは訊ねた。
'Going to your sister's, are you?'	「お姉さんの婚家へ行くのでしたっけ？」
Mabel looked at him with her steady, dangerous eyes, that always made him uncomfortable, unsettling his superficial ease.	メイベルは、彼を剣呑な、揺るがない硬い眼つきで見返したが、それは以前から、彼を不安にさせ、つねに彼のうわべの礼節を脅かしてきた眼差しだった。
'No,'	「行きません、」
she said.	と彼女は言った。
'Well, what in the name of fortune _are_ you going to do?	「なら、これから一体全体どうするつもりだ？
Say what you mean to do,'	言え！」
cried Fred Henry, with futile intensity.	と、フレッド・ヘンリーは深追いする語勢で叫んだ。
But she only averted her head, and continued her work.	しかし、彼女は少し顔をそむけただけで、淡々と片付けをつづけた。
She folded the white table-cloth, and put on the chenille cloth.	白いテーブル・クロスを折りたたみ、代わりにシェニール織りのクロスを広げた。
'The sulkiest bitch that ever trod!'	「なんて薄鈍な女だ！」
muttered her brother.	と彼はぶつぶつ言った。
But she finished her task with perfectly impassive face, the young doctor watching her interestedly all the while.	関心の眼差しを向けはじめた若い医師の前で、ずっと彼女は、端然と無表情のまま、片付けを終えた。
Then she went out.	そして部屋を出て行った。
Fred Henry stared after her, clenching his lips, his blue eyes fixing in sharp antagonism, as he made a grimace of sour exasperation.	フレッド・ヘンリーは唇を固く結び、ねじけた忿懣に眉間をしかめ、鋭い敵意に青い眼を強ばらせて、彼女の後ろ姿を見据えていた。
'You could bray her into bits, and that's all you'd get out of her,'	「どうしようもない阿魔だ。
he said, in a small, narrowed tone.	と、彼は、小さい、抑えた声で言った。
The doctor smiled faintly.	医師は微笑した。
'What's she _going_ to do, then?'	「ともかく、彼女はどうするんだろうね？」
he asked.	と彼は訊ねた。
'Strike me if I know!'	「俺が知るかよ！」
returned the other.	相手は応えた。
There was a pause.	言葉が途切れた。
Then the doctor stirred.	医師はかすかに身じろぎした。
'I'll be seeing you tonight, shall I?'	「今夜会えるかい？」
he said to his friend.	彼は友人に言った。
'Ay	「ああ。
--where's it to be?	──でも、場所は何処で？
Are we going over to Jessdale?'	ジェスデイルまで行くか？」
'I don't know. I've got such a cold on me.	「いや、僕は風邪を引いてるし、まだ決められない。
I'll come round to the Moon and Stars, anyway.'	いずれにせよ《ムーン・アンド・スターズ亭》には顔を出すよ。」
'Let Lizzie and May miss their night for once, eh?'	「リジーとメイに待ちぼうけをくわせることになるな？」
'That's it	「しょうがない。
--if I feel as I do now.'	──こんな気分の時じゃね。」
'All's one--'	「気分のせいにするなよ──、」
The two young men went through the passage and down to the back door together.	二人は廊下を抜けて裏口へと降りて行った。
The house was large, but it was servantless now, and desolate.	家屋は大きかったが、召使いは一人も見られず、荒涼としていた。
At the back was a small bricked house-yard, and beyond that a big square, gravelled fine and red, and having stables on two sides.	家の裏手には煉瓦で舗装した小さな庭があり、そこを越えると、二方に厩舎のある、綺麗に赤い砂利を敷き詰めたひらけた場所になっていた。
Sloping, dank, winter-dark fields stretched away on the open sides.	厩舎のない側には、暗く湿った冬の野原が、坂になって遠くまで広がっていた。
But the stables were empty.	厩舎は今はもう空になっていた。
Joseph Pervin, the father of the family, had been a man of no education, who had become a fairly large horse dealer.	一家の父であるジョセフ・パーヴィンは、教育のない男でありながら、馬商として成功し、財をなした人物だった。
The stables had been full of horses, there was a great turmoil and come-and-go of horses and of dealers and grooms.	当時は厩舎も馬であふれ、馬と商人と馬丁が行き交うあわただしい喧噪に充ちていたものだった。
Then the kitchen was full of servants.	台所にも、多くの召使いが居並んでいた。
But of late things had declined.	だが凋落は急速にやって来た。
The old man had married a second time, to retrieve his fortunes.	衰運のあげくに、何のつもりでか、老人は再婚さえした。
Now he was dead and everything was gone to the dogs, there was nothing but debt and threatening.	しかし今や、父は死に、すべては崩落し、あとには借金と催促状だけが残ったのだった。
For months, Mabel had been servantless in the big house, keeping the home together in penury for her ineffectual brothers.	幾月にもわたって、メイベルは、召使いの失せたこの大きな家の体裁を、無為な兄弟たちに代ってなんとか取り繕っていた。
She had kept house for ten years.	これまで十年ものあいだ、彼女は家政をつとめてきたのだった。
But previously, it was with unstinted means.	一家が零落する以前には、物惜しみなどする必要はなかった。
Then, however brutal and coarse everything was, the sense of money had kept her proud, confident.	そして、彼女をとりまく何もかもが下品で粗野であっても、財産があるという意識が、彼女に誇りと自信とを与えていた。
The men might be foul-mouthed, the women in the kitchen might have bad reputations, her brothers might have illegitimate children.	男共が淫らな噂ばかり好み、台所で働く女のあいだに悪評が沸き、或いは、彼女の兄弟たちがよその女に子を孕ませているのだとしても、構わなかった。
But so long as there was money, the girl felt herself established, and brutally proud, reserved.	財産があるかぎり、娘は独尊を感じ、冷ややかな誇りは保たれていた。
No company came to the house, save dealers and coarse men.	商人と野卑な男たち以外に家を訪れる者はなかった。
Mabel had no associates of her own sex, after her sister went away.	姉が嫁いで行った後では、彼女に同性の話し相手はなくなった。
But she did not mind.	だが、彼女は気に掛けなかった。
She went regularly to church, she attended to her father.	教会に通うことを欠かさず、忠実しく父親の世話をした。
And she lived in the memory of her mother, who had died when she was fourteen, and whom she had loved.	そして彼女が十四のときに亡くなった、愛する母親の想い出を、慕って生きた。
She had loved her father, too, in a different way, depending upon him, and feeling secure in him,	彼女はまた父親も愛していたのだが、それは、母とは異なった仕方で、つまり、父親を頼りつづけ、彼の面目の元で順風を感じているということだった
until at the age of fifty-four he married again.	──彼が五十四歳の折に再婚するまでは。
And then she had set hard against him.	それを境に、彼女は父から離れ背くようになった。
Now he had died and left them all hopelessly in debt.	そしてついに父は、彼らに手に負えない借金を残して死んでしまった。
She had suffered badly during the period of poverty.	一家の貧窮がつづくあいだに、彼女の誇りはひどく傷ついた。
Nothing, however, could shake the curious sullen, animal pride that dominated each member of the family.	しかしパーヴィン家の人間に根づいている、奇妙に陰暗な、野性的な自尊心は揺るぐことはなかった。
Now, for Mabel, the end had come.	そして今、メイベルにとって、終わりは来た。
Still she would not cast about her.	彼女はもう未来を望まなかった。
She would follow her own way just the same.	彼女はただ、それまでと同じ彼女自身の流儀に従うだけだった。
She would always hold the keys of her own situation.	彼女は最後まで自分の身は自分で処するつもりだった。
Mindless and persistent, she endured from day to day.	何も考えずに、頑なに、彼女は困窮の日々を堪えて来たのだ。
Why should she think?	そもそも、何を考える必要があるというのか？
Why should she answer anybody?	誰に何を訴えるというのか？
It was enough that this was the end, and there was no way out.	終局は訪れたのであり、もはや出口はないというだけで、十分だ。
She need not pass any more darkly along the main street of the small town, avoiding every eye.	もう、人々の眼を恥じて、この小さな街の目抜き通りを憂鬱に歩き過ぎていく必要もない。
She need not demean herself any more, going into the shops and buying the cheapest food.	店へ入って、もっとも粗末な品に手を出し、自身を卑しめる必要もない。
This was at an end.	すべては終わった。
She thought of nobody,	誰の事も彼女は思い煩わなかった
not even of herself.	──自分自身の事さえも。
Mindless and persistent, she seemed in a sort of ecstasy to be coming nearer to her fulfilment, her own glorification, approaching her dead mother, who was glorified.	彼女は、何も考えず、頑なに、ただ自分自身の成就が迫っているのを感じ──彼女の崇拝、すなわち、彼女の胸裡で神々しい面影になっている亡き母親に、いよいよ近づいていくように感じて、ただ恍惚にひたっているようだった。
In the afternoon she took a little bag, with shears and sponge and a small scrubbing brush, and went out.	午後に、彼女は木ばさみとスポンジと小さな束子を入れたバッグを下げて、外へ出た。
It was a grey, wintry day, with saddened, dark-green fields and an atmosphere blackened by the smoke of foundries not far off.	蒼然とした冬日で、深緑の野は陰鬱に広がり、近くにある鋳物工場の煙りは大気を黒く濁していた。
She went quickly, darkly along the causeway, heeding nobody, through the town to the churchyard.	彼女は土手道を、足早に、憂鬱な顔で歩き、行き違う人を気にとめず、街を抜け教会墓地へと急いだ。
There she always felt secure, as if no one could see her,	墓地のなかでは、彼女はいつも、人々の視線から隔てられたような安堵を感じた
although as a matter of fact she was exposed to the stare of everyone who passed along under the churchyard wall.	──が、実際には、教会墓地の壁の下手を通りかかる者なら誰でも彼女の姿を見ることができた。
Nevertheless, once under the shadow of the great looming church, among the graves, she felt immune from the world, reserved within the thick churchyard wall as in another country.	それでもやはり、ぼんやりと浮ぶ大きい教会の影にひそみ隠れ、墓の間に立っていると、彼女は、世界の脅嚇を免れていると感じ、あたかも教会墓地の厚い壁によって、別世界に匿われたように感じるのだった。
Carefully she clipped the grass from the grave, and arranged the pinky-white, small chrysanthemums in the tin cross.	注意深く彼女は墓に生えた雑草を刈り、薄く赤らんだ白菊の花を、錫製の十字架に供えた。
When this was done, she took an empty jar from a neighbouring grave, brought water, and carefully, most scrupulously sponged the marble headstone and the coping-stone.	それを終えると、隣りの墓にあった空の水差しを取って、水を汲み、大理石の墓碑と冠石を、余念なく、隅々まで磨きはじめた。
It gave her sincere satisfaction to do this.	その作業は彼女に深い喜びを与えた。
She felt in immediate contact with the world of her mother.	母のいる世界にじかに触れているという感じがあった。
She took minute pains, went through the park in a state bordering on pure happiness, as if in performing this task she came into a subtle, intimate connexion with her mother.	純粋な幸福につつまれたように坐り込み、ひたむきに墓の掃除をするのに、彼女は、ほとんど労苦を覚えず、まるでそうした作業をつづけるうちに、彼女と母親とのあいだに仄かな、緊密なつながりが生まれるかのようだった。
For the life she followed here in the world was far less real than the world of death she inherited from her mother.	母親と連なることのできる、その死の世界に較べれば、彼女が現実の世界で従っている生は、色の稀薄なものでしかなかった。
The doctor's house was just by the church.	医師の家は、ちょうど教会の傍にあった。
Fergusson, being a mere hired assistant, was slave to the countryside.	ただの雇われの助手にすぎない彼──ファーガソンは、この田舎の土地に縛られている男だった。
As he hurried now to attend to the outpatients in the surgery, glancing across the graveyard with his quick eye, he saw the girl at her task at the grave.	診療所で待つ外来患者を診るため、足を急がせていた彼は、通りしな、はしこい眼で教会墓地を一瞥し、そこで墓石の掃除をしている娘を見かけた。
She seemed so intent and remote, it was like looking into another world.	一途に無心な彼女は、果てしなく遠い姿のようで、それを見るのは、まるで別世界をのぞき込むかのようだった。
Some mystical element was touched in him.	なにか不可思議な実体が、彼の内に触れて来た。
He slowed down as he walked, watching her as if spell-bound.	彼は徐々に歩調をゆるめ、呪縛されたように、彼女を見つめた。
She lifted her eyes, feeling him looking.	その眼差しを感じて、彼女は眼を上げた。
Their eyes met.	二人の目線が合った。
And each looked again at once, each feeling, in some way, found out by the other.	すると何故か、互いに、相手に心際を見抜かれたというような気がして、あらためて相手を見つめ直した。
He lifted his cap and passed on down the road.	彼は少し帽子を持ち上げて見せて、それから先を急いだ。
There remained distinct in his consciousness, like a vision, the memory of her face, lifted from the tombstone in the churchyard, and looking at him with slow, large, portentous eyes.	教会墓地のなかで、墓石の傍から頭をもたげ、鈍い、大きな、不吉な瞳で彼を見つめていた彼女の姿が、幻影のように、彼の意識に克明にとどまった。
It _was_ portentous, her face.	そう、彼女の面差しはいかにも不吉だった。
It seemed to mesmerize him.	しかもその顔は、彼を魅するかのようだった。
There was a heavy power in her eyes which laid hold of his whole being, as if he had drunk some powerful drug.	まるで劇薬を呑まされたかのように、彼の存在を捉え尽くす、苛烈な力を、彼女の両眼は帯びていた。
He had been feeling weak and done before.	彼はずっと以前から、自分の人生に見切りをつけ、凋衰に甘んじていたのだが、
Now the life came back into him, he felt delivered from his own fretted, daily self.	今、不意に彼に、生の手応えが戻って来て、自身を擦り減らす日々の暮らしから、解き放たれたように感じた。
He finished his duties at the surgery as quickly as might be, hastily filling up the bottles of the waiting people with cheap drugs.	彼は、病院での仕事を、急くように、並んで待っている患者たちの薬瓶に、間に合わせの薬をつめたりして、許されるかぎりの手早さで済ませた。
Then, in perpetual haste, he set off again to visit several cases in another part of his round, before teatime.	それからやはり急いで、お茶の時間の前の午後の往診に、幾人かの患者を訪ねるため、ふたたび病院を出た。
At all times he preferred to walk, if he could, but particularly when he was not well.	彼は常日頃、もしそうできるなら、いつでも歩いて行くことを好んだが、とりわけ、身体の具合が悪いときはそうだった。
He fancied the motion restored him.	身体を動かすことで調子を取り戻せると、彼は信じていたのだ。
The afternoon was falling.	午後は暮れていった。
It was grey, deadened, and wintry, with a slow, moist, heavy coldness sinking in and deadening all the faculties.	あたりは冬めいて薄暗く、生彩を無くし、そして緩い、潤むような重苦しい霜気が、肌に沁み入り、彼の知覚を鈍磨させるようだった。
But why should he think	だからどうしたというのか？
or notice?	──彼はそんなことを気にかけなかった。
He hastily climbed the hill and turned across the dark-green fields, following the black cinder-track.	忙しげに丘を登ると、黒々と石炭殻を敷きつめた路づたいに、深緑の野の方へ折れて行った。
In the distance, across a shallow dip in the country, the small town was clustered like smouldering ash, a tower, a spire, a heap of low, raw, extinct houses.	遠い彼方、浅く広い窪地になった先に、教会の塔が、尖り屋根が、そして圧し伏された、不熟な、凍てついた家々が、燻る灰のように群がり、小さな街をなしているのが見えた。
And on the nearest fringe of the town, sloping into the dip, was Oldmeadow, the Pervins' house.	そして、街の縁の一番手前、窪地へと下る勾配には、パーヴィン家の寂びた牧場があった。
He could see the stables and the outbuildings distinctly, as they lay towards him on the slope.	彼と真直ぐ向き合うように斜面に並んでいる、厩舎や、納屋を、彼ははっきりと眺めることができた。
Well, he would not go there many more times!	もはや、彼があの家へ頻々に足を運ぶことはないだろう。
Another resource would be lost to him, another place gone:	また一つ彼の生の慰めが失われ、貴重な場所が失われていく。
the only company he cared for in the alien, ugly little town he was losing.	彼の馴染むことのできない、この醜悪な小さな街で、ただ一人の気心の知れた仲間を、彼は失おうとしているのだった。
Nothing but work,	あとに残るのはただ仕事だけ
drudgery, constant hastening from dwelling to dwelling among the colliers and the iron-workers.	──炭坑夫たちと鉄工夫たちの棲家から棲家へと、絶えず急き立てられる、退屈な骨折り仕事だけだ。
It wore him out, but at the same time he had a craving for it.	だがその仕事は、彼を疲弊させつつ、同時に彼に渇望されてもいた。
It was a stimulant to him to be in the homes of the working people, moving as it were through the innermost body of their life.	労働者たちの棲家へ分け入ることは、あたかも彼らの生の、もっとも奥底の本性を手探りするようで、それは彼に非常な刺激なのだった。
His nerves were excited and gratified.	それは彼の神経を昂奮させ、満足を与える。
He could come so near, into the very lives of the rough, inarticulate, powerfully emotional men and women.	医師である彼は、荒々しく、支離滅裂な人々、凶暴な情動をかかえた男たちと女たちの生活そのものに、微に入り近づくことができた。
He grumbled, he said he hated the hellish hole.	彼はつねづね不平を言い、あの地獄の穴ぐらのような住居にはぞっとする、と口にした。
But as a matter of fact it excited him, the contact with the rough, strongly-feeling people was a stimulant applied direct to his nerves.	その実、それらは彼の情思をそそっていたのであり、野太い感情を持つ、無骨な人々に接することは、彼にとって、直に神経を焦がすような刺激なのだった。
Below Oldmeadow, in the green, shallow, soddened hollow of fields, lay a square, deep pond.	寂びた牧場の下方、緑色を帯び、浅く、水に浸かって落ちくぼんだところに、四角い形の深い池が横たわっていた。
Roving across the landscape, the doctor's quick eye detected a figure in black passing through the gate of the field, down towards the pond.	陰湿な眺めを当処なく見渡していた医師の、敏い眼が、木戸をくぐり、草地を横切り、その池へと真直ぐ下っていく黒衣の人影を捉えた。
He looked again.	彼は瞬きして眺め直した。
It would be Mabel Pervin.	その人影はメイベル・パーヴィンのようだった。
His mind suddenly became alive and attentive.	彼の意識は俄かに、かっと燃え立ち、注意は張りつめた。
Why was she going down there?	彼女はなぜ坂を下っているのだろうか？
He pulled up on the path on the slope above, and stood staring.	彼は池につづく勾配の上の小径で足を止めて、じっと眼を凝らした。
He could just make sure of the small black figure moving in the hollow of the failing day.	彼に分ったのは、薄ら陽に照らされた窪地を、黒い小さな人影が横切っているということだけだった。
He seemed to see her in the midst of such obscurity, that he was like a clairvoyant, seeing rather with the mind's eye than with ordinary sight.	彼の眼に、彼女があまりに危うい朧ろな姿に映るのは、あたかも彼が、普段の眼によらず、心の眼で見澄ます、神秘の力を得た者と化したかのようだった。
Yet he could see her positively enough, whilst he kept his eye attentive.	とはいえ、彼が注意を凝らして見つめているかぎり、彼女の姿は、はっきり捉えられていた。
He felt, if he looked away from her, in the thick, ugly falling dusk, he would lose her altogether.	彼は、もし自分が眼を逸らせば、この濃密に濁った暮れ方の陽光の下で、彼女を永遠に見失ってしまうのではないか、と感じた。
He followed her minutely as she moved, direct and intent, like something transmitted rather than stirring in voluntary activity, straight down the field towards the pond.	彼は彼女の動きを──一にひたむきに、意志を持って進むというより、何かに導かれるかのように、池へと真直ぐに草地を突っ切って行く彼女の動きを、一時も見失わぬよう、眼で追っていた。
There she stood on the bank for a moment.	岸にたどりついて、彼女はしばらく立ち止まっていた。
She never raised her head.	彼女は決して頭を上げなかった。
Then she waded slowly into the water.	やがて彼女は、ゆっくりと水のなかに足を踏み入れた。
He stood motionless as the small black figure walked slowly and deliberately towards the centre of the pond, very slowly, gradually moving deeper into the motionless water, and still moving forward as the water got up to her breast.	小さな黒い人影が、急がず、落ち着いて真直ぐに池の深みへ向うあいだ──とてもゆっくりと、徐々に徐々に、波立たぬ平らな水面へ沈んでいき、ついには、彼女の胸元が水につかるまで歩いて進むあいだ──彼は、身じろぎせず立ち尽くしていた。
Then he could see her no more in the dusk of the dead afternoon.	それから不意に、死んだような午後の夕闇に、彼女の姿が溶け去り、彼に見えなくなった。
'There!'	「まさか！」
he exclaimed.	と彼は叫んだ。
'Would you believe it?'	「くそっ、こんなことあり得るだろうか？」
And he hastened straight down, running over the wet, soddened fields, pushing through the hedges, down into the depression of callous wintry obscurity.	彼は湿深い、水に浸かった野を飛ぶように駈け下り、叢をかき分け、鈍く冷たい冬の瞑色におおわれた窪地へ下りて行った。
It took him several minutes to come to the pond.	すぐさま池にたどり着くというわけにはいかなかった。
He stood on the bank, breathing heavily.	彼は荒い息づかいで、岸に立った。
He could see nothing.	何も見えなかった。
His eyes seemed to penetrate the dead water.	彼は死んだような水面を見澄ました。
Yes, perhaps that was the dark shadow of her black clothing beneath the surface of the water.	いや、確かにこの静かな水面は、彼女の黒い服の影を隠しているにちがいない。
He slowly ventured into the pond.	彼は意を決して、慎重に池に踏み入った。
The bottom was deep, soft clay, he sank in, and the water clasped dead cold round his legs.	池底は深く、柔らかい粘った泥で、一歩ごとに足は沈み、そして水は冷たい死の感触で彼の膝に巻きついた。
As he stirred he could smell the cold, rotten clay that fouled up into the water.	みだりに動くと、水のなかに立ちのぼる、腐敗した泥の冷え冷えした臭いが、鼻についた。
It was objectionable in his lungs.	彼の肺臓に堪える臭いだった。
Still, repelled and yet not heeding, he moved deeper into the pond.	しかし、彼はなお水を踏み分け、ほとんど盲目的に、池の深みへと進んで行った。
The cold water rose over his thighs, over his loins, upon his abdomen.	冷えきった水が彼の腿に触れ、彼の腰を突き刺し、みぞおちまでを浸した。
The lower part of his body was all sunk in the hideous cold element.	もう彼の身体の下半が、総毛立つような冷ややかな存在に捕えられていた。
And the bottom was so deeply soft and uncertain, he was afraid of pitching with his mouth underneath.	足裏に触れる池底は深々と柔らかく、不確かで、彼は身体が傾いで前につんのめるのを、恐れはじめた。
He could not swim,	彼は泳げないのだ。
He crouched a little, spreading his hands under the water and moving them round, trying to feel for her.	彼は少し腰をかがめ、腕をひろげて水の下をめぐらし、彼女の気配を掴もうとした。
The dead cold pond swayed upon his chest.	死のように凍えた池水が彼の胸元でうねった。
He moved again, a little deeper, and again, with his hands underneath,	もう一度、手をより深いところまで伸ばし、幾度も、腕をめぐらせた。
he felt all around under the water.	周囲には水の動きしか感じられない
And he touched her clothing.	──と思うと、指先に彼女の衣服が触れた。
But it evaded his fingers.	しかし掴む間もなく、それは彼の指から逃れた。
He made a desperate effort to grasp it.	ふたたび彼女を捕えようと、彼は必死になった。
And so doing he lost his balance and went under, horribly, suffocating in the foul earthy water, struggling madly for a few moments.	だがそうするうちに彼は平衡を失い、溺れ沈み、すると、土臭く濁った水に息ができなくなり、狼狽して、足手限りにもがいた。
At last, after what seemed an eternity, he got his footing, rose again into the air and looked around.	永遠とも思える一時の後、なんとか池底に足をついて、彼は、水面に浮びあがり、あたりを見回した。
He gasped, and knew he was in the world.	喘ぐように息をしていたが、ともかく、自分がまだ生きていると実感できた。
Then he looked at the water.	池水を見やると、彼女も彼のそばに浮んでいた。
She had risen near him. He grasped her clothing, and drawing her nearer, turned to take his way to land again.	彼女の衣服をしっかり握り、彼女を引き寄せた彼は、ふたたび陸に上がるため向きを転じた。
He went very slowly, carefully, absorbed in the slow progress.	彼はゆっくりと、できるだけ慎重に、少しずつ前へ前へ足を運ぶことに集中した。
He rose higher, climbing out of the pond.	やがて彼は、這い上がるように池から身体を現した。
The water was now only about his legs;	もう水は彼の足元までしかとどいていない。
he was thankful, full of relief to be out of the clutches of the pond.	纏いつくような池水の感触から逃れて、彼は、深い安堵とありがたみとを覚えた。
He lifted her and staggered on to the bank, out of the horror of wet, grey clay.	彼女を抱え上げ、よろめきながら、彼は恐ろしい灰色の緩い泥土を脱け出して、岸に上がった。
He laid her down on the bank.	彼は彼女を岸に寝かせた。
She was quite unconscious and running with water.	彼女は意識がなく、かなり水を呑んでいた。
He made the water come from her mouth, he worked to restore her.	彼は彼女に水を吐かせ、幾度もみぞおちを圧してやった。
He did not have to work very long before he could feel the breathing begin again in her;	彼女が息を吹き返すのにそれほど時間はかからなかった
she was breathing naturally.	──彼女の息差しはすぐ普段どおりに戻った。
He worked a little longer.	もうしばらくのあいだ、彼はみぞおちを圧しつづけた。
He could feel her live beneath his hands;	彼女の生の温みが手のひらに感じられた
she was coming back.	──彼女はもう意識を取り戻していた。
He wiped her face, wrapped her in his overcoat, looked round into the dim, dark-grey world, then lifted her and staggered down the bank and across the fields.	彼女の顔を拭い、自分の外套で身体をくるんでやり、彼は、あたりの薄闇をしばらく眺め渡して、それから、彼女を抱え上げると、危うい足取りで、岸を離れ、野の方へ歩いて行った。
It seemed an unthinkably long way, and his burden so heavy he felt he would never get to the house.	パーヴィン家までの道のりは、気が遠くなるほど長く、彼の負う荷は重く、永久に家に辿り着けないのではないかとさえ、彼に感じられた。
But at last he was in the stable-yard, and then in the house-yard.	だが、とうとう厩舎の並ぶ庭にさしかかり、ついで母屋の中庭に辿り着いた。
He opened the door and went into the house.	彼は扉を開け、家のなかへ入った。
In the kitchen he laid her down on the hearthrug, and called.	彼女を台所に横たえてから、人を呼んでみた。
The house was empty.	家には誰も居ないようだった。
But the fire was burning in the grate.	しかし、暖炉の格子の奥には火の気があった。
Then again he kneeled to attend to her.	彼は跪いて彼女の様子をうかがった。
She was breathing regularly, her eyes were wide open and as if conscious, but there seemed something missing in her look.	彼女の息合いは規則正しく、もう正気づいたように眼は開かれていたが、まだどこか虚ろなようだった。
She was conscious in herself, but unconscious of her surroundings.	彼女自身の内奥は目覚めているが、周囲にはまだ意識が触れていないような虚脱だった。
He ran upstairs, took blankets from a bed, and put them before the fire to warm.	彼は階段を駆けのぼり、毛布を幾枚か取って来ると、それらを暖炉の火にかざして暖めた。
Then he removed her saturated, earthy-smelling clothing, rubbed her dry with a towel, and wrapped her naked in the blankets.	それから水浸しの、泥臭い彼女の服を脱がせ、ずぶ濡れの身体をタオルで拭いてやり、裸のまま毛布にくるんでやった。
Then he went into the dining-room, to look for spirits.	強い酒か何かを探して台所へ行った彼は、
There was a little whisky.	ほんの少し残っていたウィスキーを見つけた。
He drank a gulp himself, and put some into her mouth.	まずそれを、自分でも一息飲んでから、幾らか彼女の口のなかへ含ませた。
The effect was instantaneous.	効き目はすぐに表われた。
She looked full into his face, as if she had been seeing him for some time, and yet had only just become conscious of him.	あたかも、その時まで眼に映ってはいたものの、今はじめて彼の存在に気づいたかのように、彼女は、彼の顔をまじまじと眺めた。
'Dr. Fergusson?'	「ファーガソン先生？」
she said.	と彼女は声を出した。
'What?'	「何ですか？」
he answered.	彼は応じた。
He was divesting himself of his coat, intending to find some dry clothing upstairs.	外套を脱ぎながら、上の階に乾いた衣服がなかったろうかと、彼は考えていた。
He could not bear the smell of the dead, clayey water, and he was mortally afraid for his own health.	死のような粘った泥水の臭いに苛まれ、彼は自分の体の具合を危惧した。
'What did I do?'	「私、どうしたんでしょう？」
she asked.	彼女は訊ねた。
'Walked into the pond,'	「池へ入って行ったんですよ、」
he replied.	と彼は答えた。
He had begun to shudder like one sick, and could hardly attend to her.	病熱を帯びたように身体が慄えはじめていて、彼女に応対するのも辛いようだった。
Her eyes remained full on him,	だが、彼女の眼は彼にじっと注がれていた。
he seemed to be going dark in his mind, looking back at her helplessly.	彼女のその姿を見つめ返すと、気がゆるみ、彼の意識は、暗くしびれてくるようだった。
The shuddering became quieter in him, his life came back in him, dark and unknowing, but strong again.	身震いは、徐々におさまり、陰った、未知の生き生きしさが、彼の内に打ち寄せるように、戻って来た。
'Was I out of my mind?'	「気を失っていたんですか？」
she asked, while her eyes were fixed on him all the time.	彼に堅い眼差しを向けたまま、彼女は訊ねた。
'Maybe, for the moment,'	「そうです、しばらくの間ね、」
he replied.	と彼は答えた。
He felt quiet,	彼は落ち着いていた
because his strength had come back.	──もう彼は生気を取り戻していた。
The strange fretful strain had left him.	言い知れず焦らされるような不安は、もう彼になかった。
'Am I out of my mind now?'	「今も気を失っているんですか？」
she asked.	と彼女は言った。
'Are you?'	「今も？」
he reflected a moment.	と彼は驚いて応えた。
'No,'	「いいえ、」
he answered truthfully,	と生真面目に言った、
'I don't see that you are.'	「そうは見えませんね。」
He turned his face aside.	彼は顔をそむけた。
He was afraid now, because he felt dazed, and felt dimly that her power was stronger than his, in this issue.	どうやら彼よりも確かに力強い、彼女の精気に圧されて、意識があやふやに、眩んでしまうのを感じて、彼は怖れはじめたのだ。
And she continued to look at him fixedly all the time.	彼女は瞬きもせず彼を見つめていた。
'Can you tell me where I shall find some dry things to put on?'	「僕が着られるような乾いた服が、どこかにありませんか？」
he asked.	と彼は訊ねた。
'Did you dive into the pond for me?'	「私のために池に飛び込んでくれたんですか？」
she asked.	彼女は訊ねた。
'No,'	「いや、」
he answered.	と彼は応えた。
'I walked in.	「歩いて入ったんです。
But I went in overhead as well.'	結局頭まで水を被ってしまいましたが。」
There was silence for a moment.	しばらく沈黙がつづいた。
He hesitated.	彼は迷っていた。
He very much wanted to go upstairs to get into dry clothing.	すぐにでも上の階へ行って服を着替えたかった。
But there was another desire in him.	しかし、それとはまた別の欲求も感じていた。
And she seemed to hold him.	それに彼女も、彼に傍に居てほしいようだった。
His will seemed to have gone to sleep, and left him, standing there slack before her.	彼女の前に茫漠と突っ立ったままに、彼の意志は眠りへと引きずられて行きそうだった。
But he felt warm inside himself.	それでいて、彼の身内には暖かいものがあった。
He did not shudder at all, though his clothes were sodden on him.	濡れそぼつ服に身をつつんでいながら、彼はまったく寒気を感じなかった。
'Why did you?'	「でも、なぜ？」
she asked.	と彼女は訊ねた。
'Because I didn't want you to do such a foolish thing,'	「あなたにそんな馬鹿げた真似をさせたくなかったからですよ、」
he said.	と彼は言った。
'It wasn't foolish,'	「馬鹿げてません、」
she said, still gazing at him as she lay on the floor, with a sofa cushion under her head.	と、彼女は、クッションを枕にして床に横たわったまま、やはり彼を見つめて、言った。
'It was the right thing to do.	「当然するべきことをしたんです。
_I_ knew best, then.'	気紛れでもありません。」
'I'll go and shift these wet things,'	「ちょっと、この濡れた服を取り替えてきます、」
he said.	と彼は言った。
But still he had not the power to move out of her presence, until she sent him.	しかし、彼女の気配が、彼を射抜いているかぎり、彼はその場を立ち去れなかった。
It was as if she had the life of his body in her hands, and he could not extricate himself.	彼女の手に自身の生を握られてしまったように、彼は逃れがたさを感じた。
Or perhaps he did not want to.	そして、おそらくは彼も、自らそれを望んでいたのかもしれない。
Suddenly she sat up.	不意に彼女は体を起した。
Then she became aware of her own immediate condition.	それで、彼女は自分が今どんな姿であるかに気づいた。
She felt the blankets about her, she knew her own limbs.	身にまとった毛布を手でさぐり、自分の裸の四肢に触れた。
For a moment it seemed as if her reason were going.	しばらく、彼女は放心したように動かなかった。
She looked round, with wild eye, as if seeking something.	それから、荒々しい目付きで、何か探すようにあたりを見回した。
He stood still with fear.	彼は恐怖に身動きできず、立ち尽くしていた。
She saw her clothing lying scattered.	自分の服が投げ散らかっているのを、彼女は見た。
'Who undressed me?'	「誰が私を脱がせたんです？」
she asked, her eyes resting full and inevitable on his face.	避けられないような目線を、彼の顔にじっと据えて、彼女は訊ねた。
'I did,'	「僕です、」
he replied,	と彼は応えた、
'to bring you round.'	「あなたを介抱するために──」
For some moments she sat and gazed at him awfully, her lips parted.	しばらくのあいだ、体を起した彼女は、唇を半ば開き、彼を獰猛に見据えていた。
'Do you love me then?'	「じゃあ、私を愛してるのね？」
she asked.	と、彼女は訊ねた。
He only stood and stared at her, fascinated.	彼は、答えずに、ただ惹き入られるように彼女を見つめていた。
His soul seemed to melt.	彼の精神は恍惚に溶けるようだった。
She shuffled forward on her knees, and put her arms round him, round his legs, as he stood there, pressing her breasts against his knees and thighs, clutching him with strange, convulsive certainty, pressing his thighs against her, drawing him to her face, her throat, as she looked up at him with flaring, humble eyes, of transfiguration, triumphant in first possession.	彼女は膝を引きずってゆっくりと彼に近寄り、両の腕を彼に──彼の脚にまわして、彼が立ち尽くしているのにかまわず、胸先を彼の膝と腿に押し当て、不可思議な、戦くような力強さで締め付け、さらに彼の両膝を強くかき抱くと、自分の顔に、喉元に、彼を引き寄せ、この初めての抱擁を勝ち誇るかのような、それまでとはまるで違った、燃え輝く、野卑な眼差しで、彼を見上げた。
'You love me,'	「愛してるのね、」
she murmured, in strange transport, yearning and triumphant and confident.	想い焦がれるように、勝ち誇るように、確信に充ちて、彼女は異様な無心のままにつぶやいた。
'You love me.	「愛しているのね──、
I know you love me, I know.'	分ったわ、やっと分ったわ、私を愛しているのね。」
And she was passionately kissing his knees, through the wet clothing, passionately and indiscriminately kissing his knees, his legs, as if unaware of every thing.	それから彼女は、濡れた服を着たままの、彼の膝に、熱烈に接吻し、さらに憑かれたように、膝に、脚に、見境いなく熱い唇を押し付けた。
He looked down at the tangled wet hair, the wild, bare, animal shoulders.	彼は彼女の濡れて縺れた髪筋と、荒れ立った、むき出しの、獣ののような肩先とを見下ろしていた。
He was amazed, bewildered, and afraid.	彼が感じていたのは、驚きと、当惑と、恐怖だった。
He had never thought of loving her.	彼は、自分が彼女を愛しているなど、思ってみたこともなかった。
He had never wanted to love her.	彼女を愛したいと考えたことさえなかった。
When he rescued her and restored her, he was a doctor, and she was a patient.	彼が彼女を助け、正気づかせたのは、医師としてであり、相手は患者に過ぎなかった。
He had had no single personal thought of her.	彼女に対する、彼個人としての想いなどあろうはずはなかった。
Nay, this introduction of the personal element was very distasteful to him, a violation of his professional honour.	のみならず、こうして個人の事柄を交えられるのは、彼には不快で、自分の職業の尊厳を傷つけられたとさえ、感じた。
It was horrible to have her there embracing his knees.	彼女にこんな風に膝に抱きつかれているのは、おぞましかった。
It was horrible.	息詰まる嫌悪を感じた。
He revolted from it, violently.	荒々しい反感がつのった。
And yet--and yet--he had not the power to break away.	しかしそれでいて──なお、彼はそこから逃げ出す力が出なかった。
She looked at him again, with the same supplication of powerful love, and that same transcendent, frightening light of triumph.	彼女は変わらず、猛々しい愛執と、度外れの、脅かすような勝ち誇った眼の輝きで、ふたたび彼を見上げた。
In view of the delicate flame which seemed to come from her face like a light, he was powerless.	彼女の面差しの、ゆらめき放たれるような繊細な炎を間近にして、彼は無力だった。
And yet he had never intended to love her.	しかし、なお彼は彼女を自ら愛そうとは考えなかった。
He had never intended.	そんな気にはならなかった。
And something stubborn in him could not give way.	なにかしら頑ななものが、折れずに、彼の内にとどまっていた。
'You love me,'	「私を愛してるのね、」
she repeated, in a murmur of deep, rhapsodic assurance.	と、夢のように深い確信を帯びたつぶやきで、彼女はくり返した。
'You love me.'	「愛してるのね。」
Her hands were drawing him, drawing him down to her.	彼女の腕に引き寄せられ、彼は身をかがめた。
He was afraid, even a little horrified.	彼は恐怖と、そして幾分ぞっとするような嫌悪も感じていた。
For he had, really, no intention of loving her.	彼女を愛そうなどという考えは、彼にまったく無かった。
Yet her hands were drawing him towards her.	だが彼女の腕はしきりに彼を抱き寄せようとする。
He put out his hand quickly to steady himself, and grasped her bare shoulder.	彼は倒れぬよう、とっさに手を伸ばし、彼女の肩の素肌を掴んだ。
A flame seemed to burn the hand that grasped her soft shoulder.	すると、彼の手と彼女の柔らかい肩との触れ先に、熱い、火傷ような感覚が走った。
He had no intention of loving her:	だが、決して、彼は彼女を愛しはしない
his whole will was against his yielding.	──彼女に屈してはならないと、彼の意志は必死に抵抗していた。
It was horrible.	彼女を愛する──それはおぞましい事だ。
And yet wonderful was the touch of her shoulders, beautiful the shining of her face.	しかし彼女の肩のふくらかな感触はすばらしく、彼女の顔は美しく輝いている。
Was she perhaps mad?	彼女は正気なのだろうか？
He had a horror of yielding to her.	彼女に屈するのは恐ろしいことだ。
Yet something in him ached also.	しかし、彼の内には、何かしら疼くようなものもあった。
He had been staring away at the door, away from her.	彼は彼女を避けるように、遠くの扉を見つめ続けていた。
But his hand remained on her shoulder.	だが彼の手は彼女の肩に置かれていた。
She had gone suddenly very still.	突然、彼女は動きを止めて、静かになった。
He looked down at her.	彼は彼女に目を向けた。
Her eyes were now wide with fear, with doubt, the light was dying from her face, a shadow of terrible greyness was returning.	不安と疑念とに、彼女の眼は大きく見開かれ、彼女の面差しの明るさは消え去り、影のような、痛ましい蒼味に覆われていた。
He could not bear the touch of her eyes' question upon him, and the look of death behind the question.	そして、彼女の問い掛けの眼差しの強迫と、その問いの裏にある絶望の色は、もはや彼には堪えられなかった。
With an inward groan he gave way, and let his heart yield towards her.	心の内で呻きながら、彼は屈服し、自分の心が彼女に惹き入られるにまかせた。
A sudden gentle smile came on his face.	不意に彼の顔に、優しい微笑が浮んだ。
And her eyes, which never left his face, slowly, slowly filled with tears.	すると、片時も彼の顔から離れることのなかった彼女の眼に、ゆっくりと、とてもゆっくりと、涙があふれてきた。
He watched the strange water rise in her eyes, like some slow fountain coming up.	その不可思議な水が、あたかも、ひっそりと泉が湧き出るように、彼女の眼に満ち溢れるのを、彼は見ていた。
And his heart seemed to burn and melt away in his breast.	そして彼の心臓は、胸のなかで爆ぜ、溶け崩れていくかのようだった。
He could not bear to look at her any more.	もう彼は彼女を見ていられなかった。
He dropped on his knees and caught her head with his arms and pressed her face against his throat.	膝を床につき、彼女の頭を腕にかかえ、喉元に彼女の顔を押し当てるように抱きしめた。
She was very still.	彼女はとても静かにしていた。
His heart, which seemed to have broken, was burning with a kind of agony in his breast.	もはや裂け潰れてしまったように思える彼の心臓は、胸のなかで、灼けるような苦悶に焦がれていた。
And he felt her slow, hot tears wetting his throat.	やがて彼は、静かに、熱い涙が彼の襟首を伝っていくのを感じた。
But he could not move.	彼は身動きできなかった。
He felt the hot tears wet his neck and the hollows of his neck, and he remained motionless, suspended through one of man's eternities.	熱い涙が彼の首と喉元のくぼみを濡らすのを感じながら、彼は、人が知り得る永遠の感情の一つを抱いて、じっと動かずにいた。
Only now it had become indispensable to him to have her face pressed close to him;	今はじめて、彼は身際にある彼女の顔を、失いたくないと感じた
he could never let her go again.	──もう彼はそれを放すことができなかった。
He could never let her head go away from the close clutch of his arm.	彼女の頭をきつく抱えているその腕を解くことができなかった。
He wanted to remain like that for ever, with his heart hurting him in a pain that was also life to him.	心臓に、彼にとって生そのものである痛苦を感じながら、永遠にその形姿のままでいることを、彼は望んだ。
Without knowing, he was looking down on her damp, soft brown hair.	意識せぬままに、彼は彼女の蒸れた、柔らかな褐色の髪を見下ろした。
Then, as it were suddenly, he smelt the horrid stagnant smell of that water.	すると、不意打ちのように、泥水の淀んだ厭わしい臭いが彼の鼻を衝いた。
And at the same moment she drew away from him and looked at him.	同時に、彼女は彼から身を離して、彼を見つめた。
Her eyes were wistful and unfathomable.	想い沈むような、測りがたい目色だった。
He was afraid of them, and he fell to kissing her, not knowing what he was doing.	その眼に恐れおののき、彼は、自分が何をしているか覚束ないまま、彼女に接吻しはじめていた。
He wanted her eyes not to have that terrible, wistful, unfathomable look.	そのような、痛々しい、沈鬱な、測りがたい光りが彼女の眼に浮ぶのが、彼には辛かったのだ。
When she turned her face to him again, a faint delicate flush was glowing, and there was again dawning that terrible shining of joy in her eyes,	ふたたび彼女が彼と向き合ったときには、彼女の顔は赤らんで、繊細な光りにほのめき、そして、眼にはまたも彼を脅かす熾烈な喜びの輝きが現れていた
which really terrified him, and yet which he now wanted to see, because he feared the look of doubt still more.	──その輝きはたしかに彼を脅かしたが、彼女の疑いの目色をもう堪え難いと感じる彼には、むしろ望まれている輝きなのだった。
'You love me?'	「私を愛してるの？」
she said, rather faltering.	と、彼女はおずおずと言った。
'Yes.'	「ええ。」
The word cost him a painful effort	この言葉は、彼には苦渋の一言だった。
Not because it wasn't true.	それが虚偽だからではない。
But because it was too newly true, the _saying_ seemed to tear open again his newly-torn heart.	それはあまりに、彼に未知の真実であり、それを告げることは、すでに生々しい裂け目のある彼の心を、さらに裂き開くような痛みなのだった。
And he hardly wanted it to be true, even now.	そして、それが真実であってほしくないという気持も、彼にはまだあった。
She lifted her face to him, and he bent forward and kissed her on the mouth, gently, with the one kiss that is an eternal pledge.	彼女が顔を上げると、彼は前へ身を傾けて、永久の誓約であるかのように、優しく、彼女と唇を重ねた。
And as he kissed her his heart strained again in his breast.	と同時に、彼の心臓は胸の内で、ふたたび締めつけられた。
He never intended to love her.	彼は彼女を愛そうとしたことは決してなかった。
But now it was over.	だが、その抵抗も終わりだった。
He had crossed over the gulf to her, and all that he had left behind had shrivelled and become void.	彼は彼女のいる側へ、遠い隔たりを越えて渡ったのであり、彼が後に残してきたものは、もはや瑣末な、空ろなものとしか感じられない。
After the kiss, her eyes again slowly filled with tears.	接吻の後、またも彼女の眼をゆっくりと涙が満たしていった。
She sat still, away from him, with her face drooped aside, and her hands folded in her lap.	彼女は、彼から離れ、顔を脇に俯け、膝の上に腕を組んで静かに坐っていた。
The tears fell very slowly.	涙はとてもゆるやかに頬を流れていた。
There was complete silence.	完璧な静けさがあたりに降りていた。
He too sat there motionless and silent on the hearthrug.	彼も炉床に、身じろぎせず、黙って坐っていた。
The strange pain of his heart that was broken seemed to consume him.	裂け崩れた心の、不思議な痛みが、彼を喰い尽くしたようだった。
That he should love her?	──まさか、自分が彼女を愛することになるとは！
That this was love!	これが──これが愛だとは！
That he should be ripped open in this way!	自分がこんな風に胸を抉られようとは！
--Him, a doctor!	只の医師に過ぎない彼が！
--How they would all jeer if they knew!	──このことを知ったら、彼の知人たちはみな彼を嘲ることだろう。
--It was agony to him to think they might know.	それを思うと、彼は暗澹とした。
In the curious naked pain of the thought he looked again to her.	思いを馳せるうちに、奇妙に生々しい苦痛を覚えて、彼はふたたび彼女を見つめた。
She was sitting there drooped into a muse.	彼女はしょんぼりと、物思いにふけっているようだった。
He saw a tear fall, and his heart flared hot.	涙が彼女の頬を伝うのを見ると、彼の心は熱く揺らめいた。
He saw for the first time that one of her shoulders was quite uncovered, one arm bare, he could see one of her small breasts;	彼は、毛布がずれて下がって、彼女の片方の肩と、片腕の肌が露わになっていることにはじめて気づき、彼女の片方の小さな胸を認めた
dimly, because it had become almost dark in the room.	──ほとんど暗闇につつまれた部屋のなかで、ぼんやりとではあったが。
'Why are you crying?'	「何故泣いているんです？」
he asked, in an altered voice.	彼は声音を変えて訊ねた。
She looked up at him, and behind her tears the consciousness of her situation for the first time brought a dark look of shame to her eyes.	顔を上げた彼女の眼は、はじめて自分が泣いていることに気づいたように、涙を透かして暗い羞恥の光りを帯びた。
'I'm not crying, really,'	「泣いているわけじゃないんです、ほんとうに、」
she said, watching him half frightened.	半ば怯えながら彼を見て言った。
He reached his hand, and softly closed it on her bare arm.	彼は手を伸ばし、彼女の腕の肌をそっと握った。
'I love you!	「愛しています、
I love you!'	あなたを愛しています──！」
he said in a soft, low vibrating voice, unlike himself.	と、彼は、密やかな、低い震え声、彼本来のものでないような声で言った。
She shrank, and dropped her head.	彼女は身を縮こませ、項垂れた。
The soft, penetrating grip of his hand on her arm distressed her.	親密に、沁み入るような感触で彼が彼女の腕を握っているのは、彼女を困らせた。
She looked up at him.	彼女は顔を上げて、彼を見つめた。
'I want to go,'	「放してください、」
she said.	と彼女は言った。
'I want to go and get you some dry things.'	「上へ行って乾いた服を取って来ますから。」
'Why?'	「何故？」
he said.	彼は言った。
'I'm all right.'	「僕は平気ですよ。」
'But I want to go,'	「でも、そうしたいんです、」
she said.	と彼女は言った。
'And I want you to change your things.'	「あなたにも服を着替えてほしいんです。」
He released her arm, and she wrapped herself in the blanket, looking at him rather frightened.	彼が手を放すと、彼女は毛布でしっかりと身をつつみ、怖がるような眼で彼を見た。
And still she did not rise.	そしてまだ立ち上がらずにいた。
'Kiss me,'	「キスして。」
she said wistfully.	彼女は思い沈んだ声で言った。
He kissed her, but briefly, half in anger.	彼は彼女に唇を触れたが、怒っているかのように、すぐに離した。
Then, after a second, she rose nervously, all mixed up in the blanket.	それから間をおかず、毛布が全身を隠すよう気を遣いながら、彼女はそろそろと立ち上がった。
He watched her in her confusion, as she tried to extricate herself and wrap herself up so that she could walk.	歩きやすいように、彼女が毛布をゆるめてから身体に巻き直そうとして、まごつくのを、彼はじっと見据えていた。
He watched her relentlessly, as she knew.	彼のその仮借ない眼差しを、彼女も気づいていた。
And as she went, the blanket trailing, and as he saw a glimpse of her feet and her white leg, he tried to remember her as she was when he had wrapped her in the blanket.	そして、毛布を引きずって歩き出した彼女の、束の間ひらめいた白い脚とふくらはぎを眼にして、彼は、自分が先ほど毛布にくるんでやった折の彼女の姿を、想い出そうとした。
But then he didn't want to remember,	だが、すぐにそれをやめた
because she had been nothing to him then, and his nature revolted from remembering her as she was when she was nothing to him.	──というのも、あの時はまだ彼にとって何者でもなかった彼女、その彼女の姿を、記憶に呼びさますのは、今はもう強く抵抗をおぼえることになっていたから。
A tumbling, muffled noise from within the dark house startled him.	籠った、忙しげな音が暗い家の中に響いて、彼をはっとさせた。
Then he heard her voice:	つづいて、彼女の声が聞えた
--'There are clothes.'	──「これを着てください。」
He rose and went to the foot of the stairs, and gathered up the garments she had thrown down.	彼は起き上がり、階段の上り口まで行って、彼女が投げて落とした衣服を拾い集めた。
Then he came back to the fire, to rub himself down and dress.	暖炉の傍に戻ると、体を拭いて、着替えた。
He grinned at his own appearance when he had finished.	身支度を済ますと、自分の新しい装いを見て、少し苦笑した。
The fire was sinking, so he put on coal.	消えかかっている炎に、彼は石炭をくべた。
The house was now quite dark, save for the light of a street-lamp that shone in faintly from beyond the holly trees.	ヒイラギの木の向うにほのめく街灯の光りがわずかに射すだけで、家の中は、もうほとんど闇に沈んでいた。
He lit the gas with matches he found on the mantel-piece.	マントルピースの上に見つけたマッチで、彼はランプを点した。
Then he emptied the pockets of his own clothes, and threw all his wet things in a heap into the scullery.	それから自分の服のポケットの中身を取り出し、濡れた服を山にして、洗い場に投げ込んだ。
After which he gathered up her sodden clothes, gently, and put them in a separate heap on the copper-top in the scullery.	次に、彼女のずぶ濡れの衣服を、丁寧に拾い集め、洗い場の銅の台板に、別の山にしてのせた。
It was six o'clock on the clock.	時計は六時を指していた。
His own watch had stopped.	彼自身の時計は壊れて止まっていた。
He ought to go back to the surgery.	もう病院へ戻らなければならない。
He waited, and still she did not come down.	彼は待ちつづけたが、彼女は下りて来なかった。
So he went to the foot of the stairs and called:	彼は階段の上り口まで行って、呼びかけた。
'I shall have to go.'	「僕はもう行かなくちゃならない。」
Almost immediately he heard her coming down.	すると、すぐさま彼女が階段を下りてくる音が聞えた。
She had on her best dress of black voile, and her hair was tidy, but still damp.	彼女は最も見目良い、黒の薄地のドレスを着て、髪はきれいに整えていたが、まだ少し湿っていた。
She looked at him--and in spite of herself, smiled.	彼女は彼を見て──知らず識らず、微笑した。
'I don't like you in those clothes,'	「あなたに着せる服を間違えたわ、」
she said.	と彼女は言った。
'Do I look a sight?'	「変に見えますか？」
he answered.	と彼は応えた。
They were shy of one another.	彼らは互いにはにかんでいた。
'I'll make you some tea,'	「お茶を淹れます、」
she said.	と彼女は言った。
'No, I must go.'	「いや、もう行かなくちゃ。」
'Must you?'	「どうしても？」
And she looked at him again with the wide, strained, doubtful eyes.	彼女は、ふたたび、大きな、張りつめた、疑いの眼で彼を見つめた。
And again, from the pain of his breast, he knew how he loved her.	そしてまたも、彼の胸裡に痛みが疼き、彼は、自分がどれほど彼女を愛しているかを知った。
He went and bent to kiss her, gently, passionately, with his heart's painful kiss.	彼は近寄り、身をかがめ、彼女に、優しく、熱く、心の痛みを触れ先に込めたくちづけをした。
'And my hair smells so horrible,'	「私の髪の毛、ひどく臭うのね、」
she murmured in distraction.	彼女は取り乱してつぶやいた。
'And I'm so awful, I'm so awful!	「ひどいわ、ひどい、
Oh, no, I'm too awful.'	私、ひどすぎる！」
And she broke into bitter, heart-broken sobbing.	突然彼女は、心が破れたように、痛切にすすり泣き始めた。
'You can't want to love me, I'm horrible.'	「こんなにひどい恰好じゃ、あなたに愛されるはずないわ。」
'Don't be silly, don't be silly,'	「そんなこと、そんなことない、」
he said, trying to comfort her, kissing her, holding her in his arms.	と、彼女を落ち着かせようと、彼は彼女に接吻し、腕に抱いた。
'I want you, I want to marry you,	「君が欲しい、君と結婚したい。
we're going to be married, quickly, quickly--to-morrow if I can.'	そう、僕らは結婚するんだ、早く、できるだけ早く、できるなら明日結婚したっていい。」
But she only sobbed terribly, and cried:	しかし彼女の嗚咽は止まず、彼女は叫んだ。
'I feel awful.	「ひどい、
I feel awful.	ひどいわ、
I feel I'm horrible to you.'	私分るわ、あなたが嫌がっているのが。」
'No, I want you, I want you,'	「違う、君が欲しい、君が好きだ、」
was all he answered, blindly, with that terrible intonation which frightened her almost more than her horror lest he should _not_ want her.	と、ひたむきに、盲目的に彼はくり返したが、その切羽詰まった響きは、彼が彼女を愛さなくなるかもしれないという怖れ以上に、彼女を脅かすようだった。
