Discourse on the Method of Rightly Conducting the Reason, and Seeking the Truth in the Sciences	もろもろの学問分野で、正しく理詰めで真理を探究するための方法についての考察
Rene Descartes	ルネ・デカルト 著
PREFATORY NOTE BY THE AUTHOR	著者による序文的な記述
If this Discourse appear too long to be read at once, it may be divided into six Parts:	もしこの論説が、一度に読むには長すぎると思ったら、6 部に分けてもかまわない。
and, in the first, will be found various considerations touching the Sciences;	最初のところには、科学に関わるいろいろな考察が書いてある。
in the second, the principal rules of the Method which the Author has discovered,	二番目のところには、著者の見いだした方法の基本的な原理が書いてある。
in the third, certain of the rules of Morals which he has deduced from this Method;	三番目には、この方法から導かれる道徳規則が書いてある。
in the fourth, the reasonings by which he establishes the existence of God and of the Human Soul,	四番目には、著者が神と人間の魂の存在を証明したときの理由づけが書いてある。
which are the foundations of his Metaphysic;	神と人間の魂は、著者の形而上学の基盤となるものだ。
in the fifth, the order of the Physical questions which he has investigated, and, in particular, the explication of the motion of the heart and of some other difficulties pertaining to Medicine,	五番目の部分には、著者が検討した肉体的な問題各種、特に心臓の動きや医学に関わるその他のさまざまな困難が書いてある。
as also the difference between the soul of man and that of the brutes;	さらには人間の魂と獣の魂とのちがいにもふれた。
and, in the last, what the Author believes to be required in order to greater advancement in the investigation of Nature than has yet been made, with the reasons that have induced him to write.	そして最後の部分には、いままでに行われてきたものよりさらに自然の探求を進歩させるにあたり、著者が必要だと信じていることが書かれ、そして著者が本書を書こうと思った理由も説明されている。
PART 1	第 1 部
Good sense is, of all things among men, the most equally distributed;	分別は、人間のもつあらゆるものの中でも、もっとも平等に分け与えられている。
for every one thinks himself so abundantly provided with it, that those even who are the most difficult to satisfy in everything else, do not usually desire a larger measure of this quality than they already possess.	というのも、だれでもみんな、自分には分別がじゅうぶんに備わっていると思っているし、その他のものについてはなかなか満足しない人だって、分別についてだけは、手持ち以上にほしいなんて願わないのがふつうだからだ。
And in this it is not likely that all are mistaken the conviction is rather to be held as testifying that the power of judging aright and of distinguishing truth from error, which is properly what is called  good sense or reason, is by nature equal in all men;	そしてこれは、正しいものを判断し、真実とまちがいとを識別する能力、つまりいみじくも分別や理性と呼ばれるものが万人に平等だという証拠だと考えるべきなのであって、この点でみんながまちがっているということは、あまりありそうにない。
and that the diversity of our opinions, consequently, does not arise from some being endowed with a larger share of reason than others, but solely from this, that we conduct our thoughts along different ways, and do not fix our attention on the same objects.	われわれの意見が多様なのは、別にもらった理性の分け前が人によって多いから起こるのではなくて、単にみんなの関心の対象がちがっていて、ものの考えかたもまちまちだからなのだ。
For to be possessed of a vigorous mind is not enough;	つまり活発な精神を持つだけでは不十分であって、
the prime requisite is rightly to apply it.	いちばんだいじな要件というのは、その精神を正しく適用することなのだ。
The greatest minds, as they are capable of the highest excellences, are open likewise to the greatest aberrations;	最高の精神は、最高にすぐれた成果を挙げることもできるが、同時にものすごくはずれていってしまうことだって、じゅうぶんに可能だ。
and those who travel very slowly may yet make far greater progress, provided they keep always to the straight road, than those who, while they run, forsake it.	そしてとてもゆっくりと旅する者であっても、必ずまっすぐな道をたどるならば、走りはするがまっすぐな道を捨てる者にくらべて、ずっと遠くまで進むことができるだろう。
For myself, I have never fancied my mind to be in any respect more perfect than those of the generality;	というのもこのわたし自身だって、どんな点でも自分の精神が人並み以上に完璧だなどと思ったことがないのだ。
on the contrary, I have often wished that I were equal to some others in promptitude of thought, or in clearness and distinctness of imagination, or in fullness and readiness of memory.	それどころか、思考のすばやさや、想像力の明晰さや独自性、あるいは記憶力の確かさやそれを思い出す素早さの点で、ほかの人たち並の水準になれたらなあ、と願うこともしょっちゅうだ。
And besides these, I know of no other qualities that contribute to the perfection of the mind;	そしていま挙げたもの以外には、精神の完成に貢献するような資質はわたしには思いつかない。
for as to the reason or sense, inasmuch as it is that alone which constitutes us men, and distinguishes us from the brutes, I am disposed to believe that it is to be found complete in each individual;	というのも、われわれ人間をつくり、獣と区別する唯一のものは理性や判断力なのだけれど、わたしはそれが各個人の中に、それぞれ完璧な形で見つかるものと信じているからだ。
and on this point to adopt the common opinion of philosophers,	そしてこの点で、哲学者たちに共通意見を採用しておこう。
who say that the difference of greater and less holds only among the accidents, and not among the forms or natures of individuals of the same species.	かれらは、優れているとか劣っているとかいうのは、accidentsのみの間に適用されるものであって、同じ種の個体の形態や性質について適用されるものではない、と言っている。
I will not hesitate, however, to avow my belief that it has been my singular good  fortune to have very early in life fallen in with certain tracks	とはいえ人生のごくはやい時期に、いまの方向に進めたのは、きわめて運がよかったことは真っ先に認めよう。
which have conducted me to considerations and maxims, of which I have formed a method that gives me the means, as I think, of gradually augmenting my knowledge, and of raising it by little and little to the highest point	この方向にきたおかげで、いろんな考察や一般原理を検討し、そこから知識をだんだん補って高めていける（と思う）ような手法を編み出せたから。
which the mediocrity of my talents and the brief duration of my life will permit me to reach.	わたしの才能は凡庸だし、人生も短いけれど、この手法を使えばその限界の中で到達できる最高点にまでたどりつけるのだ。
For I have already reaped from it such fruits that,	わたしはそこからすでにとてもたくさんの成果を得ている。
although I have been accustomed to think lowly enough of myself, and although when I look with the eye of a philosopher at the varied courses and pursuits of mankind at large, I find scarcely one which does not appear in vain and useless,	我が身については慎み深くするのが常だけれど、哲学者の目で見てやると、わたしの成果にくらべれば人類全体のいろんな分野や探求は、ほとんどすべてが無内容で役立たずに見えてしまう。
I nevertheless derive the highest satisfaction from the progress I conceive myself to have already made in the search after truth,	だから、わたしは、真理の探究で自分が達成したと思う進歩には満足しきっている。
and cannot help entertaining such expectations of the future as to believe that if, among the occupations of men as men, there is any one really excellent and important, it is that which I have chosen.	将来への期待もついつい高まってしまっていて、人の人としての職業のなかで、どれか本当に優秀で大事なものを一つ選ぶとすれば、それはわたしが選んだこの仕事だと思うほどだ。
After all, it is possible I may be mistaken;	とはいえ、わたしがまちがっていることもあるだろう。
and it is but a little copper and glass, perhaps, that I take for gold and diamonds.	ただの銅やガラスでしかないものを、黄金やダイヤモンドだと思いこんでいるだけかもしれない。
I know how very liable we are to delusion in what relates to ourselves, and also how much the judgments of our friends are to be suspected when given in our favor.	自分にかかわることについて、人がどれほど幻想に陥りやすいかは知っているし、友人の下す判断がこちらに好意的なときには、かなり疑ってかかるべきなのも知っている。
But I shall endeavor in this discourse to describe the paths I have followed,	でも、この著作では、わたしがたどってきた道を記述してみよう。
and to delineate my life as in a picture,	そして絵のようにわたしの一生を描き出してみよう。
in order that each one may also be able to judge of them for himself, and that in the general opinion entertained of them, as gathered from current report, I myself may have a new help towards instruction to be added to those I have been in the habit of employing.	みんなが自分なりの判断を下せるように、そしてこの文章から得られるものに対してもたれるいろいろな意見から、このわたしも自分がこれまで採用してきたやり方に対し、何か追加すべき方法を加えるための、新たな手助けが得られるように。
My present design, then, is not to teach the method which each ought to follow for the right conduct of his reason,	というわけで、いまのこの著作の構想というのは、理性を正しく執行するために各人がたどるべき手法を教えることではない。
but solely to describe the way in which I have endeavored to conduct my own.	わたし自身がそれを執行するときに使っている方法を記述することだ。
They who set themselves to give precepts must of course regard themselves as possessed of greater skill than those to whom they prescribe;	もちろん処方を与えようとする者は、それを受け取る側より高い能力を持っているつもりのはずだ。
and if they err in the slightest particular, they subject themselves to censure.	そして個別の点でちょっとでもまちがえたら、非難を浴びることになる。
But as this tract is put forth merely as a history, or, if you will, as a tale, in which, amid some examples worthy of imitation, there will be found, perhaps, as many more which it were advisable not to follow,	でも、この文章での記述はただの歴史というか、お望みならお話として書かれている、だからまねする価値のある例のなかに、まねしないほうがいい例も見つかるかもしれない。
I hope it will prove useful to some without being hurtful to any, and that my openness will find some favor with all.	だけれど、これが一部の人には役にたって、だれも傷つけることなく、そしてこの率直さが、みんなに多少は満足してもらえるといいな、と思う。
From my childhood, I have been familiar with letters;	子供の頃から、わたしは文献に慣れ親しんできた。
and as I was given to believe that by their help a clear and certain knowledge of all that is useful in life might be acquired, I was ardently desirous of instruction.	そして、文献の助けを借りれば、人生で訳にたつことすべてについて、はっきりした確実な知識が得られると思いこまされてきたので、教育を熱心に求めたものだ。
But as soon as I had finished the entire course of study, at the close of which it is customary to be admitted into the order of the learned, I completely changed my opinion.	でも、講義のすべてを終えたとたん、教養ある人物の地位に普通は認められるはずのものが終わったとたん、わたしはがらっと意見を変えた。
For I found myself involved in so many doubts and errors,	というのも、気がついてみると、自分があまりにたくさんの疑いやまちがいに囲まれていたからだ。
that I was convinced I had advanced no farther in all my attempts at learning, than the discovery at every turn of my own ignorance.	おかげで、自分の無知を悟るたびに行う発見以外の点では、自分はまったく何一つ学習という点で前進していないのだと確信するようになってしまった。
And yet I was studying in one of the most celebrated schools in Europe, in which I thought there must be learned men,  if such were anywhere to be found.	それでも、わたしが学んでいたのはヨーロッパでも最高とうたわれる学校で、教養ある人がいるなら、ここしかないと思えたところだ。
I had been taught all that others learned there;	わたしは、他のみんなが教わったことをすべて学んだ。
and not contented with the sciences actually taught us, I had, in addition, read all the books that had fallen into my hands, treating of such branches as are esteemed the most curious and rare.	さらに、教わった学問に満足できなかったので、手元にきた本はすべて読み尽くしたし、えらく風変わりで珍しいと思われている分野も相手にしてみた。
I knew the judgment which others had formed of me;	ほかの人たちが、わたしのことをどう判断しているかも知っていたし、
and I did not find that I was considered inferior to my fellows,	自分が同期にくらべて劣っているとは思われていないのも知っていた。
although there were among them some who were already marked out to fill the places of our instructors.	もっとも、中にはすでに教師たちの任にとってかわるべく選出された者もいたけれど。
And, in fine, our age appeared to me as flourishing, and as fertile in powerful minds as any preceding one.	そしてわれわれの時代は、それに先立つどの時代とくらべても、強力な精神を輩出するという点で、全体としてまったく劣るものではないように思えた。
I was thus led to take the liberty of judging of all other men by myself, and of concluding that there was no science in existence that was of such a nature as I had previously been given to believe.	というわけで、わたしはほかのあらゆる人物を、勝手ながら自分一人で判断させてもらった結果として、わたしがそもそも信じさせられたような性質を持った学問というのは、実はまるっきり存在していないのだと結論するしかなかった。
I still continued, however, to hold in esteem the studies of the schools.	それでも、学校での学問への敬意をなくしたわけではない。
I was aware that the languages taught in them are necessary to the understanding of the writings of the ancients;	そこで教えられる言語は、古人の書いた著作を理解するのに必要だというのはわかる。
that the grace of fable stirs the mind;	寓話の優雅さは心ときめくものだ。
that the memorable deeds of history elevate it;	歴史上の印象的なできごとは精神を高めてくれるし、
and, if read with discretion, aid in forming the judgment;	注意して読めば、判断力の形成にも役立つ。
that the perusal of all excellent books is,  as it were, to interview with the noblest men of past ages, who have written them, and even a studied interview, in which are discovered to us only their choicest thoughts;	すぐれた本を読み込むのは、それを書いた過去の最高の偉人たちの話をきくようなもので、しかもただの話ではなく、その人たちのえり抜きの思考だけを伝えてくれる。
that eloquence has incomparable force and beauty;	雄弁は比類なき力と美しさを持っている。
that poesy has its ravishing graces and delights;	詩は、すばらしい優雅さとよろこびをもたらす。
that in the mathematics there are many refined discoveries eminently suited to gratify the inquisitive, as well as further all the arts an lessen the labour of man;	数学には、探求心の旺盛な者を満足させるにじゅうぶん足るだけの洗練された発見がたくさんあって、しかもそれは人のあらゆる技芸を進歩させ、人々の労働を減らせるものだ。
that numerous highly useful precepts and exhortations to virtue are contained in treatises on morals;	道徳律には、美徳について無数のとても役に立つ知見や訓戒が含まれている。
that theology points out the path to heaven;	神学は天国への道を指し示す。
that philosophy affords the means of discoursing with an appearance of truth on all matters, and commands the admiration of the more simple;	哲学は、あらゆる事柄について、真実ぶった対話を可能にしてくれて、単純な人々の崇拝を獲得できる。
that jurisprudence, medicine, and the other sciences, secure for their cultivators honors and riches;	法学や医学などの科学は、それを探求する者たちに名誉と富を確保してくれる。
and, in fine, that it is useful to bestow some attention upon all,	そして結局は、このすべてに少しは関心をはらっておくといいだろう。
even upon those abounding the most in superstition and error, that we may be in a position to determine their real value, and guard against being deceived.	なかにはえらく迷信やあやまりばかりの分野もあるけれど、でもそういうのを見ておけば、その真価も見定められるし、だまされないようにすることもできるわけだ。
But I believed that I had already given sufficient time to languages, and likewise to the reading of the writings of the ancients, to their histories and fables.	でも、もう言語にはじゅうぶん時間を割いたし、古人の著作や歴史、寓話も、やるだけやった気がした。
For to hold converse with those of other ages and to travel, are almost the same thing.	というのも、ほかの時代の人たちと対話するのは、旅行するのとほとんど同じことだからだ。
It is useful to know something of the manners of different nations,	ほかの国の習慣をある程度知るのは、役にたつ。
that we may be enabled  to form a more correct judgment regarding our own, and be prevented from thinking that everything contrary to our customs is ridiculous and irrational,	自分自身の国についてもっと正しい判断ができるようになるし、自分たちの習俗に反するものはすべて変てこで不合理だ、などという考えちがいをしないですむようになるからだ。
a conclusion usually come to by those whose experience has been limited to their own country.	こういう考えちがいは、経験が自国内に限られている者からくることが多い。
On the other hand, when too much time is occupied in traveling, we become strangers to our native country;	でも一方で、旅行ばかりに時間を費やしていると、自分の国で異人となってしまう。
and the over curious in the customs of the past are generally ignorant of those of the present.	それに、過去の習俗ばかり気にしている人たちというのは、だいたいはいまの習俗には無知だったりする。
Besides, fictitious narratives lead us to imagine the possibility of many events that are impossible;	さらに、創作著述は、不可能なことを可能だと思わせてしまう。
and even the most faithful histories, if they do not wholly misrepresent matters, or exaggerate their importance to render the account of them more worthy of perusal, omit, at least, almost always the meanest and least striking of the attendant circumstances;	そして、どんなに忠実な歴史でも、できごとを完全にねじまげたり、とりあげる価値を高めるためにその重要性を誇張してみたりすることだってあるし、そうでなくてもその場の状況でいちばん都合が悪かったり、あまり印象の強くなかったりするものは黙殺してしまう。
hence it happens that the remainder does not represent the truth, and that such as regulate their conduct by examples drawn from this source, are apt to fall into the extravagances of the knight-errants of romance, and to entertain projects that exceed their powers.	だから、そういう源から導かれた前例をもとに、自分の行動を律する人たちというのは騎士道物語のロマンスの派手派手しさに陥って、自分の力にあまるプロジェクトに手をだしたりするようになる。
I esteemed eloquence highly, and was in raptures with poesy;	雄弁は高く評価していたし、詩学にも夢中になった。
but I thought that both were gifts of nature rather than fruits of study.	でも、どっちも学習の成果というよりは才能の問題だと思う。
Those in whom the faculty of reason is predominant, and who most skillfully dispose their thoughts with a view to render them clear and intelligible, are always the best able to persuade others of the truth of what they lay down, though they should speak only in the language of Lower Brittany, and be wholly ignorant of the rules of rhetoric;	同僚のなかで、とっても高い理性を持っていて、自分の考えを、はっきりわかりやすい形で、上手に表現していた人たちは、自分たちの主張の正しさで他人を説得するのが上手だったけれど、かれらはlower Brittanyのことばでしか話せず、レトリックの規則にはまったく無知だった。
and those whose minds are stored with the most agreeable fancies, and who can give expression to them with the greatest embellishment and harmony, are still the best poets, though unacquainted with the art of poetry.	そして頭が心地よい空想でいっぱいで、それを見事な飾りと調和でもって表現できる人たちは、詩学のことなど何も知らなくても、やはり最高の詩人たちなのだ。
I was especially delighted with the mathematics,	数学にはなかでも夢中になった。
on account of the certitude and evidence of their reasonings;	その論理展開の確実さと実証性という点で。
but I had not as yet a precise knowledge of their true use;	でもそのころは、その真の使い方についてはっきりとは知らなかった。
and thinking that they but contributed to the advancement of the mechanical arts, I was astonished that foundations, so strong and solid, should have had no loftier superstructure reared on them.	そしてそれが、機械工学の進歩にだけ貢献すると思っていたので、これだけ強固でがっちりした基礎の上に、もっと壮大な建造物がつくられていないのには驚いた。
On the other hand, I compared the disquisitions of the ancient moralists to very towering and magnificent palaces with no better foundation than sand and mud:	その一方で、古代の道徳家たちの考察を見てみると、これは砂と泥まがいのいい加減な基礎の上に建った、そびえ立つ壮大な宮殿みたいなものだ。
they laud the virtues very highly, and exhibit them as estimable far above anything on earth;	この人たちは、美徳というのをとても賞賛して、地上のなによりもそれが気高いものだと書きたてる。
but they give us no adequate criterion of virtue, and frequently that which they designate with so fine a name is but apathy, or pride, or despair, or parricide.	でもその美徳についてのまともな評価尺度は与えてくれないし、えらく立派な名前をつけているものを見ると、ただの無気力や高慢や絶望や親殺しだったりすることがしょっちゅうある。
I revered our theology, and aspired as much as any one to reach heaven:	神学は崇拝したし、天に到達しようとしてほかのみんなと同じように努力はしてみた。
but being given assuredly to understand that the way is not less open to the most ignorant than to the most learned, and that the revealed truths which lead to heaven are above our comprehension, I did not presume to subject them to the impotency of my reason;	が、その道は、最高に教養ある者にも、まったく無知なる者にも等しく開かれていることを確実に理解するに至り、さらには天国にいたるものとして明かされた真実が、われわれの理解を越えていることがよくわかったので、それをわたしの無力な理性の対象にしようなどという気は起きなかった。
and I thought that in order competently to undertake their examination, there was need of some special help from heaven,	そういうのをちゃんと検討するには、天国からの特別な助けが必要なのだと思う。
and of being more than man.	そして、人間以上のものにならなくてはならないのだろう。
Of philosophy I will say nothing,	哲学については何も言わないでおこう。
except that when I saw that it had been cultivated for many ages by the most distinguished men, and that yet there is not a single matter within its sphere which is not still in dispute, and nothing, therefore, which is above doubt, I did not presume to anticipate that my success would be greater in it than that of others;	ただし、幾世紀にもわたって、非凡な人々によって探求されてきたというのに、いまだにその領域で議論に片が付いたものは何一つないし、だから疑問の余地のないものも何一つないというのを見ると、自分がやってもほかの人より成功する見込みがあるとは思えなかった。
and further, when I considered the number of conflicting opinions touching a single matter that may be upheld by learned men, while there can be but one true, I reckoned as well-nigh false all that was only probable.	そしてさらに、教養ある人たちが掲げるたった一つのことについて、真実は一つしかないはずなのに、矛盾する意見が山ほどあることを考えると、まあそういう意見はどれも実は正しくなんかなくて、「そういうこともあるかもしれない」程度のものでしかないんだな、と思ったわけだ。
As to the other sciences, inasmuch as these borrow their principles from philosophy, I judged that no solid superstructures could be reared on foundations so infirm;	それ以外の科学となると、みんな原理を哲学から拝借しているということから見ても、そんな貧相な基礎のうえにまともな建物が建てられるわけがないと判断した。
and neither the honor nor the gain held out by them was sufficient to determine me to their cultivation:	そしてそうした分野が掲げる名誉も富も、その道の探求を決意させるほどのものではないと思った。
for I was not, thank Heaven, in a condition which compelled me to make merchandise of science for the bettering of my fortune;	というのもありがたいことに、わたしは科学を商売にしてお金を儲けたりしなくてはならない立場ではなかったから。
and though I might not profess to scorn glory as a cynic, I yet made very slight account of that honor which I hoped to acquire only through fictitious titles.	そして名誉も、皮相的なものだなんて言わないにしても、空疎な肩書きだけから得られるような名誉なんか、大したものとは思わなかった。
And, in fine, of false sciences I thought I knew the worth sufficiently to escape being deceived by the professions of an alchemist, the predictions of an astrologer, the impostures of a magician, or by the artifices and boasting of any of those who profess to know things of which they are ignorant.	そしてインチキ科学については、じゅうぶんに値打ちがわかっていたので、錬金術師の仕事や占星術師の預言、魔術師のおどしや、知りもしないことについてきいたふうな口をきく連中の大風呂敷にだまされるようなこともなかった。
For these reasons, as soon as my age permitted me to pass from under the control of my instructors, I entirely abandoned the study of letters, and resolved no longer to seek any other science than the knowledge of myself, or of the great book of the world.	こうした理由のため、年齢があがって教師たちの配下から抜け出せるようになるがはやいか、わたしは完全に文献の学習をやめて、自分自身の知識以外や、世界という偉大な本の知識以外を求めるのはやめようと決意した。
I spent the remainder of my youth in traveling, in visiting courts and armies, in holding intercourse with men of different dispositions and ranks, in collecting varied experience,	その後の若い時期は旅行に専念し、宮廷や軍を訪ねて、いろいろな立場や地位の人たちとつきあって、さまざまな経験を集めた。
in proving myself in the different situations into which fortune threw me, and, above all, in making such reflection on the matter of my experience as to secure my improvement.	そして、運命がなげかけてくるいろいろな状況において自分の力を証明し、そして何よりも、自分の体験について考えてみることで、自分を確実に改善しようとした。
For it occurred to me that I should find much more truth in the reasonings of each individual with reference to the affairs in which he is personally interested, and the issue of which must presently punish him if he has judged amiss, than in those conducted by a man of letters in his study, regarding speculative matters that are of no practical moment, and followed by no consequences to himself, farther, perhaps, than that they foster his vanity the better the more remote they are from common sense;	というのも、現実的な力を持たず、その人自身には何の利害ももたらさない（ただし、常識ばなれしていればしているほど、虚栄心を満たす役にはたつのかもしれないけれど）、純粋に頭の中だけの事柄について、学者たちの理由づけよりは、それぞれの人が個人的に利害関心を持っていることがらや、まちがった判断を下したらすぐに罰を受けるようなことがらについて行う理由づけのほうが、ずっと多くの真理を含んでいるだろうからだ。
requiring, as they must in this case, the exercise of greater ingenuity and art to render them probable.	そういう現実の利害ある状況での理由づけのほうが、それをなるべく確実なものとするような慎重さと技を行使することが必要となる。
In addition, I had always a most earnest desire to know how to distinguish the true from the false, in order that I might be able clearly to discriminate the right path in life, and proceed in it with confidence.	さらに、わたしはいつも真実を虚偽から区別する方法を知りたいと心から思ってきたのだけれど、それは人生の正しい道をはっきりと見分けて、安心してその道を進めるようになりたいと思ったからでもある。
It is true that, while busied only in considering the manners of other men, I found here, too, scarce any ground for settled conviction, and remarked hardly less contradiction among them than in the opinions of the philosophers.	確かに、ほかの人々のふるまいを考えることにばかり専念していると、ここにもはっきりとしたconvictionの基盤はほとんどなかったし、人々の見解も矛盾するものだらけで、哲学者たちの見解の矛盾ぶりと大してかわりはなかった。
So that the greatest advantage I derived from the study consisted in this,	だからこうして行った調査の最大の成果といえばこういうことだ：
that, observing many things which, however extravagant and ridiculous to our apprehension, are yet by common consent received and approved by other great nations, I learned to entertain too decided a belief in regard to nothing of the truth of which I had been persuaded merely by example and custom;	われわれから見ればとんでもなくキテレツに見えるようなことでも、ほかの大国では常識的に受け取られて認められていることはたくさんあって、だから単に事例や習慣だからというだけでは、なにごとも真実だと思いこまないようにしようという決意を持てたのだ。
and thus I gradually extricated myself from many errors powerful enough to darken our natural intelligence, and incapacitate us in great measure from listening to reason.	こうしてわたしは、われわれの天性の知力を覆い隠し、理性にほとんど耳を傾けられなくしてしまうほど強力な多数のまちがいから、だんだん自由となっていった。
But after I had been occupied several years in thus studying the book of the world, and in essaying to gather some experience, I at length resolved to make myself an object of study, and to employ all the powers of my mind in choosing the paths I ought to follow,	でも何年かにわたって世界の本を勉強するのに専念し、そして経験を集めようと努める中で、わたしはいっしょうけんめい自分自身を観察対象にしようと決意して、自分のたどるべき道を選ぶために意識の全力を傾けようと決意した。
an undertaking which was accompanied with greater success than it would have been had I never quitted my country or my books.	これは、自分の祖国や本を捨てなかった場合にくらべて、はるかに大きな成功をもたらしてくれたのだった。
PART II	第 2 部
I was then in Germany,	そのころわたしはドイツにいた。
attracted thither by the wars in that country, which have not yet been brought to a termination;	まだ当時はドイツ国内の戦争が終わっておらず、それに惹かれたのだ。
and as I was returning to the army from the coronation of the emperor, the setting in of winter arrested me in a locality where, as I found no society to interest me, and was besides fortunately undisturbed by any cares or passions, I remained the whole day in seclusion, with full opportunity to occupy my attention with my own thoughts.	そして皇帝の戴冠から軍隊に戻ろうとしているところで、冬がやってきてある地域にとどまることになってしまったのだけれど、そこには興味を覚えるような集団もなく、また心配や劣情などにも運良くじゃまされることがなかったので、丸一日を他人と接触なしにすごせ、自分自身の思考にだけ関心を向けるまたとない機会が得られた。
Of these one of the very first that occurred to me was, that there is seldom so much perfection in works composed of many separate parts, upon which different hands had been employed, as in those completed by a single master.	そういう思考の中でまっさきに思い浮かんだのは、一人の工匠の手によって完成したものにくらべて、いろいろな手が加わった、さまざまな異なる部分からできた作品は、完成度が低いのが常だということだった。
Thus it is observable that the buildings which a single architect has planned and executed, are generally more elegant and commodious than those which several have attempted to improve, by making old walls serve for purposes for which they were not originally built.	つまり一人の建築家が計画して施工した建物のほうが、数人が改善しようとして古い壁を最初の意図とはちがった用途に使ったりしているような建物にくらべ、優雅さでも便利さでも勝っていることが多いのだ。
Thus also, those ancient cities which, from being at first only villages, have become, in course of time, large towns, are usually but ill laid out compared with the regularity constructed towns which a professional architect has freely planned on an open plain;	そしてまた、最初はほんの小さな村だったのが、時間がたつにつれて大きな町になった古い都市というのは、プロの建築家が平原に自由に計画した、規則正しく作られた町にくらべて、レイアウトがまずいのがふつうだ。
so that although the several buildings of the former may often equal or surpass in beauty those of the latter,	古い都市の建物のいくつかは、新しい都市のものに匹敵するかそれ以上の美しさを持っていることもある。
yet when one observes their indiscriminate juxtaposition, there a large one and here a small, and the consequent crookedness and irregularity of the streets, one is disposed to allege that chance rather than any human will guided by reason must have led to such an arrangement.	でも、それがいい加減に並べられて、こっちは大きくあっちは小さくという具合で、それに伴って通りも曲がったり不規則になったりしているのを見ると、こういう配置をもたらしたのは、理性に導かれた人間ではなく、偶然にちがいないと宣言するしかない。
And if we consider that nevertheless there have been at all times certain officers whose duty it was to see that private buildings contributed to public ornament, the difficulty of reaching high perfection with but the materials of others to operate on, will be readily acknowledged.	そしてそうはいっても、いつの時代にも、個々の建物が公共の美観に貢献するよう監督するのが仕事のお役人がいたことを考えると、他人の材料だけを使って高い完成度に到達するむずかしさはよくわかるだろう。
In the same way I fancied that those nations which, starting from a semi-barbarous state and advancing to civilization by slow degrees, have had their laws successively determined, and, as it were, forced upon them simply by experience of the hurtfulness of particular crimes and disputes,	同じように、半ば野蛮な国からだんだんと文明国へ進歩してきた国は、法律もだんだんに定められてきて、そのために個別の犯罪や紛争の痛みの経験からその法律が強制されるようになってきている。
would by this process come to be possessed of less perfect institutions than those which, from the commencement of their associationas communities, have followed the appointments of some wise legislator.	そういう国では、コミュニティとして発足したときから、賢い法律制定者の判断に強いたがっていたような国に比べて体制としての完成度は低いにちがいない。
It is thus quite certain that the constitution of the true religion, the ordinances of which are derived from God, must be incomparably superior to that of every other.	したがって真なる宗教のconstitution、つまり神さまから下された戒律は、その他あらゆるものとは比較にならないほど優れているはずだ。
And, to speak of human affairs, I believe that the pre-eminence of Sparta was due not to the goodness of each of its laws in particular, for many of these were very strange, and even opposed to good morals, but to the circumstance that, originated by a single individual, they all tended to a single end.	そして人間のことを語るにしても、スパルタがあれほど反映したのは個々の法が特によかったわけではなく（というのも、その多くはかなり変てこで、道徳的に反するようなものすらある）、それがすべて一人の個人によって起草されたために、同じ一つの目標に向かっていたということからくるのだと考える。
In the same way I thought that the sciences contained in books (such of them at least as are made up of probable reasonings, without demonstrations), composed as they are of the opinions of many different individuals massed together,	同じように、本に書いてある学問（少なくとも、実例に基づかずに、可能性としてありそうな理由づけだけに頼っているものも）は、いろいろ異なる人たちの意見の寄せ集めになっている。
are farther removed from truth than the simple inferences which a man of good sense using his natural and unprejudiced judgment draws respecting the matters of his experience.	だからまともな感覚の持ち主が、自然で偏見のない判断力を使い、経験を尊重しつつ導き出す簡単な洞察に比べれば、真実から遠ざかっていると思った。
And because we have all to pass through a state of infancy to manhood, and have been of necessity, for a length of time, governed by our desires and preceptors (whose dictates were frequently conflicting, while neither perhaps always counseled us for the best),	そしてわれわれみんな、子供時代から大人へと移行しなければならず、そしてかなり長いこと自分たちの欲望や教師たち（かれらの伝えることは、しょっちゅう矛盾していて、しかもわれわれに最良のものを伝えるようにはなっていなかった）の監督下にあったわけだ。
I farther concluded that it is almost impossible that our judgments can be so correct or solid as they would have been, had our reason been mature from the moment of our birth, and had we always been guided by it alone.	もしわれわれの理性が生まれたときから成熟していて、ずっとそれだけに導かれていた場合に比べて、そういう影響にさらされてきたわれわれの判断力は、正しくもなければ確固たるものでもなかろう。
It is true, however, that it is not customary to pull down all the houses of a town with the single design of rebuilding them differently, and thereby rendering the streets more handsome;	しかしながら実際問題として、単に改築して街路をきれいに引き直したいというだけで街の建物を全部取り壊すようなことはしないのがふつうだ。
but it often happens that a private individual takes down his own with the view of erecting it anew, and that people are even sometimes constrained to this when their houses are in danger of falling from age, or when the foundations are insecure.	確かに、ときどき個人が、自分の家を新築しようとして古い家を取り壊したりすることはあるし、建物が古くなってきたり、基礎にガタが出てきたりして、取り壊さざるを得ないことだってあるけれど。
With this before me by way of example, I was persuaded that it would indeed be preposterous for a private individual to think of reforming a state by fundamentally changing it throughout, and overturning it in order to set it up amended;	こういうのを例として考えると、たかが一個人が国家を根本的に変えてしまって改革しようとしたり、それを修正しようとしてひっくり返してしまうというのは、とても傲慢不遜だな、と確信した。
and the same I thought was true of any similar project for reforming the body of the sciences,	そして同じことが、科学の総体を改革しようという試みについても言えるだろうと思った。
or the order of teaching them established in the schools:	あるいは、学校で確立された教育の秩序をひっくり返すような試みについても。
but as for the opinions which up to that time I had embraced, I thought that I could not do better than resolve at once to sweep them wholly away, that I might afterwards be in a position to admit either others more correct, or even perhaps the same when they had undergone the scrutiny of reason.	でもわたしがその時点までに抱くようになった考え方についていえば、わたしはそれを一気に捨て去ってしまって、後になってやっぱりもとのほうがよかったとか、あるいはきちんと理性の検討を経て、やはりあれは正しかったと認められるような立場に身を置くのがいちばんいいだろうと思った。
I firmly believed that in this way I should much better succeed in the conduct of my life, than if I built only upon old foundations, and leaned upon principles which, in my youth, I had taken upon trust.	若い頃に学んで信用していた原理原則に基づいて、古い基礎の上に積み上げていくより、こういうやりかたをしたほうが、人生を統御するにあたってもずっと成功しやすいだろうとわたしは確信していた。
For although I recognized various difficulties in this undertaking, these were not, however, without remedy, nor once to be compared with such as attend the slightest reformation in public affairs.	というのも、確かにこのやり方にはいろいろとむずかしいところがあるのは気がついたけれど、別にそれはどうしようもない問題ではないし、公共的な政治がらみの改革にちょっとでも結びつくと思われることもあり得ないからだ。
Large bodies, if once overthrown, are with great difficulty set up again,	大きな物体をひっくり返したら、それを立ち上げ直すのはとてもむずかしい。
or even kept erect when once seriously shaken, and the fall of such is always disastrous.	あるいは一度でも激しく揺らいでしまったら、立たせておくのはむずかしくなるし、そういうものが倒れるといつも大惨事になる。
Then if there are any imperfections in the constitutions of states (and that many such exist the diversity of constitutions is alone sufficient to assure us), custom has without doubt materially smoothed their inconveniences, and has even managed to steer altogether clear of, or insensibly corrected a number which sagacity could not have provided against with equal effect;	それならば、国の基盤に不完全な部分があるなら（そしてそういう部分がたくさんあることは、その基盤の多様性だけを見ても充分に納得がいくだろう）、慣習がまちがいなく、その欠陥をはっきりと補うようになっているだろうし、賢明さだけではきちんと対応しきれない部分についても、完全に回避するか、あるいは知らず知らずのうちに矯正を加えているはずだ。
and, in fine, the defects are almost always more tolerable than the change necessary for their removal;	だから結果として、欠陥はいつも、それを取り除くために必要な変化よりはずっと耐えやすいものとなっている。
in the same manner that highways which wind among mountains, by being much frequented, become gradually so smooth and commodious, that it is much better to follow them than to seek a straighter path by climbing over the tops of rocks and descending to the bottoms of precipices.	これは、山中をくねくねと通っている街道が、何度も通行されるためにずっとなめらかで平坦になっていて、だからもっとまっすぐな通路を求めて岩のてっぺんにのぼったり、谷底まで下りていったりするよりも、その街道にしたがうほうがずっといいのと同じことだ。
Hence it is that I cannot in any degree approve of those restless and busy meddlers who, called neither by birth nor fortune to take part in the management of public affairs, are yet always projecting reforms;	そういうわけで、政治的な事柄の管理に関わるよう生まれついたわけでもなければ、運命でそういう立場になったわけでもないのに、改革ばかりを主張しているような、落ち着かなくてせわしない出しゃばりどもたちには、ちっとも賛成できないのだ。
and if I thought that this tract contained aught which might justify the suspicion that I was a victim of such folly, I would by no means permit its publication.	そして、わたしのこのやりかたが、この自分自身もそうした愚行の犠牲者になっているのではないかという疑念を少しでも含んでいたら、この文書の刊行を許しはしなかっただろう。
I have never contemplated anything higher than the reformation of my own opinions, and basing them on a foundation wholly my own.	わたしは、自分自身の見解を改革し、それを完全に独自の基盤の上に築くという以上のことを企んだことはないのだ。
And although my own satisfaction with my work has led me to present here a draft of it, I do not by any means therefore recommend to every one else to make a similar attempt.	そして自分では自分の成果に満足しているので、それについての概要をこうして提示はしているけれど、別に他のみんなに同じようなことをしろと薦めているわけでもない。
Those whom God has endowed with a larger measure of genius will entertain, perhaps, designs still more exalted;	神がもっと大きな才能を与えたもうた人物であれば、もっとすばらしい方策を操れるのかもしれない。
but for the many I am much afraid lest even the present undertaking be more than they can safely venture to imitate.	しかしながら、多くの者にとっては、ここに書いたようなことを実践するのでさえ、気軽に真似するには荷が重いだろうと心底危惧しているのだ。
The single design to strip one's self of all past beliefs is one that ought not to be taken by every one.	過去の信念すべてを捨て去ってしまうというやり方は、だれでもやっていいというものではない。
The majority of men is composed of two classes, for neither of which would this be at all a befitting resolution:	人類の大半は、二種類に分かれるけれど、そのいずれにとっても、これはふさわしい手口とはいえない。
in the first place, of those who with more than a due confidence in their own powers, are precipitate in their judgments and want the patience requisite for orderly and circumspect thinking;	一種類目は、自分自身の力量について、しかるべき以上に自信を抱いている人たちであり、この人たちは判断がせっかちで、秩序だった周到な思考に必要な落ち着きが足りない。
whence it happens, that if men of this class once take the liberty to doubt of their accustomed opinions, and quit the beaten highway, they will never be able to thread the byway that would lead them by a shorter course, and will lose themselves and continue to wander for life;	この種の人たちが、自分の慣れ親しんだ意見に疑念を抱けるようになってしまい、いままでの道をやめてしまったとしても、もっと短い道筋となるような脇道をきちんとたどることができずに、迷子になって、一生さまよい続けることになってしまう。
in the second place, of those who, possessed of sufficient sense or modesty to determine that there are others who excel them in the power of discriminating between truth and error,	二種類目の人は、真実と誤りを見分ける力量が自分より高く、教えを請うべき人々が存在することを認めるだけの理性と慎みを持ち合わせている。
and by whom they may be instructed, ought rather to content themselves with the opinions of such than trust for more correct to their own reason.	この人たちは、そういう力量の高い人々の意見に従っているべきで、自分の理性のほうがもっと正しいなどと信用するべきではない。
For my own part, I should doubtless have belonged to the latter class,	自分自身のことを言えば、わたしはまちがいなく後者に属する人間だっただろう。
had I received instruction from but one master, or had I never known the diversities of opinion that from time immemorial have prevailed among men of the greatest learning.	でもそれは、もし教えをたった一人の師から受けていたり、有史以来の最高の賢者たちの間に広まった各種見解の多様性を知らなければの話だ。
But I had become aware, even so early as during my college life, that no opinion, however absurd and incredible, can be imagined, which has not been maintained by some on of the philosophers;	わたしは大学時代というごく早い時期からすでに、どんなにばかげた奇々怪々な見解であっても、どこかの哲学者が掲げなかったようなものはないということに気がついていた。
and afterwards in the course of my travels I remarked that all those whose opinions are decidedly repugnant to ours are not in that account barbarians and savages,	そしてその後、旅行して気がついたことだが、われわれにとって明らかに不愉快な見解を持つ人々であっても、それだけで野蛮人だということにはならない。
but on the contrary that many of these nations make an equally good, if not better, use of their reason than we do.	それどころか、こうした国民の多くは、われわれ以上とはいわないまでも、同程度にはきちんと理性を使っているのだ。
I took into account also the very different character which a person brought up from infancy in France or Germany exhibits, from that which, with the same mind originally, this individual would have possessed had he lived always among the Chinese or with savages, and the circumstance that in dress itself the fashion which pleased us ten years ago, and which may again, perhaps, be received into favor before ten years have gone, appears to us at this moment extravagant and ridiculous.	さらに、フランスやドイツでそれぞれ幼少期を過ごした人物を考えてみよう。
I was thus led to infer that the ground of our opinions is far more custom and example than any certain knowledge.	こうしてわたしは、われわれの見解のベースというのは、ある特定の英知に基づくのではなく、慣習や事例に根ざした部分のほうがずっと大きいと考えるしかなかった。
And, finally, although such be the ground of our opinions, I remarked that a plurality of suffrages is no guarantee of truth where it is at all of difficult discovery,	そして結論として、そういう英知がわれわれの見解のベースになっているとしても、むずかしい発見の場合には、多数決をとってみたところで、それが正しさの保証とはならないのだと気がついた。
as in such cases it is much more likely that it will be found by one than by many.	むずかしい発見というものは、みんなが見つけるものではなく、たった一人の人物が発見する可能性のほうがずっと高いからだ。
I could, however, select from the crowd no one whose opinions seemed worthy of preference,	しかしながらわたしは、群衆の中からその見識を評価すべき人物を一人として選ぶことができなかった。
and thus I found myself constrained, as it were, to use my own reason in the conduct of my life.	そこで、いまのように、自分の人生を仕切るにあたって、自分自身の理性を使うよりほかに手がなかったのである。
But like one walking alone and in the dark, I resolved to proceed so slowly and with such circumspection,	でも暗闇の中を一人であるく人物のように、わたしはゆっくりと、慎重に調べながら進もうと決意した。
that if I did not advance far, I would at least guard against falling.	だから、遠くまでは行けないにしても、少なくとも穴に落ちたりはせずにすむだろう。
I did not even choose to dismiss summarily any of the opinions that had crept into my belief without having been introduced by reason,	理性に導入されることなく、信念の中に入り込んできた各種の見解についても、すぐに捨て去ったりはしなかった。
but first of all took sufficient time carefully to satisfy myself of the general nature of the task I was setting myself, and ascertain the true method by which to arrive at the knowledge of whatever lay within the compass of my powers.	まずはたっぷり時間をかけて、自分がやろうとしている作業の全般的な性質について自分を満足させて、自分の力量の範囲内にある知識に到達するための真の方法について、みきわめようとしたのだった。
Among the branches of philosophy, I had, at an earlier period, given some attention to logic,	哲学のいろんな分野のなかで、それ以前にちょっと論理学をかじったことはあった。
and among those of the mathematics to geometrical analysis and algebra,	それに数学のいろんな分野の中では、幾何学分析と代数をかじっていた
-- three arts or sciences which ought, as I conceived, to contribute something to my design.	――これらは、わたしの構想（design）になにかしら役にたつと思えた学芸や科学の三分野だ。
But, on examination, I found that, as for logic, its syllogisms and the majority of its other precepts are of avail	でもよく調べてみると、論理学の場合には、三段論法をはじめとするいろんな成果は、未知のものを探求するのにはあまり役にたたないのだ。
- rather in the communication of what we already know, or even as the art of Lully, in speaking without judgment of things of which we are ignorant, than in the investigation of the unknown;	むしろすでに知っていることを他人に伝えたり、あるいはルルスの学芸なんかは、知らないことについて、判断抜きで語るのにむいている。
and although this science contains indeed a number of correct and very excellent precepts, there are, nevertheless, so many others, and these either injurious or superfluous, mingled with the former, that it is almost quite as difficult to effect a severance of the true from the false	だからこの科学は、確かにいろいろと正しくてとても優れた成果を持ってはいるのだけれど、そうでない成果もたくさんあって、そしてこういう有害なあやまったものが、正しくて優れた成果とごっちゃになっていて、真実と虚偽とをきちんと分離するのはとてもむずかしくなっている。
as it is to extract a Diana or a Minerva from a rough block of marble.	荒い大理石のかたまりからダイアナやミネルバ像を抽出するくらいむずかしい。
Then as to the analysis of the ancients and the algebra of the moderns, besides that they embrace only matters highly abstract, and, to appearance, of no use,	そして古人の分析や、現代人の代数はといえば、どちらもとても抽象的な話しかしなくて見るからに何の役にもたたない。
the former is so exclusively restricted to the consideration of figures, that it can exercise the understanding only on condition of greatly fatiguing the imagination;	幾何学は図のことばかりひたすら考えているので、その理解を活用するときにも、想像力がえらくくたびれはてるような状況にしか適用できない。
and, in the latter, there is so complete a subjection to certain rules and formulas, that there results an art full of confusion and obscurity calculated to embarrass, instead of a science fitted to cultivate the mind.	そして後者の代数となると、特定の規則や公式に完全に縛られているので、結果として出てくるのは、精神を豊かにするための科学ではなく、混乱とわけのわからなさだらけで、それがひたすら人に恥をかかせるようにしかできていない。
By these considerations I was induced to seek some other method which would comprise the advantages of the three and be exempt from their defects.	こう思ったので、わたしは、この３つのいいとこどりをして、悪いところは含まないような手法を探すしかなくなったのだ。
And as a multitude of laws often only hampers justice, so that a state is best governed when, with few laws, these are rigidly administered; in like manner, instead of the great number of precepts of which logic is composed,	そして、法律が多すぎるとかえって正義のじゃまになり、だから法律が少ないと、それをきちんと運用することで国がきちんと治められるのと同じように、
I believed that the four following would prove perfectly sufficient for me,	わたしは以下の四つだけで自分にはまったく充分だと考えた。
provided I took the firm and unwavering resolution never in a single instance to fail in observing them.	ただし、自分がどんな場合にも例外なしに以下の四点を守ることをしっかりと誓えば。
The first was never to accept anything for true which I did not clearly know to be such;	第一に、自分がはっきり真だと知っていないことは、何一つ受け入れないこと。
that is to say, carefully to avoid precipitancy and prejudice,	これはつまり、慎重に軽率さと偏見を避けるということだ。
and to comprise nothing more in my judgement than what was presented to my mind so clearly and distinctly as to exclude all ground of doubt.	そして、あらゆる疑問の余地なしにはっきりと明確に、自分の意識に提示されたもの以外はいっさい判断にとりこまないということだ。
The second, to divide each of the difficulties under examination into as many parts as possible, and as might be necessary for its adequate solution.	第二に、検討している問題のそれぞれを、きちんとした解決に必要なだけ、なるべく細かい部分に分割すること。
The third, to conduct my thoughts in such order that, by commencing with objects the simplest and easiest to know,	第三に、いちばん単純で知るのが簡単な対象から手をつけてゆくように、思考を順序だてること。
I might ascend by little and little, and, as it were, step by step, to the knowledge of the more complex;	こうすることで、ちょっとずつ前進して、一歩一歩、もっと複雑な知識に到達できるようになる。
assigning in thought a certain order even to those objects which in their own nature do not stand in a relation of antecedence and sequence.	そして頭の中で、こうした優先順位や序列の中に性格上として位置づかないような対象にも、なんらかの順番を与えてやる。
And the last, in every case to make enumerations so complete, and reviews so general, that I might be assured that nothing was omitted.	そして最後に、すべての場合に番号づけを完全にして、さらに見直しを徹底することで、見落としが何もないと確信できるようにすること。
The long chains of simple and easy reasonings by means of which geometers are accustomed to reach the conclusions of their most difficult demonstrations, had led me to imagine that all things, to the knowledge of which man is competent, are mutually connected in the same way, and that there is nothing so far removed from us as to be beyond our reach, or so hidden that we cannot discover it,	幾何学者たちが、とてもむずかしい証明の結論にたどりつくときに使う、単純で簡単な理由づけの連鎖というやりかたを見て、わたしは人間の知りうるものはすべて、同じように相互に関係しあっていてるのだと考えるようになった。
provided only we abstain from accepting the false for the true, and always preserve in our thoughts the order necessary for the deduction of one truth from another.	そして、まちがったことを真実として受け入れてしまったりしないようにして、ある真実から次の真実を引き出すのに必要な順序というものをきちんと理解しておけば、手の届かないほどの彼方にあったり、あるいは発見できないほど深く隠されたことがらというのは何もない、とも考えるようになった。
And I had little difficulty in determining the objects with which it was necessary to commence,	そして、手をつけるべき対象を決めるのには、ほとんど何の苦労もなかった。
for I was already persuaded that it must be with the simplest and easiest to know,	というのも、それがいちばん簡単で単純にわかるものでなくてはならないと得心していたからだ。
and, considering that of all those who have hitherto sought truth in the sciences, the mathematicians alone have been able to find any demonstrations, that is, any certain and evident reasons, I did not doubt but that such must have been the rule of their investigations.	そして、いろいろな科学でこれまで真理を求めてた人たちのうち、証明（つまり確実で明らかな理性の力）を見つけることができたのは数学者たちだけだったということから考えて、それがかれらの探求の規則であったことも疑問の余地はなかった。
I resolved to commence, therefore, with the examination of the simplest objects, not anticipating,	だからわたしは、いちばん単純な対象の検討から手をつけようと決意した。
however, from this any other advantage than that to be found in accustoming my mind to the love and nourishment of truth, and to a distaste for all such reasonings as were unsound.	けれど、ここから得られるはずのメリットは、自分の精神を真理への愛と育成に捧げて、あぶなっかしい理由づけをすべて退けるという以上のものではなかった。
But I had no intention on that account of attempting to master all the particular sciences commonly denominated mathematics:	そしてこの点で、数学と総称される科学の一分野をすべてマスターしようなどというつもりは、まるでなかった。
but observing that, however different their objects, they all agree in considering only the various relations or proportions subsisting among those objects, I thought it best for my purpose to consider these proportions in the most general form possible,	でも、数学の各分野が扱う対象がどんなにちがっていても、数学はすべて、そうした対象同士の関係や、構成比率だけを考えるという点で共通しているので、こうした構成についていちばん一般的な形で考えてやるのが、自分の目的からもいいだろうと考えたわけだ。
without referring them to any objects in particular, except such as would most facilitate the knowledge of them,	そして個別の対象自体について考えるのは避けるようにした（ただしその対象の理解に役立つ場合は除く）。
and without by any means restricting them to these, that afterwards I might thus be the better able to apply them to every other class of objects to which they are legitimately applicable.	そしてその対象のみに考察を限定しないようにして、あとからそこで得た関係性の知識を、まともに適用できる他の対象のクラスすべてに応用できるようにしようと考えた。
Perceiving further, that in order to understand these relations I should sometimes have to consider them one by one and sometimes only to bear them in mind, or embrace them in the aggregate,	さらに考えてみると、こうした関係性を理解するためには、それを一つずつ考えなくてはならないときもあるし、それをまとめて集合的に考えなくてはならないときもある。
I thought that, in order the better to consider them individually, I should view them as subsisting between straight lines,	そこで、個別に検討するときに便利なように、それが直線の間に位置づけられていると考えたほうがいいな、と思った。
than which I could find no objects more simple, or capable of being more distinctly represented to my imagination and senses;	これ以上に単純な対象は見つからなかったし、自分の想像力や感覚に対してきれいに表現されるものとして、これ以上のものも考えつかなかったからだ。
and on the other hand, that in order to retain them in the memory or embrace an aggregate of many, I should express them by certain characters the briefest possible.	そして一方で、それを記憶の中に保っておいたり、それを多数の集合物としてとらえるために、それの個別対象を表現するにはできるだけ簡単な特性で表現してやろうと思った。
In this way I believed that I could borrow all that was best both in geometrical analysis and in algebra, and correct all the defects of the one by help of the other.	こうすれば、幾何学分析と代数のいちばんいいところを拝借して、片方の欠陥をもう片方の助けを借りて補ってやれるだろうと思った。
And, in point of fact, the accurate observance of these few precepts gave me, I take the liberty of saying, such ease in unraveling all the questions embraced in these two sciences,	そして現実問題として、こういういくつかの方針に厳密に従ったら、この科学の二分野（幾何と代数）に含まれる問題すべてを解決するのが、敢えて言えば実に簡単きわまりないものになってしまった。
that in the two or three months I devoted to their examination, not only did I reach solutions of questions I had formerly deemed exceedingly difficult but even as regards questions of the solution of which I continued ignorant, I was enabled, as it appeared to me, to determine the means whereby, and the extent to which a solution was possible;	その検討に二、三ヶ月を費やしただけで、これまではとんでもなくむずかしいと思っていた問題がどんどん解決できてしまっただけでなく、まだ解決できていない問題についても、解決が可能かどうかを判断し、実際に解決するための手段がどうもわかるようになったようだ。
results attributable to the circumstance that I commenced with the simplest and most general truths,  and that thus each truth discovered was a rule available in the discovery of subsequent ones	いちばん単純で、一般的な真理から手をつけた状況から出てくる結果を使うことで、そこから発見される真理が規則となって、それに続く真理の発見に利用できるようになるわけだ。
Nor in this perhaps shall I appear too vain, if it be considered that, as the truth on any particular point is one whoever apprehends the truth, knows all that on that  point can be known.	そしてある点での真実をだれであれ理解したら、その点について知りうるすべてを知るのだ、ということを考慮するならば、ここでわたしが傲慢すぎるとは言えないはずだ。
The child, for example, who has been instructed in the elements of arithmetic, and has made a particular addition, according to rule, may be assured that he has found, with respect to the sum of the numbers before him, and that in this instance is within the reach of human genius.	たとえば算数の基礎を教わった子供が、ある足し算の計算を規則にしたがって実行したら、その結果としての合計という点からまちがいなくその規則を理解したのであり、そしてその瞬間に人間の英知に手が届くようになったのである。
Now, in conclusion, the method which teaches adherence to the true order, and an exact enumeration of all the conditions of the thing .sought includes all that gives certitude to the rules of arithmetic.	というわけで結論として、真の秩序に従うことを教え、そして追求するものすべての条件にきちんと番号をつけることは、算数の規則に確実性を与えているものすべての一部なのだ。
But the chief ground of my satisfaction with thus method, was the assurance I had of thereby exercising my reason in all matters,	でもこの手法でわたしがいちばん満足したのは、自分がこれで万物に対して理性を適用している保証が得られたことだった。
if not with absolute perfection, at least with the greatest attainable by me:	完全無欠かどうかはわからないけれど、少なくともわたしに可能な限りきちんと適用できているわけだ。
besides, I was conscious that by its use my mind was becoming gradually habituated to clearer and more distinct conceptions of its objects;	それに、これを利用することで、自分の精神がだんだん対象をもっとはっきり、くっきりと把握できるように習慣づいてきたことが意識できた。
and I hoped also, from not having restricted this method to any particular matter, to apply it to the difficulties of the other sciences, with not less success than to those of algebra.	そして、この手法をなにか特定の対象のみに限定しなかったことで、これをほかの科学のむずかしい問題にも適用できるだろうと願ったし、そこでの成功も、代数の場合に劣らぬものであってほしいと思った。
I should not, however, on this account have ventured at once on the examination of all the difficulties of the sciences which presented themselves to me,	でもこの点では、目の前にあるあらゆる科学のあらゆる問題の検討にとびつくことはできない。
for this would have been contrary to the order prescribed in the method,	というのも、そんなことをしたら、わたしの方法論に記述された順番に反することになってしまうからだ。
but observing that the knowledge of such is dependent on principles borrowed from philosophy,	他の科学分野での知識は、哲学から拝借した原理に依存している。
in which I found nothing certain,	そして哲学分野では、わたしは確実なものはなにも見つけだせなかった。
I thought it necessary first of all to endeavor to establish its principles.	だから、まず哲学の原理を確立するように努力すべきだな、と考えた。
And because I observed, besides, that an inquiry of this kind was of all others of the greatest moment, and one in which precipitancy and anticipation in judgment were most to be dreaded, I thought that I ought not to approach it till I had reached a more mature age (being at that time but twenty-three),	そしてこの種の探求がほかの何にも増して最大の力を持っており、だからせっかちさと予断がいちばんこわい部分でもあるな、と思ったこともあって、この問題については、もっと成熟した年齢に達するまで手をつけないほうがいいだろうと考えた（当時のわたしは23歳だった）。
and had first of all employed much of my time in preparation for the work, as well by eradicating from my mind all the erroneous opinions I had up to that moment accepted,	だからまず、時間のほとんどを割いてその作業の準備を行い、一方で、それまで自分が受け入れてきた、まちがった見解を頭からどんどん捨てていった。
as by amassing variety of experience to afford materials for my reasonings, and by continually exercising myself in my chosen method with a view to increased skill in its application.	さらには、自分の理論展開のための材料を得るため、さまざまな経験を積んで、絶えず自分を、選んだ手法にしたがって実践するようにうながして、その適用のスキルを増そうと努めたのだった。
PART III	第 3 部
And finally, as it is not enough, before commencing to rebuild the house in which we live, that it be pulled down, and materials and builders provided, or that we engage in the work ourselves, according to a plan which we have beforehand carefully drawn out,	住んでいる家を建て直す場合、それを取り壊して、建材や建築業者を手配したり、あるいは自分が事前に慎重にひいた設計図にしたがって自分でその作業を行ったりするだけでは、事前準備としては不十分だ。
but as it is likewise necessary that we be furnished with some other house in which we may live commodiously during the operations,	工事中にも自分たちが不自由なく暮らすために、別の家を手配しなくてはならない。
so that I might not remain irresolute in my actions, while my reason compelled me to suspend my judgement, and that I might not be prevented from living thenceforward in the greatest possible felicity,	同じように、理性から考えて判断を停止すべき状態でも、優柔不断にならずにすむように、さらには最大限の幸福な暮らしをあきらめなくてすむように、わたしは一時的な道徳コードを作っておいた。
I formed a provisory code of morals, composed of three or four maxims, with which I am desirous to make you acquainted.	これは三，四つの原則からできているので、是非ともみなさんに紹介しておこう。
The first was to obey the laws and customs of my country, adhering firmly to the faith in which, by the grace of God, I had been educated from my childhood	最初の原則は、自分の国の法律や習慣を守り、神の恩寵によってわたしが子供時代以来教わってきた信仰をしっかりと遵守することだ。
and regulating my conduct in every other matter according to the most moderate opinions, and the farthest removed from extremes,	そしてそれ以外の点に関する行動はすべて、いちばん穏健な見解にしたがい、なるべく極論からは遠ざかること。
which should happen to be adopted in practice with general consent of the most judicious of those among whom I might be living.	その判断基準としては、自分がその中で暮らしている人々の中で最も判断力のある人たちの、一般的な合意を受けて採用されている行動を使う。
For as I had from that time begun to hold my own opinions for nought because I wished to subject them all to examination, I was convinced that I could not do better than follow in the meantime the opinions of the most judicious;	というのも、どの頃から自分の見解を全部否定して、それをすべて検討しなおそうとはしていたけれど、でもその間のやり方としては、いちばん判断力のある人たちの見解にしたがっておくのがいちばんいいと思ったからだ。
and although there are some perhaps among the Persians and Chinese as judicious as among ourselves, expediency seemed to dictate that I should regulate my practice conformably to the opinions of those with whom I should have to live;	そして、ペルシャやシナにだってわれわれと同じくらい判断力のある人たちはいるだろうけれど、便宜上からいっても、自分がいっしょに生活しなくてはならない人たちの意見に問題なくおさまるような形で、実践を規定すべきだろうと考えたわけだ。
and it appeared to me that, in order to ascertain the real opinions of such, I ought rather to take cognizance of what they practised than of what they said,	そして、そういう人たちの本当の見解を見極めるには、たぶんかれらが言っていることよりは、その行動のほうに注意すべきだろうと考えた。
not only because, in the corruption of our manners, there are few disposed to speak exactly as they believe, but also because very many are not aware of what it is that they really believe;	というのも、われわれの行いは堕落していて、信じるところを正直に述べようとする人は少ないし、さらには多くの人が、自分が本当は何を信じているのかわかっていないからだ。
for, as the act of mind by which a thing is believed is different from that by which we know that we believe it, the one act is often found without the other.	われわれが何かを信じるという心の働きは、自分が何かを信じていることを知るという心の働きとは別物なので、後者なしに前者が存在することだってよくあるのだ。
Also, amid many opinions held in equal repute, I chose always the most moderate,	さらに、同じくらいの評判を持つ各種の意見のなかで、わたしはいつも、いちばん穏健なものを選んだ。
as much for the reason that these are always the most convenient for practice,	そういうもののほうが絶対に実践しやすいからだ。
and probably the best (for all excess is generally vicious), as that, in the event of my falling into error, I might be at less distance from the truth than if, having chosen one of the extremes, it should turn out to be the other which I ought to have adopted.	さらに、もしまちがえたときにも、極端なものを選んで実は別の道を選ぶべきだったということになったときに比べれば、真実からの乖離具合が少なくてすむのでいちばんいいだろう
And I placed in the class of extremes especially all promises by which somewhat of our freedom is abridged;	そして、あらゆる契約の中で、われわれの自由が多少でも制限されるものはすべて極論に含めるようにした。
not that I disapproved of the laws which, to provide against the instability of men of feeble resolution,	別に、意志薄弱な人たちの不安定さから社会を守るための法律に反対というわけではない。
when what is sought to be accomplished is some good, permit engagements by vows and contracts binding the parties to persevere in it, or even, for the security of commerce, sanction similar engagements where the purpose sought to be realized is indifferent:	それが達成しようとしているものが何らかのメリットを持っていたり、誓約や契約によって関係者をしばるようになっていたり、あるいは商業の安全性を守るために、狙いが不公平なく適用されるような、各種行為を禁じる法律なども別に反対ではない。
but because I did not find anything on earth which was wholly superior to change, and because, for myself in particular, I hoped gradually to perfect my judgments, and not to suffer them to deteriorate,	でもこの世のもので、絶対不変なほど優れたものはわたしには見あたらなかったし、それに特に自分自身については、だんだん判断力を完成させていきたいと思っていて、それが退行するのは我慢ならなかった。
I would have deemed it a grave sin against good sense, if, for the reason that I approved of something at a particular time,	何かをある時点で認めても、それが将来正しくなくなったり、あるいはわたしがそれを正しいと思わなくなる場合があるだろう。
I therefore bound myself to hold it for good at a subsequent time, when perhaps it had ceased to be so, or I had ceased to esteem it such.	そんな場合でも、それをずっと正しいものと認め続けなくてはならないような形で自分を縛るのは、大きな罪であると考えざるをえない。
My second maxim was to be as firm and resolute in my actions as I was able, and not to adhere less steadfastly to the most doubtful opinions, when once adopted, than if they had been highly certain;	わたしの二つ目の原則は、できるだけ自分の行動について断固として決意をもって臨み、怪しげな意見であっても、いったんそれを採用したならばいい加減なことはせず、それがもっと確実な見解だった場合と同じようにふるまうということだった、
imitating in this the example of travelers who, when they have lost their way in a forest, ought not to wander from side to side, far less remain in one place, but proceed constantly towards the same side in as straight a line as possible, without changing their direction for slight reasons,	これと似ている話というと、森の中で道に迷った旅人は、あちこちふらふらしたりすべきではなく、まして一ヶ所にじっとしているべきではなく、同じ方向に向かってできるだけまっすぐに進み続けて、ちょっとやそっとでは方向を変えたりしないことだ。
although perhaps it might be chance alone which at first determined the selection;	その最初の方向を決めたのがただの偶然だったとしても。
for in this way, if they do not exactly reach the point they desire, they will come at least in the end to some place that will probably be preferable to the middle of a forest.	なぜならこうすれば、希望の地点にたどりつくことはないにしても、いずれどこか、森のど真ん中よりはましなところに出るはずだからだ。
In the same way, since in action it frequently happens that no delay is permissible, it is very certain that, when it is not in our power to determine what is true, we ought to act according to what is most probable;	同じように、行動の途中では遅れが許されないことがしょちゅうあるので、何が真実かを見極めるだけの力がない場合には、いちばんありそうな方向にしたがって行動すべきなのはおそらく確実であろう。
and even although we should not remark a greater probability in one opinion than in another, we ought notwithstanding to choose one or the other, and afterwards consider it, in so far as it relates to practice, as no longer dubious, but manifestly true and certain,	そしてこっちの意見があっちの意見より可能性がありそうだと思わないにしても、どちらかは選ぶべきなのであり、そして選んだら、実践に関わる範囲内ではそれがもはや疑わしいものであるようにはふるまわず、はっきりと真実で確実なものとして行動しなくてはならない。
since the reason by which our choice has been determined is itself possessed of these qualities.	というのも、われわれが選択を行ったときの理性ある判断は、それ自体がこうした性質を持っているからだ。
This principle was sufficient thenceforward to rid me of all those repentings and pangs of remorse that usually disturb the consciences of such feeble and uncertain minds as, destitute of any clear and determinate principle of choice,	われわれの弱々しくて自信のない精神は、はっきり決然とした選択方針がないときには後悔や逡巡にさいなまれて、おかげである日には、最高の行動はこっちだと思って行動したものの、その次の日は、やっぱりその反対だと思って行動したりしてしまう。
allow themselves one day to adopt a course of action as the best, which they abandon the next, as the opposite.	この原則を採用したことで、そういうことが以後まったくなくなったのである。
My third maxim was to endeavor always to conquer myself rather than fortune, and change my desires rather than the order of the world, and in general, accustom  myself to the persuasion that, except our own thoughts, there is nothing absolutely in our power;	第三の原則は、常に運命をねじふせようとするより自分自身を抑えるようにして、世界の秩序を変えるより自分の欲望を変えるようにしよう、そして一般論として、われわれの持つ力の中には、自分の思考力以外には絶対的なものはなにもないのだ、という説得に自分を慣らそうということだった。
so that when we have done our best in things external to us, all wherein we fail of success is to be held, as regards us, absolutely impossible:	つまりはなにか自分の外のことに対して人事をつくしても、それが失敗するかは絶対にわからないのだ。
and this single principle seemed to me sufficient to prevent me from desiring for the future anything which I could not obtain,	そしてこの一つの原理によって、将来、自分の手に入らないものを望むようなことを防ぐのに十分に思えた。
and thus render me contented;	こうしれば、不満を抱かずにいられる。
for since our will naturally seeks those objects alone which the understanding represents as in some way possible of attainment, it is plain, that if we consider all external goods as equally beyond our power, we shall no more regret the absence of such goods as seem due to our birth, when deprived of them without any fault of ours,	というのも、われわれの意志は当然のこととして、理解力にもとづき、何らかの形で入手可能だと思えるものだけを望むから、もし自分の外のものがすべて自分の力の及ばないものだと考えるなら、生まれながらに持っていてしかるべきだと思えるそういう外部のものが、こちらの落ち度ではない原因で奪われたときにも、残念がったりしないのは明らかだろう。
than our not possessing the kingdoms of China or Mexico,	それは、シナやメキシコ王国を所有したいないからといってわれわれが残念がったりしないのと同じことだ。
and thus making, so to speak, a virtue of necessity, we shall no more desire health in disease, or freedom in imprisonment, than we now do bodies incorruptible as diamonds, or the wings of birds to fly with.	あるいは、ダイヤのように衰えない身体を望んだり、あるいは空飛ぶ鳥の翼を望んだりしないように、病気のときにも健康を望んだり、幽閉時にも自由を望んだりしないのも、あたりまえのことだろう。
But I confess there is need of prolonged discipline and frequently repeated meditation to accustom the mind to view all objects in this light;	でも、この方法であらゆる対象を見るように精神を慣らすには、非常に長期の規律と、頻繁な瞑想の繰り返しが必要だったことは告白しておこう。
and I believe that in this chiefly consisted the secret of the power of such philosophers as in former times were enabled to rise superior to the influence of fortune, and, amid suffering and poverty, enjoy a happiness which their gods might have envied.	そして、かつての哲学者たちが、運命の影響を逃れて、困窮と貧困の中でも神々すらうらやむような幸福を楽しめた秘密は、主にここにあるのだろうと思う。
For, occupied incessantly with the consideration of the limits prescribed to their power by nature, they became so entirely convinced that nothing was at their disposal except their own thoughts,	つまり自然によって自分の力に与えられた限界のことばかりをしつこく考えることで、かれらは自由になるのが、自分の思考だけであることを完全に納得しきったのだ。
that this conviction was of itself sufficient to prevent their entertaining any desire of other objects;	だからこの結論だけで、他の物体への欲望をまるでもてあそばずにすむようになったのだろう。
and over their thoughts they acquired a sway so absolute, that they had some ground on this account for esteeming themselves more rich and more powerful, more free and more happy, than other men	そして思考するうちに、それが絶対的な影響を獲得したので、他のどんな人よりも自分がもっと裕福で、強力で、自由で幸福だと自負するだけの根拠を得るにいたったのだろう。
who, whatever be the favors heaped on them by nature and fortune, if destitute of this philosophy, can never command the realization of all their desires.	他の人々は、天与や運命がどんなに微笑もうと、この哲学を持たなければ、自分たちの欲望すべてを実現するなんてとうてい不可能だからだ。
In fine, to conclude this code of morals, I thought of reviewing the different occupations of men in this life,	結局、この道徳律をしめくくるにあたって、わたしはこの人生における人々のいろいろな職業を検討してみた。
with the view of making choice of the best.	そして最良のものを選択しようと思った。
And, without wishing to offer any remarks on the employments of others, I may state that it was my conviction that I could not do better than continue in that in which I was engaged,	そして他人の仕事についてあれこれ言うつもりはないのだけれど、いま自分が携わっていることを続ける以上に優れた選択はないな、というのがわたしの結論だとは言っておこう。
viz., in devoting my whole life to the culture of my reason, and in making the greatest progress I was able in the knowledge of truth, on the principles of the method which I had prescribed to myself.	つまり、一生を理性の耕作に捧げて、真実を知るために、自分自身に課した手法の原則に基づいてできる限りの進歩をもたらすということだ。
This method, from the time I had begun to apply it, had been to me the source of satisfaction so intense as to lead me to, believe that more perfect or more innocent could not be enjoyed in this life;	この手法は、それを適用しはじめて以来ずっと、とても強い満足感を与えてくれたので、これより完璧だったり無垢たっだりするものはこの世で味わえまいと思ったほどだ。
and as by its means I daily discovered truths that appeared to me of some importance, and of which other men were generally ignorant, the gratification thence arising so occupied my mind that I was wholly indifferent to every other object.	そしてこの手法を使うことで、ある程度の重要性を持った、ほかのだれもほとんど知らない真実を毎日のように発見していったので、そこから生じる満足で胸がいっぱいになってしまって、ほかのものにはまったく無関心になってしまった。
Besides, the three preceding maxims were founded singly on the design of continuing the work of self-instruction.	それに、さっきの原則三つは自己啓発作業を続けるためだけにつくったものだ。
For since God has endowed each of us with some light of reason by which to distinguish truth from error, I could not have believed that I ought for a single moment to rest satisfied with the opinions of another,	神はわれわれみんなに、真実とまちがいとを区別する理性を多少は与えたもうたから、自分が他人の意見で満足すべきだとは一瞬も思わなかった。
unless I had resolved to exercise my own judgment in examining these whenever I should be duly qualified for the task.	ただし、いずれ自分がその任に完全にふさわしくなった暁に自分の判断力を使ってそれを検討しよう、それまで先送りにしようと決意した場合は別だが。
Nor could I have proceeded on such opinions without scruple, had I supposed that I should thereby forfeit any advantage for attaining still more accurate, should such exist.	さらには、もっと正確なものが存在した場合に、それを達成するためになんらかのメリットを犠牲にしなくてはならないのなら¥footnote{達成するというメリット、かな？}、良心のとがめを感じずにそういう意見に基づいて先に進むことはできなかっただろう。
And, in fine, I could not have restrained my desires, nor remained satisfied had I not followed a path in which I thought myself certain of attaining all the knowledge to the acquisition of which I was competent, as well as the largest amount of what is truly good  which I could ever hope to secure Inasmuch as we neither seek nor shun any object	そして結局、自分に可能な限りのあらゆる知識獲得が確実にできると思った道をたどっていなければ、そして同時に、自分に可能な限りの知識を確実に得られると思った道をたどっていなければ、そして自分が獲得できるはずの真によきものを、最大限に実現できると思った道をたどっていなければ、自分の欲望をおさえたり、満足した状態でいられたりもしなかっただろう。
except in so far as our understanding represents it as good or bad, all that is necessary to right action is right judgment,	われわれが理解したうえでいいとか悪いとか判断した場合にだけ、何かを求めたり拒絶したりするようにすれば、正しい行動のために必要なものは正しい判断力だけだ。
and to the best action the most correct judgment,	つまり最高の行動にはいちばん正しい判断が必要となる。
that is, to the acquisition of all the virtues with all else that is truly valuable and within our reach;	最高の行動というのは、あらゆる美徳や、われわれの手に届く真に価値あるその他のものすべてを獲得することだ。
and the assurance of such an acquisition cannot fail to render us contented.	そして確実にそれが獲得できるということになれば、どうしたってわれわれは満足できるだろう。
Having thus provided myself with these maxims, and having placed them in reserve along with the truths of  faith, which have ever occupied the first place in my  belief, I came to the conclusion that I might with freedom set about ridding myself of what remained of my opinions.	こういう原則を考えついて、それをわたしの信念の中で最初の地位を占める、信仰の真理と同じところに掲げたので、わたし自身の見解で残っているものも片づけていけるだけの余裕ができたという結論に達した。
And, inasmuch as I hoped to be better able successfully to accomplish this work by holding intercourse with mankind, than by remaining longer shut up in the retirement where these thoughts had occurred to me, I betook me again to traveling before the winter was well ended.	そしてこの作業を行うためには、それを思いついた隠遁の地に引きこもったままでいるよりも、人々と対話をしていったほうがいいんじゃないかと思ったので、冬が終わりきる前にまた旅に出ることにした。
And, during the nine subsequent years, I did nothing but roam from one place to another, desirous of being a  spectator rather than an actor in the plays exhibited on the theater of the world;	そして続く9年の間、わたしはひたすらあちこちさまよい続け、世界という劇場で上演される芝居の役者となるおりも観客となり続けようとした。
and, as I made it my business in each matter to reflect particularly upon what might fairly be doubted and prove a source of error, I gradually rooted out from my mind all the errors which had hitherto crept into it.	そしてあらゆる事柄について、なにが公平に見て疑い得るものでまちがいの原因になれるかを必ず考えるようにしたので、精神からはそれまでに忍び込んできたまちがいが、すべて抜き取られてしまった。
Not that in this I imitated the sceptics who doubt only that they may doubt, and seek nothing beyond uncertainty itself;	だからといって、疑うために疑って、不確実性以外の何も求めないような懐疑主義者をまねしたわけではない。
for, on the contrary, my design  was singly to find ground of assurance,	それどころか、わたしはひたすら確実性の基盤を求めていたのである。
and cast aside the  loose earth and sand, that I might reach the rock or the clay.	ゆるい土砂をどけて、岩盤や年度に達したいなと思っていたのだ。
In this, as appears to me, I was successful enough;	この点でわたしはなかなか成功できたと思う。
for, since I endeavored to discover the falsehood or incertitude of the propositions I examined, not by feeble conjectures, but by clear and certain reasonings, I met with nothing so doubtful as not to yield some conclusion of adequate certainty,	いい加減な推量ではなく、はっきりした確実な理由づけをもとに、自分が検討する仮説のまちがいや不確実性を見つけだそうとしてきたけれど、どんなに疑わしいものについてでも、しかるべき確実さを持った結論を引き出せたからだ。
although this were merely the inference, that the matter in question contained nothing certain.	とはいっても、その結論というのは、検討していたものに確実なものは何一つ含まれていないというものだったりもしたのだが。
And, just as in pulling down an old house, we usually reserve the ruins to contribute towards the erection, so, in destroying such of my opinions as I judged to be Ill-founded, I made a variety of observations and acquired an amount of experience of which I availed myself in the establishment of more certain.	そして古い家を取り壊すときにも、がれきを保存して再建に使えるようにするのが普通だけれど、それと同じように、根拠がないと思われる自分の見解を破壊するときにも、さまざまな考察を行ってかなりの経験を獲得し、もっと確実なものの確立に役立つようにした。
And further, I continued to exercise myself in the method I had prescribed;	さらに、自分で用意した手法をさらに使い続けた。
for, besides taking care in general to conduct all my thoughts according to its rules, I reserved some hours from time to time which I expressly devoted to the employment of the method in the solution of mathematical difficulties, or even in the solution likewise of some questions belonging to other sciences,	というのも、自分のすべての思考をその規則に従って行おうと自らを律する一方で、わたしはときどき時間をとって、その手法を数学の問題に適用したり、あるいはほかの学問分野に属する問題に適用したりした。
but which, by my having detached them from such principles of these sciences as were of inadequate certainty, were rendered almost mathematical:	ただし、そうした分野の基盤は、確実性の点で十分とはいえなかったので、そうした問題もその分野の基盤から切り離された結果、どうしても数学的な表現をとることになったのだけれど。
the truth of this will be manifest from the numerous examples contained in this volume.	この真理は、この巻に含まれた無数の例からも見て取れるだろう。
And thus, without in appearance living otherwise than those who, with no other occupation than that of spending their lives agreeably and innocently, study to sever pleasure from vice, and who, that they may enjoy their leisure without ennui, have recourse to such pursuits as are honorable, I was nevertheless prosecuting my design, and making greater progress in the knowledge of truth, than I might, perhaps, have made had I been engaged in the perusal of books merely, or in holding converse with men of letters.	というわけで外見だけをみれば、わたしは後ろ指さされることもなく、罪も犯さずに暮らし、悪徳と喜びを切り離し、余暇を怠惰なくして楽しんでいる者たちが、名誉ある探求を行っているのと何ら変わらない暮らしを送っていたのだけれど、でも一方でわたしは自分の考えを押しすすめ、本だけを読んだり、学者たちとだけ話をしていた場合と比較しても、真理の獲得においてずっと大きな進歩をとげていたのだ。
These nine years passed away, however, before I had come to any determinate judgment respecting the difficulties which form matter of dispute among the learned, or had commenced to seek the principles of any philosophy more certain than the vulgar.	でも、賢者の間で論争の種となっている問題に関して、決定的な判断に到達したり、あるいは通俗哲学以上に確実な何らかの哲学原理を見つけだそうと手をつけるまでには、9年が経過した。
And the examples of many men of the highest genius, who had, in former times, engaged in this inquiry, but, as appeared to me, without success, led me to imagine it to be a work of so much difficulty, that I would not perhaps have ventured on it so soon had I not heard it currently  rumored that I had already completed the inquiry.	そしてこれまでの時代の、最高の天才を持った多くの人たちが、この探求に没頭しつつも、わたしに言わせれば成功できなかったという多くの事例を見たので、これはえらくむずかしい作業であって、もしわたしがこの探求をもう終えているという噂が最近流れていると耳にしなかったら、こんなにはやくそれに手をつけたりもしなかったかもしれない。
I know not what were the grounds of this opinion;	この噂がなにを根拠にしているのかは知らない。
and, if my conversation contributed in any measure to its rise, this must have happened rather from my having confessed my Ignorance with greater freedom	そしてわたしの会話がその噂の原因に少しでもなっていたとしたら、それは別にわたしが何か哲学大系を豪語してみせたからではないはずだ。
than those are accustomed to do who have studied a little, and expounded perhaps, the reasons that led me to doubt of many of those things that by others are esteemed certain, than from my having boasted of any system of philosophy.	むしろ、多少なりとも学問を学んだ者たちが行うよりも自由に自分の無知について告白し、そしてひょっとしたら、他の人たちが確実と思っている多くのことに対してなぜ疑問を抱くようになったかについて、理由を説明したりしたせいなのだろうと思う。
But, as I am of a disposition that makes me unwilling to be esteemed different from what I really am, I thought it necessary to endeavor by all means to render myself worthy of the reputation accorded to me;	でも、わたしは実際の自分以外のものとしてもてはやされるのを避けようと決意しているので、自分に与えられた評判にふさわしい存在となるよう全力を尽くさなければ、と思った。
and it is now exactly eight years since this desire constrained me to remove from all those places where interruption from any of my acquaintances was possible, and betake myself to this country,	そこで知人たちからのじゃまが入りそうな場所すべてから身を隠そうと思って、この国にやってきた。
in which the long duration of the war has led to the establishment of such discipline, that the armies maintained seem to be of use only in enabling the inhabitants to enjoy more securely the blessings of peace	ここでは長いこと戦争が続いてきたから、維持されている軍隊も、住民たちが平和の恵みをもっとしっかり享受できるようにだけ使われるという規律ができあがっていたのだ。
and where, in the midst of a great crowd actively engaged in business, and more careful of their own affairs than curious about those of others,	そして大群衆の中でも活発に商売に励み、他人のことをかぎまわるよりは、自分のことに注意を払うような風土ができあがっていた。
I have been enabled to live without being deprived of any of the conveniences to be had in the most populous cities, and yet as solitary and as retired as in the midst of the most remote deserts.	だからわたしは、人の多い街で味わえるような生活の便はまったく犠牲にせずに暮らせた一方で、はるか彼方の砂漠の真ん中に隠遁したかのように、一人で暮らせたのだった。
PART IV	第 4 部
I am in doubt as to the propriety of making my first meditations in the place above mentioned matter of discourse;	いまのべた場所で行った最初の思索について、ここで述べてしまうのが適切かどうか、実は自信がない。
for these are so metaphysical, and so uncommon, as not, perhaps, to be acceptable to every one.	というのも、これはあまりに形而上学的で、えらく風変わりなので、だれもが認めるようなものではないかもしれないからだ。
And yet, that it may be determined whether the foundations that I have laid are sufficiently secure, I find myself in a measure constrained to advert to them.	でも、自分が敷いた基礎というのがじゅうぶんにしっかりしているかを決めるためには、それを否定せざるを得ないような立場に自分を置かなくてはならない。
I had long before remarked that, in relation to practice, it is sometimes necessary to adopt, as if above doubt, opinions which we discern to be highly uncertain, as has been already said;	さっき述べたように、実践との関連でいえば、非常に不確実なものとして退けるような見解であっても、それが疑問の余地なく、確固たるものであるかのようにふるまうことが必要となることもある。
but as I then desired to give my attention solely to the search after truth, I thought that a procedure exactly the opposite was called for,	でもわたしは、真理の探究だけに関心を向けようと思っていたので、その正反対の手続きが必要となるな、と思った。
and that I ought to reject as absolutely false all opinions in regard to which I could suppose the least ground for doubt,	つまり、ちょっとでも疑問の余地のあるものはすべて、まったくの偽であるとして棄却すべきだということだ。
in order to ascertain whether after that there remained aught in my belief that was wholly indubitable.	そうすることで、わたしの信念の中に、完全に疑問の余地のないものが残るかどうかを確かめたかった。
Accordingly, seeing that our senses sometimes deceive us, I was willing to suppose that there existed nothing really such as they presented to us;	同じように、感覚もわれわれをだますときがあるから、こうして感じられるものすべてが、何一つ存在しないと仮定してみようと思った。
and because some men err in reasoning, and fall into paralogisms, even on the simplest matters of geometry, I, convinced that I was as open to error as any other, rejected as false all the reasonings I had hitherto taken for demonstrations;	そして、幾何学の一番単純な問題でも理由づをまちがえて、まちがった論理に陥る人もいるから、わたし自身だってほかのだれにも負けず劣らずまちがえやすいのだと確信して、これまで証明につかってきた理由づけをすべて、まちがいとして棄却した。
and finally, when I considered that the very same thoughts (presentations) which we experience when awake may also be experienced when we are asleep, while there is at that time not one of them true,	そして最後に、われわれが起きているときに経験される、この思考（表象）とまったく同じものが、眠っているときにも体験できるのに、実はその時に体験されるものは何一つ真ではない、ということも考えた。
I supposed that all the objects (presentations) that had ever entered into my mind when awake, had in them no more truth than the illusions of my dreams.	だから、起きているときにわたしの精神に入ってきた、すべての対象（表象）ですら、自分の夢の中の幻影のように、本物ではないのだと考えてみた。
But immediately upon this I observed that, whilst I thus wished to think that all was false, it was absolutely necessary that I, who thus thought, should be somewhat;	しかしこのときすぐに見て取ったのだが、すべてが非現実だと考えたくても、そのように考えているこのわたしは、なんらかの形で存在しなくてならない。
and as I observed that this truth, I think, therefore I am (COGITO ERGO SUM), was so certain and of such evidence that no ground of doubt, however extravagant, could be alleged by the sceptics capable of shaking it,	そしてこの真理、われ思う、故にわれあり（COGITO ERGO SUM）がまったく確実で、確固たる証拠を持ち、どんなにとんでもないものであれ、疑問の余地はないことがわかった。
I concluded that I might, without scruple, accept it as the first principle of the philosophy of which I was in search	だから、疑念なしにこれを、わたしの求める哲学の第一原理として受け入れようと結論づけたわけだ。
In the next place, I attentively examined what I was and as I observed that I could suppose that I had no body, and that there was no world nor any place in which I might be;	次に、自分がなんであるかを素直に検討すると、自分にはからだがないと考えることもできるし、自分が存在できるような世界も場所もまったくないと考えたっていいことに気がついた。
but that I could not therefore suppose that I was not;	でも、だからといって自分自身が存在していないとは想定できない。
and that, on the contrary, from the very circumstance that I thought to doubt of the truth of other things, it most clearly and certainly followed that I was;	それどころか逆に、ほかのことの真実性を疑おうとわたしが考えたというまさにそのことから、わたしが存在するということはきわめてはっきりと疑いなく導かれるのだった。
while, on the other hand, if I had only ceased to think, although all the other objects which I had ever imagined had been in reality existent, I would have had no reason to believe that I existed;	一方で、わたしが考えるのをやめただけで、わたしが想像してきたものがすべて現実に存在するとしても、わたしは自分が存在すると信じるべき理由を持たなくなる。
I thence concluded that I was a substance whose whole essence or nature consists only in thinking, and which, that it may exist, has need of no place, nor is dependent on any material thing;	だからわたしは、自分というのは、その本質や性質が考えるということだけからできあがった存在なのであり、それが存在するにあたっては、場所や物質的なものには一切依存する必要がないのだ、と結論した。
so that " I," that is to say, the mind by which I am what I am, is wholly distinct from the body, and is  even more easily known than the latter, and is such, that although the latter were not, it would still continue to be all that it is.	だから「わたし」、つまりわたしがわたしであるところの精神は、肉体からは完全に独立したもので、肉体よりもずっと簡単に知り得るもので、肉体が存在しなかったとしても、いまとまったく同じように存在し続けるということになる。
After this I inquired in general into what is essential I to the truth and certainty of a proposition;	この後で、わたしはある仮説の真実性と確実性にとってなにが本質的かを一般的に考えてみた。
for since I had discovered one which I knew to be true, I thought that I must likewise be able to discover the ground of this certitude.	というのも、真実なのが確実な仮説を一つ見つけたので、わたしとしては、その確実性の根拠を見つけられるはずだと思ったからだ。
And as I observed that in the words I think, therefore I am, there is nothing at all which gives me assurance of their truth beyond this,	「われ思う、故にわれあり」ということばの中には、それ自体を越えるような形で真実性を確信させてくれるようなものはなにもない。
that I see very clearly that in order to think it is necessary to exist,	単に、考えるためには存在しなくてはならない、というのがはっきりわかるだけだ。
I concluded that I might take, as a general rule, the principle, that all the things which we very clearly and distinctly conceive are true,	したがって、一般原則としては、われわれが非常にはっきりと、疑問の余地なく受け入れられるものは真実だと考えていいという結論に達した。
only observing, however, that there is some difficulty in rightly determining the objects which we distinctly conceive.	ただしここで、われわれが疑問の余地なく受け入れられるものとは何なのかをきちんと決めるのは、やはりむずかしいということは理解できた。
In the next place, from reflecting on the circumstance that I doubted, and that consequently my being was not wholly perfect (for I clearly saw that it was a greater perfection to know than to doubt), I was led to inquire whence I had learned to think of something more perfect than myself;	次に、自分が疑問視した状況を考え、さらにわたし自身の存在が完全無欠ではないことを考えると（というのも、疑うよりも知る方が完成度が高いことははっきりとわかったからだ）、どうして自分があるものについて、自分よりもっと完全だと考えるようになったのか、ということを検討するにいたった。
and I clearly recognized that I must hold this notion from some nature which in reality was more perfect.	そしてはっきり認識したのは、そういう考えは現実に自分よりもっと完全なものの性質から得たにちがいない、ということだ。
As for the thoughts of many other objects external to me, as of the sky, the earth, light, heat, and a thousand more, I was less at a loss to know whence these came;	自分の外にあるほかのいろいろな対象、たとえば空とか、大地とか、光や熱など無数のものについての考えがどこからきたのかを考えると、もっと迷いは少ない。
for since I remarked in them nothing which seemed to render them superior to myself, I could believe that, if these were true, they were dependencies on my own nature, in so far as it possessed a certain perfection, and, if they were false, that I held them from nothing, that is to say, that they were in me because of a certain imperfection of my nature.	それらの中には、自分より優れていると考えるべきものは一切みられないので、そういうものが実在するならば、それはある程度の完成度を持っているので、わたし自身の性質に従属しているものなのだと信じることもできるし、もしそれが実在しないなら、自分がそれを無から作り出した、つまりはわたし自身の性質がある種不完全なために、そうしたものが自分の中にあるのだと信じることができるわけだ。
But this could not be the case with-the idea of a nature more perfect than myself;	でもこれは、自分より完成度の高い性質については言えない。
for to receive it from nothing was a thing manifestly impossible;	それを無から作り出すことは、明らかに不可能なことだ。
and, because it is not less repugnant that the more perfect should be an effect of, and dependence on the less perfect, than that something should proceed from nothing,	そして、より完璧なものが、完成度の低いものの結果であり、したがってその従属物だというのは、それが無からでてきたというのと同じくらい気持ち悪い。
it was equally impossible that I could hold it from myself:	だからそれがわたし自身から生じたと考えることもできない。
accordingly, it but remained that it had been placed in me by a nature which was in reality more perfect than mine,	すると結局、それはわたし自身よりも実際にもっと完成度が高いものによってそこにおかれたのだと考えるよりほかにない。
and which even possessed within itself all the perfections of which I could form any idea;	そしてその存在は、わたしが考えもつかないようなあらゆる完成度を中に持っているはずだ。
that is to say, in a single word, which was God.	つまりそれを一言でいうなら、それは神だ。
And to this I added that, since I knew some perfections which I did not possess, I was not the only being in existence (I will here, with your permission, freely use the terms of the schools);	そしてこれにわたしとして付け加えたいのは、わたしは自分が持っていない完成度について知っているので、わたしは単に存在しているだけでなく（ここでスコラ学派の用語をかなり我流で使うのをお許しいただこう）、
but, on the contrary, that there was of necessity some other more perfect Being upon whom I was dependent, and from whom I had received all that I possessed;	もっと完全な存在があってわたしはそれに依存して存在しているのであり、そこからわたしは自分の持っているものすべてを与えられたのだ、ということだ。
for if I had existed alone, and independently of every other being, so as to have had from myself all the perfection, however little, which I actually possessed, I should have been able, for the same reason, to have had from myself the whole remainder of perfection, of the want of which I was conscious, and thus could of myself have become infinite, eternal, immutable, omniscient, all-powerful, and, in fine, have possessed all the perfections which I could recognize in God.	というのも、もしわたしが単独で、ほかのすべての存在から独立して存在していたのなら、わたしは実際に持っているのがどれほど少量であったとしても、すべての完全さを自分で備えていることになるわけで、同じ理由から、完全さの残りもすべて自分で獲得できるはずで（獲得したいのは自分で意識できている）、すると無限かつ永遠で、遍在し、全能で、つまるところ神の中に認められるあらゆる完成度を自ら身につけられたはずなのだ。
For in order to know the nature of God (whose existence has been established by the preceding reasonings), as far as my own nature permitted, I had only to consider in reference to all the properties of which I found in my  mind some idea, whether their possession was a mark of perfection;	というのも、神（その存在についてはいままでの理由づけで確立されている）の性質を、わたしの性質が許す限りにおいて知るためには、自分の頭の中で多少なりとも理解している性質すべてについて、それを持つことが完全さの印となるかどうかを考えてみればよいだけだからだ。
and I was assured that no one which indicated any imperfection was in him, and that none of the rest was awanting.	そして、不完全さを少しでも示すような性質は、神の中には一切ないことが確認できて、その他の性質も一切不要であることが確認できた。
Thus I perceived that doubt, inconstancy,  sadness, and such like, could not be found in God,	したがってわたしは、疑念や非一貫性、悲しみなどの性質は、神の中には見いだせないと理解した。
since I myself would have been happy to be free from them.	わたし自身、そういったものがなければもっとうれしいからだ。
Besides, I had ideas of many sensible and corporeal things;	それに、わたしは感覚的なことや実体的について、いろいろな考えを持っている。
for although I might suppose that I was dreaming, and that all which I saw or imagined was false, I could not, nevertheless, deny that the ideas were in reality in my thoughts.	自分が夢を見ていると想定することも可能で、自分が見て考えることすべてが存在しないと考えることもできるけれど、そうした考えが実際に自分の頭の中にあることは否定できないからだ。
But, because I had already very clearly recognized in myself that the intelligent nature is distinct from the corporeal, and as I observed that all composition is an evidence of dependency, and that a state of dependency is manifestly a state of imperfection, I therefore determined that it could not be a perfection in God to be compounded of these two natures and that consequently he was not so compounded;	でもすでに自分の中で、知性は肉体的なものとは別だというのをはっきり認識していて、部分から構成されているのというのはすべて依存の証拠であり、依存した状態は明らかに不完全な状態を示すものなんだから、肉体と知性という二つの性質でできているのは、神の完成度とは相容れないものであり、したがって神はそのようには構成されていないことになる。
but that if there were any bodies in the world, or even any intelligences, or other natures that were not wholly perfect, their existence depended on his power in such a way that they could not subsist without him for a single moment.	せもこの世に完全無欠でない物体や、知性や、その他の性質があるなら、その存在は神の力に依存していて、神なしには一瞬たりとも続くことができないであろう。
I was disposed straightway to search for other truths and when I had represented to myself the object of the geometers,	わたしはすぐにほかの真理を探すのに取りかかった、そして幾何学的な対象を考えてみた。
which I conceived to be a continuous body or a space indefinitely extended in length, breadth, and height or depth, divisible into divers parts which admit of different figures and sizes, and of being moved or transposed in all manner of ways (for all this the geometers suppose to be in the object they contemplate),	ここでわたしはそれを、長さや幅、高さ／深さが無限に続くような連続対または空間だと考え、それを様々な形や大きさにいろいろ分割でき、あらゆる形で移動させたりひっくり返したりできるようなものだと考えることにした（というのも、幾何学者が考える対象はそういうものだとされているからだ）。
I went over some of their simplest demonstrations.	かれらのいちばん簡単な証明を考えてみた。
And, in the first place, I observed, that the great certitude which by common consent is accorded to these demonstrations, is founded solely upon this, that they are clearly conceived in accordance with the rules I have already laid down	そしいてこうした証明については、一般的な合意に基づいて、非常に確実だとされているけれど、それが確実なのは、わたしがすでに敷いてきた原則にしたがう形で考察されているという点にのみ基づいていることを認識した。
In the next place, I perceived that there was nothing at all in these demonstrations which could assure me of the existence of their object:	次に、こうした証明の中には、そうした対象物の実在性について保証してくれるようなものは一切ないことも認識した。
thus, for example, supposing a triangle to be given, I distinctly perceived that its three angles were necessarily equal to two right angles, but I did not on that account perceive anything which could assure me that any triangle existed:	たとえば三角形が与えられたとすると、その内角の和が直角二つ分になることは疑問の余地なく認識できたけれど、でもそれだからといって、三角形なるものが存在することを保証してくれるものは、一切認識できなかった。
while, on the contrary, recurring to the examination of the idea of a Perfect Being, I found that the existence of the Being was comprised in the idea in the same way that the equality of its three angles to two right angles is comprised in the idea of a triangle, or as in the idea of a sphere, the equidistance of all points on its surface from the center, or even still more clearly;	ところが逆に、完全なる存在という概念の検討に戻ると、その完全な存在の実在性は、三角形という概念の中に、内角の和が直角二つ分に等しいということが含まれているのと同じように、あるいは球面上のすべての点がその中心から等距離にあるということが、球という概念にふくまれているのと同じように（いやそれよりもっとはっきりと）、完全な存在という概念自体に含まれていることを発見した。
and that consequently it is at least as certain that God, who is this Perfect Being, is, or exists, as any demonstration of geometry can be.	だから完全な存在たる神がある、または存在しているということは、少なくとも幾何学の証明が確実なのと同じくらい確実なわけだ。
But the reason which leads many to persuade them selves that there is a difficulty in knowing this truth, and even also in knowing what their mind really is, is that they never raise their thoughts above sensible objects,	でも、多くの人が、この真実を知るのは難しいと思いこんでしまう理屈、そしてさらには、自分の精神が何であるかを知るのが難しいと思いこんでしまう理由というのは、かれらが感覚的な物体のことばかりを考えていて、それ以上のものに思考を向けないからだ。
and are so accustomed to consider nothing except by way of imagination,	だからすべてを想像以外の方法で考えるのになれていない。
which is a mode of thinking limited to material objects,	想像というのは物質的な対象に限られた思考の様式なのだ。
that all that is not imaginable seems to them not intelligible.	そして、想像できないものについては考えることができない、とかれらは思っている。
The truth of this is sufficiently manifest from the single circumstance, that the philosophers of the schools accept as a maxim that there is nothing in the understanding which was not previously in the senses,	これが事実であるのをはっきり物語っているのが、スコラ学派の哲学者たちの採用している公理で、それによると、理解の中には、もともと感覚の中に含まれていなかったものはないということになる。
in which however it is certain that the ideas of God and of the soul have never been;	ところが、神や魂の概念がもともと感覚の中にはあり得ないのは確実だ。
and it appears to me that they who make use of their imagination to comprehend these ideas do exactly the some thing as if, in order to hear sounds or smell odors, they strove to avail themselves of their eyes;	するとわたしには、想像力を使ってこうした概念を理解しようとしているかれらは、音を聞いたりにおいをかいだりしようとして、いっしょうけんめい目を使って苦心している人と同じことをやっているように思えるのだ。
unless indeed that there is this difference, that the sense of sight does not afford us an inferior assurance to those of smell or hearing;	そういう区別がない限り、視覚は、嗅覚や聴覚に対してはさしたる保証にはならないのだ。
in place of which, neither our imagination nor our senses can give us assurance of anything unless our understanding intervene.	同じように、われわれの想像力も感覚も、われわれの理解力が介入しない限り、なにごとをも保証はしてくれないのだ。
Finally, if there be still persons who are not sufficiently persuaded of the existence of God and of the soul, by the reasons I have adduced, I am desirous that they should know that all the other propositions, of the truth of which they deem themselves perhaps more assured, as that we have a body, and that there exist stars and an earth, and such like, are less certain;	最後に、わたしがこれまで示した理由でもまだ神と魂の存在について納得できない人がいるなら、わたしとしてはかれらがもっと確信を持って真実だと考えているような、その他すべての説――たとえばわれわれに肉体があり、星や地球が存在するなど――は、神や魂の存在よりも不確実なのだということは、是非知っておいてほしいと思う。
for, although we have a moral assurance of these things, which is so strong that there is an appearance of extravagance in doubting of their existence,	われわれはこうした事柄について道義的な確信を持っていて、それがとても強いために、その存在を疑うなんてやりすぎだと思えるかもしれない。
yet at the same time no one, unless his intellect is impaired, can deny, when the question relates to a metaphysical certitude, that there is sufficient reason to exclude entire assurance,	でも同時に、形而上学的な確実さにまできちんと検討するつもりなら、そういう確信をすべて排除すべきだということは、知性に欠陥があるのでもない限りだれも否定できないのだ。
in the observation that when asleep we can in the same way imagine ourselves possessed of another body and that we see other stars and another earth,	それは、われわれが寝ている時に別の肉体を持っていると想像できたり、別の星や別の地球をみることができるという観察結果からもわかる。
when there is nothing of the kind.	実際にはそんな別の肉体や星や地球はありはしないのだ。
For how do we know that the thoughts which occur in dreaming are false rather than those other which we experience when awake,	起きているときに経験することではなく、夢の中で起こることのほうが偽物であるとなぜわかるのだろう。
since the former are often not less vivid and distinct than the latter?	夢の中のできごとは、しばしば起きているときのできごとに比べても、鮮明さや明瞭さの点で勝るとも劣らないではないか。
And though men of the highest genius study this question as long as they please, I do not believe that they will be able to give any reason which can be sufficient to remove this doubt, unless they presuppose the existence of God.	そして、最高の才能を持った人たちは好きなだけこの疑問を考えてくれればいいのだけれど、わたしはかれらが神の存在を前提としない限り、この疑問をぬぐい去れるだけの理由は一切提出できないだろうと信じている。
For, in the first place even the principle which I have already taken as a rule, viz., that all the things which we clearly and distinctly conceive are true, is certain only because God is or exists and because he is a Perfect Being, and because all that we possess is derived from him:	というのも、そもそもわたしがすでに規則として採用した原理、つまりわれわれがはっきりと疑問の余地なく受け入れられるものが真実だという原理も、神があるかまたは存在していて、そして神が完全な存在であって初めて確実なのであり、われわれが持っているものがすべて神から派生するものだからこそ確実なのだ。
whence it follows that our ideas or notions, which to the extent of their clearness and distinctness are real, and proceed from God, must to that extent be true.	そこから言えるのは、われわれの考えや概念は、それがはっきりしていて疑問の余地がなく真実であり、神から派生しているという限りにおいて真実なのだ、ということだ。
Accordingly, whereas we not infrequently have ideas or notions in which some falsity is contained, this can only be the case with such as are to some extent confused and obscure, and in this proceed from nothing (participate of negation), that is, exist in us thus confused because we are not wholly perfect.	同じように、われわれはしばしば、まちがいを含んだ思いつきや考えを抱くけれど、これはある程度までは混乱して不明瞭なものがあって初めてあり得るのであり、そしてそれが無から出てきたなら、 (participate of negation), つまりはわれわれの中にそのように混乱したものがあるのは、われわれが完全ではないからだ、ということになる。
And it is evident that it is not less repugnant that falsity or imperfection, in so far as it is imperfection, should proceed from God, than that truth or perfection should proceed from nothing.	そしてこうした誤りや不完全さは、不完全であるがゆえに、それが神様からでてきたと思うのは、真実や完全さが無から生じたと思うくらい気持ち悪い。
But if we did not know that all which we possess of real and true proceeds from a Perfect and Infinite Being, however clear and distinct our ideas might be, we should have no ground on that account for the assurance that they possessed the perfection of being true.	でも、われわれが持つ真実で本物なものがすべて完全で無限の存在から派生しているのだと知らなければ、われわれの思考がいかにはっきりと疑問の余地がないものであっても、それが真実であることの完全性を備えているということを保証してくれるような根拠というのはいっさいなくなってしまう。
But after the knowledge of God and of the soul has rendered us certain of this rule, we can easily understand that the truth of the thoughts we experience when awake, ought not in the slightest degree to be called in question on account of the illusions of our dreams.	でも、神と魂の実在がわかってこの規則が確実となったからには、われわれは目を覚ましているときに経験する思考のほうが実在するものであり、夢の幻などを理由にみじんも疑うべきものではないのだ、ということは用意に理解される。
For if it happened that an individual, even when asleep, had some very distinct idea,	もしある個人が眠っているときにでも非常にはっきりした考えを持ったとしよう。
as, for example, if a geometer should discover some new demonstration,	たとえば幾何学者が夢の中で新しい証明を発見したとしよう。
the circumstance of his being asleep would not militate against its truth;	それでも、かれが眠っているという状況は、その証明の正しさを否定するものにはならない。
and as for the most ordinary error of our dreams, which consists in their representing to us various objects in the same way as our external senses, this is not prejudicial,	そしてわれわれの夢によく見られるまちがいというのは、外部に対する感覚と同じような形で、いろいろなものをわれわれに提示してしまうことからくるので、これは偏見ではない。
since it leads us very properly to suspect the truth of the ideas of sense;	むしろ、しごくまっとうに、われわれの感覚という概念を疑うことにつながるのだ。
for we are not infrequently deceived in the same manner when awake;	われわれは目を覚ましている時にも、同じようなかたちでだまされてしまうことが多いからだ。
as when persons in the jaundice see all objects yellow, or when the stars or bodies at a great distance appear to us much smaller than they are.	黄疸にかかった人間にはすべてが黄色かがって見えるし、星などずっと遠くにある物体は、実際よりもずっと小さく見えたりする。
For, in fine, whether awake or asleep, we ought never to allow ourselves to be persuaded of the truth of anything unless on the evidence of our reason.	結局のところ、寝ていようと起きていようと、理性の証拠に基づかない限り、何事も真実だと納得したりしてはいけないのだ。
And it must be noted that I say of our reason, and not of our imagination or of our senses:	そしていま、「理性」といったのであり、「想像力」とか「感覚」とかいったのではないことに注意してほしい。
thus, for example, although we very clearly see the sun, we ought not therefore to determine that it is only of the size which our sense of sight presents;	たとえば、太陽はとてもはっきり見えるけれど、だからといって、太陽が目に見える大きさでしかないと判断してはならない。
and we may very distinctly imagine the head of a lion joined to the body of a goat, without being therefore shut up to the conclusion that a chimaera exists;	ヤギの体にライオンの頭がくつっついたところを明瞭に想像できるからといって、そんなキマイラが存在するという結論を黙々と受け入れなければならないわけでもない。
for it is not a dictate of reason that what we thus see or imagine is in reality existent;	見たり想像したりするものが実際に存在するというのは、理性が告げるものではない。
but it plainly tells us that all our ideas or notions contain in them some truth;	それは単に、われわれの概念や発想にも同じように真実が多少は含まれている、ということを教えてくれているだけだからだ。
for otherwise it could not be that God, who is wholly perfect and veracious, should have placed them in us.	というのも、もし真実が含まれていないなら、全く完全で正直な神が、それをわれわれの中に置くはずがないからだ。
And because our reasonings are never so clear or so complete during sleep as when we are awake,	そしてわれわれの理由づけは、起きているときに比べて寝ているときには、あまり明瞭でも完全でもない。
although sometimes the acts of our imagination are then as lively and distinct, if not more so than in our waking moments,	想像力のほうは、起きているときと同じくらい、あるいはそれ以上に生き生きと明瞭だ。
reason further dictates that, since all our thoughts cannot be true because of our partial imperfection, those possessing truth must infallibly be found in the experience of our waking moments rather than in that of our dreams.	そこから理性が導き出す結論とはつまり、われわれの思考は、われわれの不完全さのせいですべてが真というわけではない以上、真理を含む思考というのは、夢を見ているときではなく、起きているときの経験の中に見つかるのはまちがいない、ということなのだ。
PART V	第 5 部
I would here willingly have proceeded to exhibit the whole chain of truths which I deduced from these primary but as with a view to this it would have been necessary now to treat of many questions in dispute among the earned, with whom I do not wish to be embroiled, I believe that it will be better for me to refrain from this exposition, and only mention in general what these truths are, that the more judicious may be able to determine whether a more special account of them would conduce to the public advantage.	ここで、こうした基本原則（primary）から導き出した一連の真理すべてを開陳したいところだが、そのためにはまず学識経験者の間で議論されている各種の質問を扱わなくてはならず、そういう人々に巻き込まれたくないので、ここでは真理の開陳は控えて、それがなんであるかを一般論として述べて、そしてそれを個別に詳述することが公共の利益にかなうかどうかについては、判断力のある人が決めてくれるのに任せたほうがいいだろう。
I have ever remained firm in my original resolution to suppose no other principle than that of which I have recently availed myself in demonstrating the existence of God and of the soul,	わたしはずっと、さっき神と魂の存在を証明したときに使ったまさにあの原理以外の何者をも想定しないというもともとの決意を、いっさい変えてはいない。
and to accept as true nothing that did not appear to me more clear and certain than the demonstrations of the geometers had formerly appeared;	そしてこれまで幾何学者たちがやってきたような証明と同じくらい明瞭で確実に思えないものは、どれも真実として認めなかった。
and yet I venture to state that not only have I found means to satisfy myself in a short time on all the principal difficulties which are usually treated of in philosophy,	それでもわたしは、哲学でふつう扱われる主要な問題すべてについて、ごく短期間のうちに自分の満足のいく答えを出す方法を見つけたと敢えて主張する。
but I have also observed certain laws established in nature by God in such a manner,	またそのようなやり方で、神が自然の中に確立したいくつかの法則も見つけた。
and of which he has impressed on our minds such notions, that after we have reflected sufficiently upon these, we cannot doubt that they are accurately observed in all that exists or takes place in the world and farther,	そうした概念を神がわれわれの精神に刻みつけ、このためそれについて十分に考えてみれば、それがこの世に存在するものや起こることすべての中に、厳密に観察されることもわかった。
by considering the concatenation of these laws, it appears to me that I have discovered many truths more useful and more important than all I had before learned, or even had expected to learn.	そしてさらにそうした法則の組み合わせを考えれば、それまで学習してきたことすべて、学習できると期待したことすべてよりも、もっと有用で重要な真理をたくさん見つけたのである。
But because I have essayed to expound the chief of these discoveries in a treatise which certain considerations prevent me from publishing, I cannot make the results known more conveniently than by here giving a summary of the contents of this treatise.	しかしながら、こうした発見の主要部分は論文に書いたのだけれど、いろいろ考えるところあって、それを刊行できずにいるので、ここではその論文の中身をかいつまんで説明することで、その結果を手短に知ってもらうのがいちばんいいだろう。
It was my design to comprise in it all that, before I set myself to write it, I thought I knew of the nature of material objects.	それを書き始める前は、自分が物質界について知っていることをすべて書き記すつもりでいた。
But like the painters who, finding themselves unable to represent equally well on a plain surface all the different faces of a solid body, select one of the chief, on which alone they make the light fall, and throwing the rest into the shade, allow them to appear only in so far as they can be seen while looking at the principal one;	でも、たとえば画家は、固体のさまざまな面を、平面上に等しく表現するわけにはいかないのを悟って、主要な面を一つ選んでそこに光を当て、残りは影にして、主要な面を見るときに見える範囲だけを描くようにするけれど、
so, fearing lest I should not be able to compense in my discourse all that was in my mind, I resolved to expound singly, though at considerable length, my opinions regarding light;	それと同じようにわたしも、自分の著作で頭の中にあるものすべてを表現できないだろうと思ったので、まずは光に関する見解だけについて、かなりの分量をかけて述べることにした。
then to take the opportunity of adding something on the sun and the fixed stars,	そしてそれから、太陽と恒星についての話を追加した。
since light almost wholly proceeds from them;	というのも、ほとんどすべての光はこれらのものから発しているからだ。
on the heavens since they transmit it;	ついで、その光を伝える天について。
on the planets, comets, and earth, since they reflect it;	そしてその光を反射する惑星や彗星や地球について。
and particularly on all the bodies that are upon the earth,	そして、特に、地上にあるあらゆる物体について述べた。
since they are either colored, or transparent, or luminous;	それらは色がついているか、透明か、光を放つかのどれかだからだ。
and finally on man,	そして最後に人間についても書いた。
since he is the spectator of these objects.	人間はこうした物体を観察する存在だからだ。
Further, to enable me to cast this variety of subjects somewhat into the shade, and to express my judgment regarding them with greater freedom, without being necessitated to adopt or refute the opinions of the learned, I resolved to leave all the people here to their disputes, and to speak only of what would happen in a new world,	さらにこうしたさまざまな対象を、ある程度むこうに押しやって、有識者たちの意見を採用したり反論したりせずに、それについての自分の判断をもっと自由に表明できるようにするため、わたしはここでみんなを論争するに任せて、次のようなことだけを考えることにした。
if God were now to create somewhere in the imaginary spaces matter sufficient to compose one, and were to agitate variously and confusedly the different parts of this matter, so that there resulted a chaos as disordered as the poets ever feigned,	もし神がいま、どこか想像上の空間に、万物を生み出すに足るだけの物体を創造し、そのあちこちをいろいろな形ででたらめにかき混ぜ、詩人たちがよく言うような混沌とした無秩序なものができあがったとしたらどうだろう。
and after that did nothing more than lend his ordinary concurrence to nature, and allow her to act in accordance with the laws which he had established.	そしてその後で神は、通常の自然のふるまいに任せて、神のつくった自然法則通りにその物体が動くようにしたら、なにが起きるだろうか。
On this supposition, I, in the first place, described this matter, and essayed to represent it in such a manner that to my mind there can be nothing clearer and more intelligible, except what has been recently said regarding God and the soul;	この想定で、わたしはまずその物質を記述して、さっき神と魂について述べたことをのぞけば、これ以上わたしの精神にとって明瞭でわかりやすいことはないというくらいにそれを思い描いた。
for I even expressly supposed that it possessed none of those forms or qualities which are so debated in the schools, nor in general anything the knowledge of which is not so natural to our minds that no one can so much as imagine himself ignorant of it.	その物体がスコラ学派によっていろいろ議論されている形相や質料を何一つ持たないということもはっきりと想定し、どんな愚かな人でもそれを知らないとは想像もつかないくらい自然でない知識は、すべてないことにした。
Besides, I have pointed out what are the laws of nature;	さらに、自然法則は何かを指摘した。
and, with no other principle upon which to found my reasonings except the infinite perfection of God,	そして神が無限の完成度を持っていること以外は、なにごとも自分の理由づけの根拠とはしなかった。
I endeavored to demonstrate all those about which there could be any room for doubt, and to prove that they are such, that even if God had created more worlds, there could have been none in which these laws were not observed.	そして疑問の余地のあることはすべて証明しようとし、もし神が他の世界をつくったとしても、そういう自然法則の中でそうした世界に適用されないものなどあり得ないことを示そうとした。
Thereafter, I showed how the greatest part of the matter of this chaos must, in accordance with these laws, dispose and arrange itself in such a way as to present the appearance of heavens;	そこから、この混沌をつくる物質のかなりの部分が、こうした自然法則にしたがって分離し、配置を換えて、天のような形をどうしてもとってしまうことを示した。
how in the meantime some of its parts must compose an earth and some planets and comets, and others a sun and fixed stars.	そしてその一方では、そうした物質の一部が地球や惑星や彗星をつくり、その他の物質が太陽や恒星を作らざるを得ないかも示した。
And, making a digression at this stage on the subject of light, I expounded at considerable length what the nature of that light must be which is found in the sun and the stars, and how thence in an instant of time it traverses the immense spaces of the heavens, and how from the planets and comets it is reflected towards the earth.	そしてここで、光の話題でちょっと脇道にそれて、太陽や星で見られる光の性質とはどんなものか、それが天空の広大な空間を一瞬にして旅すること、そして惑星や彗星でそれが反射して地球に到達することなどについて、かなり長々と記述した。
To this I likewise added much respecting the substance, the situation, the motions, and all the different qualities of these heavens and stars;	さらにここに、こうした天空や星の材質、その状況、運動などさまざまな性質についても記述を加えた。
so that I thought I had said enough respecting them to show that there is nothing observable in the heavens or stars of our system that must not, or at least may not appear precisely alike in those of the system which I described.	こうすることで、天だろうと星だろうと、そこで見られることで、わたしが表現したシステムでもまったく同じようなものが観察されないもの、あるいは少なくとも、観察されないかもしれないものなど、なに一つないことをはっきり示したつもりだ。
I came next to speak of the earth in particular,	次に、地球だけについて説明をした。
and to show how, even though I had expressly supposed that God had given no weight to the matter of which it is composed, this should not prevent all its parts from tending exactly to its center;	そして、神様が地球のつくられ方について一顧だにしなかったとはっきり仮定したとしても、地球のパーツがその中心にずばり集まっていいはずなのだ。
how with water and air on its surface, the disposition of the heavens and heavenly bodies, more especially of the moon, must cause a flow and ebb,	水と空気がその表面にきて、天や天体のありかた、特に月の存在が潮の干満をつくりだす。
like in all its circumstances to that observed in our seas,	これはあらゆる状況で、この地球の海でも見られる現象だ。
as also a certain current both of water and air from east to west,	さらに水や空気の流れの一部が東から西へと向かうのも説明できる。
such as is likewise observed between the tropics;	これは、この地球でも回帰線の間で観察される。
how the mountains, seas, fountains, and rivers might naturally be formed in it, and the metals produced in the mines, and the plants grow in the fields and in general,	山や海や泉や川が、そこで自然に構成され、鉱山でとれる金属ができ植物が平原におおむね生えるのも説明できる。
how all the bodies which are commonly denominated mixed or composite might be generated	ふつうに名前のついている物体が、混合体としてであれ複合体としてであれ生じる仕組みも説明できる。
and, among other things in the discoveries alluded to inasmuch as besides the stars, I knew nothing except fire which produces light, I spared no pains to set forth all that pertains to its nature,	そして発見したことはいろいろあったけれど、星以外では光を発するものは炎しか知らないので、炎の性質に関わるものすべてを明らかにしようと、わたしは努力を惜しまなかった。
-- the manner of its production and support, and to explain how heat is sometimes found without light, and light without heat;	火をつくってそれを保つにはどうしたらいいか、そして光なしに熱が生み出されることがあるのはどうしてか、あるいは熱なしに光が出てくるのはなぜか。
to show how it can induce various colors upon different bodies and other diverse qualities;	それが他の物体にさまざまな色を生じさせられることなど、さまざまな性質を示した。
how it reduces some to a liquid state and hardens others;	火があるものは液体化してしまい、あるものは堅くすること、
how it can consume almost all bodies, or convert them into ashes and smoke;	ほとんどあらゆる者を燃やし、それを灰と煙に変えてしまえること。
and finally, how from these ashes, by the mere intensity of its action, it forms glass:	そして最後に、こうした灰から、炎のふるまいをさらに強めることで、ガラスがつくられることも示した。
for as this transmutation of ashes into glass appeared to me as wonderful as any other in nature, I took a special pleasure in describing it.	灰がガラスに変わるというのは、自然のどんな現象よりもすばらしく思えたので、これについて書くのは特に楽しかった。
I was not, however, disposed, from these circumstances, to conclude that this world had been created in the manner I described;	でもこうしたことだけから、世界がわたしの説明したような形で創造されたのだと結論づける気はない。
for it is much more likely that God made it at the first such as it was to be.	神が、最初からいまあるような形で世界を作ったという方が、ずっとありそうだからだ。
But this is certain, and an opinion commonly received among theologians, that the action by which he now sustains it is the same with that by which he originally created it;	でも、神がいまの世界を維持するためのふるまいというのは、神がそれをもともと作ったときのふるまいと同じだというのは確実であり、これは神学者たちも一般に求めている見解だ。
so that even although he had from the beginning given it no other form than that of chaos, provided only he had established certain laws of nature, and had lent it his concurrence to enable it to act as it is wont to do, it may be believed, without discredit to the miracle of creation,	だから、神がはじめに世界に混沌という形しか与えず、そこにいくつか自然法則を与えてあとは物体がそれに従って動くに任せたとしても、創造の奇跡をおとしめることなしに次のように信じることはできる。
that, in this way alone, things purely material might, in course of time, have become such as we observe them at present;	つまりそのような形でも、純粋に物質的なものが時間を経るにつれて、いまわれわれが見ているようなものとなることは可能だ、ということだ。
and their nature is much more easily conceived when they are beheld coming in this manner gradually into existence, than when they are only considered as produced at once in a finished and perfect state.	そして万物の性質は、それが一発で完成された完全な状態で作られたと想定するよりも、だんだんと現在のような存在になってきたと考えれば、もっとわかりやすくなるのである。
From the description of inanimate bodies and plants, I passed to animals, and particularly to man.	無生物や植物の記述から、わたしは動物、特に人間についての記述に進んだ。
But since I had not as yet sufficient knowledge to enable me to treat of these in the same manner as of the rest,	でも当時はまだ、こうしたものについて、これまでの対象と同じような扱いができるほど知識がなかった。
that is to say, by deducing effects from their causes, and by showing from what elements and in what manner nature must produce them,	つまり、結果から原因を導き出し、そしてどのような要素から、どのような形で自然がそれを生み出すかを示すだけの知識がなかった。
I remained satisfied with the supposition that God formed the body of man wholly like to one of ours, as well in the external shape of the members as in the internal conformation of the organs, of the same matter with that I had described,	だから神が、外見面でも内部器官の構成面でも、これまで説明してきたのと同じ物質を使ってわれわれのとまったく同じような人間の肉体を形成したものと想定することで満足していた。
and at first placed in it no rational soul, nor any other principle, in room of the vegetative or sensitive soul, beyond kindling in the heart one of those fires without light, such as I had already described,	そして神ははじめ、そこに理性ある魂も入れず、植物的あるいは感覚的な魂の代わりにそれ以外のいかなる行動原理もおかず、単に心臓に、これまで説明したような光の出ない炎をおいたのだと想定して満足していた。
and which I thought was not different from the heat in hay that has been heaped together before it is dry, or that which causes fermentation in new wines before they are run clear of the fruit.	その光の出ない炎というのは、乾燥前のわらを積み上げたときに出てくる熱や、新しいワインからブドウの実の成分を取り除いていないときに、発酵を引き起こす熱と同じものだろうと思った。
For, when I examined the kind of functions which might, as consequences of this supposition, exist in this body, I found precisely all those which may exist in us independently of all power of thinking, and consequently without being in any measure owing to the soul;	というのも、こういう想定の結果かどうかはさておき、肉体の中に存在している機能がどんなものかを検討してみると、あらゆる思考力とは無関係に存在するものばかりが見つかり、魂の働きに依存した機能はまったく見つからなかったのだ。
in other words, to that part of us which is distinct from the body, and of which it has been said above that the nature distinctively consists in thinking, functions in which the animals void of reason may be said wholly to resemble us;	つまり魂という、まさに思考という性質を持つ、肉体とは別の人間の部分に依存している機能はなく、したがって理性を持たない獣でも、われわれとまったく同じといっていい機能を持っている。
but among which I could not discover any of those that, as dependent on thought alone, belong to us as men, while, on the other hand, I did afterwards discover these as soon as I supposed God to have created a rational soul, and to have annexed it to this body in a particular manner which I described.	でも、人間たるわれわれに属しているものの中には、思考のみに依存している部分は見つけられなかったのだが、一方で神が合理的な魂を創り出して、それをわたしの説明したような形で肉体に併合したという仮定をおいてみると、そうした機能はすぐに見つかった。
But, in order to show how I there handled this matter, I mean here to give the explication of the motion of the heart and arteries,	だが、わたしがこうした事柄をどのように扱ったかを示すため、ここでは心臓と動脈の動きについて説明しよう。
which, as the first and most general motion observed in animals, will afford the means of readily determining what should be thought of all the rest.	これは動物でまず普遍的に見られる運動であり、それ以外のことすべてをどう考えるべきかを決める手段を与えてくれる。
And that there may be less difficulty in understanding what I am about to say on this subject, I advise those who are not versed in anatomy, before they commence the perusal of these observations, to take the trouble of getting dissected in their presence the heart of some large animal possessed of lungs (for this is throughout sufficiently like the human),	そしてこのテーマについてわたしが言おうとしていることを、もっと楽に理解するには、解剖学の心得のない人がこうした観察を行うに先立って、肺をもった大きな動物（これでそこそこ人間に近い存在だといえる）の心臓の解剖を実際に目の前でやってもらうことをおすすめする。
and to have shown to them its two ventricles or cavities:	そして、心臓の二つの空洞または空室を見せてもらうといい
in the first place, that in the right side, with which correspond two very ample tubes,	まずは心臓の右側にある空洞は、非常に太い2本の管に対応している。
viz., the hollow vein (vena cava), which is the principal receptacle of the blood, and the trunk of the tree, as it were, of which all the other veins in the body are branches;	その一つ目が大静脈 (vena cava)で、血液を受け取る最大の管であり、体中の静脈すべてを枝だと考えれば、いわば幹にあたるものだ。
and the arterial vein (vena arteriosa),	そしてもう一つがarterial vein (vena arteriosa) だ。
inappropriately so denominated, since it is in truth only an artery, which, taking its rise in the heart, is divided, after passing out from it, into many branches which presently disperse themselves all over the lungs;	これは名前が不適切で、実際にはただの動脈で、心臓から生じて、そこから出てくるとどんどん枝分かれして、それが肺の一面に広がっていく。
in the second place, the cavity in the left side, with which correspond in the same manner two canals in size equal to or larger than the preceding,	次に、左側の空洞は同じように、さっきと同じかそれ以上に大きい2本の通路に対応している。
viz., the venous artery (arteria venosa), likewise inappropriately thus designated,	一つがvenous artery (arteria venosa) で、これまた名前が不適切だ。
because it is simply a vein which comes from the lungs,	これは単に肺から戻ってくる静脈だからだ。
where it is divided into many branches, interlaced with those of the arterial vein, and those of the tube called the windpipe, through which the air we breathe enters;	肺では細かく枝わかれして、動脈からの血管や、われわれの呼吸する空気が通る、気管と呼ばれる管と絡み合っている。
and the great artery which, issuing from the heart, sends its branches all over the body.	そしいてもう1本が大動脈で、心臓から出て全身にその枝を送り込んでいる。
I should wish also that such persons were carefully shown the eleven pellicles which, like so many small valves, open and shut the four orifices that are in these two cavities,	また、こうした2つの空洞につながっている4つの開口部を開いたり閉じたりする、小さなバルブ上の弁が11枚あるから、それもきちんと見せてもらうようにしてほしい。
viz., three at the entrance of the hollow veins	大静脈の入り口には3枚ある。
where they are disposed in such a manner as by no means to prevent the blood which it contains from flowing into the right ventricle of the heart, and yet exactly to prevent its flowing out;	これは大静脈の中にある血が、心臓の右側の空室に入ってくるのはまったく止めない一方で、それが出ていくのはきちんと止めるようにできてる。
three at the entrance to the arterial vein, which, arranged in a manner exactly the opposite of the former,	またarterial vein (肺動脈）の入り口にも3枚あって、大静脈の場合とは正反対についている。
readily permit the blood contained in this cavity to pass into the lungs, but hinder that contained in the lungs from returning to this cavity;	この空室の中の血液が肺のほうに向かうのは許すけれど、でも肺の方から心室に戻ってくるのは防ぐわけだ。
and, in like manner, two others at the mouth of the venous artery,	同じように、肺からの血を心臓の左心室に送り込むvenous artery（肺静脈）の入り口にも弁が2つある。
which allow the blood from the lungs to flow into the left cavity of the heart, but preclude its return;	血が入ってくるのは許すが、戻るのは許さない。
and three at the mouth of the great artery,	そして大動脈の入り口にも3つある。
which suffer the blood to flow from the heart, but prevent its reflux.	こちらは血が流れ出すのは認めるけれど、逆流は許さない。
Nor do we need to seek any other reason for the number of these pellicles beyond this	弁の数がそれぞれちがっている理由も、あえて考えるまでもないだろう。
that the orifice of the venous artery being of an oval shape from the nature of its situation, can be adequately closed with two, whereas the others being round are more conveniently closed with three.	venous artery（肺静脈）の開口部は、その役割の性質から楕円形になっているので、弁が2つできちんと閉じられるのだが、それ以外の開口部は円形なので、3つあったほうが閉じやすいのだ。
Besides, I wish such persons to observe that the grand artery and the arterial vein are of much harder and firmer texture than the venous artery and the hollow vein;	あと、大動脈とarterial vein（肺動脈）が、venous artery（肺静脈）や大静脈よりもずっとしっかりとして高密な材質からできているのも見てほしい。
and that the two last expand before entering the heart, and there form, as it were, two pouches denominated the auricles of the heart, which are composed of a substance similar to that of the heart itself;	そして後二者が、心臓に入る前に広がって、心耳と呼ばれる2つの袋のようになっていて、それが心臓そのものと似た物質でできていることを見てほしいと思う。
and that there is always more warmth in the heart than in any other part of the body	さらに心臓は全身のなかで一番熱いことも知っておこう
- and finally, that this heat is capable of causing any drop of blood that passes into the cavities rapidly to expand and dilate,	――この熱のおかげで、心臓の空洞部に入ってくる血液はすべてふくれて膨張するわけだ。
just as all liquors do when allowed to fall drop by drop into a highly heated vessel.	ちょうど高熱の容器に酒を一滴ずつたらしたときに、それがふくれて膨張するのと同じことだ。
For, after these things, it is not necessary for me to say anything more with a view to explain the motion of the heart,	これだけ言えば、わたしが心臓の動きについてこれ以上の説明をする必要もないだろう。
except that when its cavities are not full of blood, into these the blood of necessity flows,	心臓の空洞部が血で満たされていないと、必要な血液がそこに流れ込むのだ
-- from the hollow vein into the right, and from the venous artery into the left;	――大静脈から心臓の右へ、そしてvenous artery（肺静脈）から左へ。
because these two vessels are always full of blood, and their orifices, which are turned towards the heart, cannot then be closed.	そしてこの二つの血管はいつも血でいっぱいであり、心臓部へと向けられたその開口部は閉じることができない。
But as soon as two drops of blood have thus passed,	しかしそこを血が二滴通ってくる。
one into each of the cavities, these drops which cannot but be very large,	（つまり左右の心臓の空洞にそれぞれ一つずつ）、こうした血液の滴はとても大きなものであろう。
because the orifices through which they pass are wide, and the vessels from which they come full of blood,	それが通ってくる開口部がとても広いからで、さらにそれがやってくる血管は、血でいっぱいだからだ。
are immediately rarefied, and dilated by the heat they meet with.	するとその心臓に入ってきた血は、そこで出会う熱ですぐに希薄化されて、膨張するわけだ
In this way they cause the whole heart to expand, and at the same time press home and shut the five small valves that are at the entrances of the two vessels from which they flow, and thus prevent any more blood from coming down into the heart,	こうしてそれは心臓全体を拡大させ、そして同時に、こうした血管の入り口にある小さなバルブ5つを圧迫して閉じさせ、それ以上の血が心臓に入ってこないようにする。
and becoming more and more rarefied, they push open the six small valves that are in the orifices of the other two vessels, through which they pass out,	そしてどんどん希薄化するうちに、それは残り二つの血管にある小さなバルブ6つを押し開け、そこを通って出ていく。
causing in this way all the branches of the arterial vein and of the grand artery to expand almost simultaneously with the heart	これによって、arterial vein（肺動脈）と大動脈の枝が心臓とほぼ同時に拡張する。
which immediately thereafter begins to contract, as do also the arteries,	心臓はその直後に収縮をはじめ、動脈もいっしょに収縮する。
because the blood that has entered them has cooled,	そこに入ってきた血が冷えるからだ。
and the six small valves close, and the five of the hollow vein and of the venous artery open anew and allow a passage to other two drops of blood,	すると小さな6つのバルブが閉じて、大静脈と venous artery（肺静脈）の入り口のバルブが改めて開いて、血がもう二滴入ってくるのを許す。
which cause the heart and the arteries again to expand as before.	これでまた心臓と動脈がさっきのように膨張するわけだ。
And, because the blood which thus enters into the heart passes through these two pouches called auricles,	そして、このように心臓に入ってくる血は、心耳と呼ばれる袋をそれぞれ通ってくる。
it thence happens that their motion is the contrary of that of the heart,	そしてこの心耳の動きは心臓の動きと正反対になっている。
and that when it expands they contract.	心臓が膨張すると、心耳は収縮する。
But lest those who are ignorant of the force of mathematical demonstrations and who are not accustomed to distinguish true reasons from mere verisimilitudes, should venture. without examination, to deny what has been said, I wish it to be considered that the motion which I have now explained follows as necessarily from the very arrangement of the parts,	でも数学的な証明の力を知らない者たちや、本当の理由づけと、単なるもっともらしさとを見分けるのになれていない人たちが、よく検討もしないでこれまで述べてきたことを否定しようなどという気を起こさないように言っておくけれど、ここでいま説明した動きというのは、そのパーツの仕組みからまさに必然的に出てくるものなのだ。
which may be observed in the heart by the eye alone, and from the heat which may be felt with the fingers, and from the nature of the blood as learned from experience,	その配置は、実際の心臓を目で観察しなければわからないし、熱は指で触れてみなければわからないし、さらに血の性質は経験からわかる。
as does the motion of a clock from the power, the situation, and shape of its counterweights and wheels.	それは時計の動きが、おもりや歯車の動力や配置、形などから明らかに導かれるのと同じことだ。
But if it be asked how it happens that the blood in the veins, flowing in this way continually into the heart, is not exhausted, and why the arteries do not become too full, since all the blood which passes through the heart flows into them,	でも、どうして血管の中の血は、こうやって絶えず心臓に流れ込んでいるのになくならないんだろうか、そしてなぜ、その心臓を通って血が流れ込む動脈が満杯になってしまわないんだろうか。
I need only mention in reply what has been written by a physician 1 of England,	これに答えるには、イギリスのある医師が書いたものを示すだけですむ。
who has the honor of having broken the ice on this subject,	かれは、この問題について突破口を見出すという名誉をものにしている。
and of having been the first to teach that there are many small passages at the extremities of the arteries, through which the blood received by them from the heart passes into the small branches of the veins, whence it again returns to the heart;	動脈の先っぽにはさらにもっと小さな通路が続いていて、心臓から動脈に流れこんだ血は、血管の小さな枝に入っていって、そしてそれがまた心臓に戻ってくるのだ、ということを初めて教えたのがこのイギリス人だ。
so that its course amounts precisely to a perpetual circulation.	だからそれは結局、まさにいつまでも循環し続けることになる。
Of this we have abundant proof in the ordinary experience of surgeons,	もちろんこれは、外科医たちの日常的な経験からもたっぷり証拠がある。
who, by binding the arm with a tie of moderate straitness above the part where they open the vein, cause the blood to flow more copiously than it would have done without any ligature;	腕の静脈を開いて、その傷より上のところにそこそこまっすぐな棒をしばって、あまりきつくねじらないでおくと、血はそういう止血棒なしのときよりも勢いよく流れる。
whereas quite the contrary would happen were they to bind it below;	そして傷より下のところをしばると、逆がおこる。
that is, between the hand and the opening,	傷より下というのはつまり、手と傷との間ということだ。
or were to make the ligature above the opening very tight.	あるいは、傷より上を縛るときに非常にきつくしばった場合もそうだ。
For it is manifest that the tie, moderately straightened, while adequate to hinder the blood already in the arm from returning towards the heart by the veins, cannot on that account prevent new blood from coming forward through the arteries,	止血棒がそこそこまっすぐたと、それはすでに腕に入っていて、静脈経由で心臓に戻ろうとしている血は止めてしまうけれど、動脈から新しい血が入ってくるのは止められない。
because these are situated below the veins, and their coverings, from their greater consistency, are more difficult to compress;	動脈は静脈より下にあるし、それを覆っている組織も密度が高いので、圧迫するのがむずかしいからだ。
and also that the blood which comes from the heart tends to pass through them to the hand with greater force than it does to return from the hand to the heart through the veins.	そしてさらに、心臓から動脈を通って手に達する血の圧力は、手から静脈を通って心臓に戻る力よりも強いこともある。
And since the latter current escapes from the arm by the opening made in one of the veins, there must of necessity be certain passages below the ligature, that is, towards the extremities of the arm through which it can come thither from the arteries.	静脈のほうの流れは、静脈にできた開口部から流れ出てしまうので、止血棒より下、つまりは腕の先端側に向かって、血が動脈から入ってくるような通路が必然的になくてはならないわけだ。
This physician likewise abundantly establishes what he has advanced respecting the motion of the blood, from the existence of certain pellicles, so disposed in various places along the course of the veins,	同じようにこの医師は、静脈の中のあちこちに配置された薄膜の存在をもとに、血液の動きについてつきとめ、豊富な証拠をもとに明確にしている。
in the manner of small valves, as not to permit the blood to pass from the middle of the body towards the extremities, but only to return from the extremities to the heart;	こうした薄膜は小さなバルブのように機能して、血が身体の奥から外側に向けて流れるのを許さずに、外側から心臓に戻るのだけを許しようになっているわけだ。
and farther, from experience which shows that all the blood which is in the body may flow out of it in a very short time through a single artery that has been cut,	そして経験的に言って、動脈が一本切られただけで、体内の血液すべてがごく短時間に流れ出してしまう。
even although this had been closely tied in the immediate neighborhood of the heart and cut between the heart and the ligature,	これは、心臓のすぐ近くをしばって、心臓と止血帯との間で切った場合でも成り立つ。
so as to prevent the supposition that the blood flowing out of it could come from any other quarter than the heart.	ということは、その傷から流れ出す血は心臓以外のところからくることはあり得ないことになる。
But there are many other circumstances which evince that what I have alleged is the true cause of the motion of the blood:	ここでわたしが主張しているものこそが、血液の流れの真の原因だということを証拠づける事例は、他にもいろいろある。
thus, in the first place, the difference that is observed between the blood which flows from the veins, and that from the arteries, can only arise from this, that being rarefied, and, as it were, distilled by passing through the heart, it is thinner, and more vivid, and warmer immediately after leaving the heart, in other words, when in the arteries, than it was a short time before passing into either, in other words, when it was in the veins;	たとえばまず、静脈に流れる血液と、動脈から流れる血とで見られるちがいは、それが純化され、まるで心臓を通ることで蒸留されているかのようで、心臓から出てきた直後（つまりは動脈内にあるとき）のほうが、心臓に戻る直前（つまりは静脈内にあるとき）もっと薄く、もっとサラサラして暖かい。
and if attention be given, it will be found that this difference is very marked only in the neighborhood of the heart;	そしてきちんと観察すれば、このちがいが際だっているのは心臓のすぐ近くだけだというのがわかる。
and is not so evident in parts more remote from it.	心臓からもっと離れてくると、ちがいは少なくなってくる。
In the next place, the consistency of the coats of which the arterial vein and the great artery are  composed, sufficiently shows that the blood is impelled  against them with more force than against the veins.	次に、動脈と、大動脈ができている血管の壁の密度を見ると、静脈と比べてこちらのほうが、高い圧力の血液が押し付けられるようになっていることを充分に示している。
And why should the left cavity of the heart and the  great artery be wider and larger than the right cavity and the arterial vein,	そして、心臓の左の空洞と大動脈は、なぜ右の空洞と大静脈よりも広くて大きいのだろうか。
were it not that the blood of the  venous artery, having only been in the lungs after it has passed through the heart, is thinner, and rarefies more readily, and in a higher degree, than the blood which proceeds immediately from the hollow vein?	それは静脈の中の血が、心臓を通ってから肺を受けてきただけなので、大静脈から戻ってきたばかりの血よりも薄く、もっと簡単かつ高度に純化されるからとしか考えられない。
And what can physicians conjecture from feeling the pulse unless they know that according as the blood changes its nature it can be rarefied by the warmth of the heart, in a higher or lower degree, and more or less quickly than before?	そして医師たちは脈をはかるけれど、血が性質を変えるにつれて、心臓の暖かみによって多かれ少なかれ純化され、前よりも速度が速まったり遅くなったりするのでなければ、あれでなにがわかるのだろうか。
And if it be inquired how this heat is communicated to the other members, must it not be admitted that this is effected by means of the blood, which, passing through the heart, is there heated anew, and thence diffused over all the body?	そしてこの熱がほかの機関にどのように伝えられるかを考えるなら、これが血によって行われるのであり、心臓を通ることで新しく暖めなおされて、それが全身に伝えられるのだと認めざるを得ないだろう
Whence it happens, that if the blood be withdrawn from any part, the heat is likewise withdrawn by the same means;	もし血がどこからか抜かれるようなことがあれば、熱もまたいっしょに抜かれることになる。
and although the heart were as-hot as glowing iron, it would not be capable of warming the feet and hands as at present, unless it continually sent thither new blood.	そして心臓は赤熱する鉄のように熱くても、新しい血を絶えず送り続けないと、手足を温めることはできない。
We likewise perceive from this, that the true use of respiration	同じように、呼吸の真の機能もこれでわかる。
is to bring sufficient fresh air into the lungs,	呼吸は肺に新鮮な空気を十分に送り込む。
to cause the blood which flows into them from the right ventricle of the heart, where it has been rarefied and, as it were, changed into vapors, to become thick, and to convert it anew into blood, before it flows into the left cavity,	そして心臓の右心室で薄められ、いわば蒸気状になった血が肺に流れ込んできたときに、それがそこで濃くなって真新しい血に変換され、心臓の左側の空洞に流れ込むことになるのだ。
without which process it would be unfit for the nourishment of the fire that is there.	このプロセスがなければ、その血液はそこにある火を養う役割を果たせなくなってしまう。
This receives confirmation from the circumstance,	これには状況証拠もある。
that it is observed of animals destitute of lungs that they have also but one cavity in the heart,	肺を持たない動物は、心臓には心室が一つしかない。
and that in children who cannot use them while in the womb, there is a hole through which the blood flows from the hollow vein into the left cavity of the heart, and a tube through which it passes from the arterial vein into the grand artery without passing through the lung.	また子宮内にいるときには子供は肺を使えないので、大静脈から心臓の左心室に血液を流すための穴があり、それがarterial vein（肺動脈）から大動脈へと肺を経由せずに流れ込むための管がある。
In the next place, how could digestion be carried on in the stomach unless the heart communicated heat to it through the arteries, and along with this certain of the more fluid parts of the blood,	さらには、心臓が動脈を通じて熱を伝え、同時にもっとサラサラした血を送り込まなければ、腹で消化を行うこともできない。
which assist in the dissolution of the food that has been taken in?	その血が、食べたばかりの食物を溶かすのに役立つわけだ。
Is not also the operation which converts the juice of food into blood easily comprehended, when it is considered that it is distilled by passing and repassing through the heart perhaps more than one or two hundred times in a day?	さらに、血液が心臓を一日に100回か200回ほど通過することで蒸留されるということを考えれば、食物の汁が血に変換される仕組みも、すぐに理解できるではないか。
And what more need be adduced to explain nutrition, and the production of the different humors of the body, beyond saying,	そして滋養と、肉体のさまざまな気質の発生についても、簡単にわかるだろう。
that the force with which the blood, in being rarefied, passes from the heart towards the extremities of the arteries, causes certain of its parts to remain in the members at which they arrive, and there occupy the place of some others expelled by them;	血液が希薄化されて、心臓から動脈の末端にまで移動する力のおかげで、滋養の一部が到達したいろんな器官の中に残り、そして器官が排出したものの場所にとってかわるわけだ。
and that according to the situation, shape, or smallness of the pores with which they meet, some rather than others flow into certain parts,	そしてそこで滋養が出会う穴の状態や形や大きさのおかげで、特定の滋養だけが特定の場所に送り込まれることになる。
in the same way that some sieves are observed to act, which, by being variously perforated, serve to separate different species of grain?	これはふるいの穴をいろいろ変えることで、さまざまな穀物をふるいわけられるのと同じことではないか。
And, in the last place, what above all is here worthy of observation, is the generation of the animal spirits,	そして最後に、なによりも見て取る価値があると思われることだが、動物霊気の生成について記述した。
which are like a very subtle wind, or rather a very pure and vivid flame which, continually ascending in great abundance from the heart to the brain, thence penetrates through the nerves into the muscles, and gives motion to all the members;	これはとてもかすかな風か、あるいは非常に純粋で鮮明な炎のようなもので、絶えず心臓と脳から大量に送り出され続けていて、神経を通じて筋肉に送られ、すべての肉体器官に動きをもたらすものである。
so that to account for other parts of the blood which, as most agitated and penetrating, are the fittest to compose these spirits, proceeding towards the brain, it is not necessary to suppose any other cause, than simply, that the arteries which carry them thither proceed from the heart in the most direct lines,	血液のほかの部分のうち、いちばん勢いよく活力があって、こうした霊気を創り出すにふさわしいものは脳に向かう血液だが、これを説明するには、それを運ぶ動脈がいちばんまっすぐであることを原因として認識すればすむわけだ。
and that, according to the rules of mechanics which are the same with those of nature, when many objects tend at once to the same point where there is not sufficient room for all (as is the case with the parts of the blood which flow forth from the left cavity of the heart and tend towards the brain), the weaker and less agitated parts must necessarily be driven aside from that point by the stronger	自然に見られるのと同じ力学の働きによって、多くの物体が一カ所に集中する時には、そのすべてをおさめられるだけの場所がないため（これは左心室から流れ出て脳に向かう血液についていえる）、弱くて活力のない部分は必然的に脇に押しやられて、強いものだけがそこを通るようになるわけだ。
which alone in this way reach it I had expounded all these matters with sufficient minuteness in the treatise which I formerly thought of publishing.	わたしはこういう事柄すべてを、じゅうぶんな詳細さをもって、もともと刊行しようと思っていた論文で説明したのである。
And after these, I had shown what must be the fabric of the nerves and muscles of the human body to give the animal spirits contained in it the power to move the members,	そして続いてわたしは、肉体の中にある動物の霊気が、その肉体器官を動かす力をもつためには、人間の神経や筋肉がどのように織りなされなくてはならないかを示した。
as when we see heads shortly after they have been struck off still move and bite the earth, although no longer animated;	これは人の首がはねられてからも、その首が生きてもいないのにしばらくは動いて地面を噛んだりすることからもわかる。
what changes must take place in the brain to produce waking, sleep, and dreams;	あるいは、目をさましたり、眠ったり、夢をみたりするためには脳の中でどんな変化が起きる必要があるかも書いた。
how light, sounds, odors, tastes, heat, and all the other qualities of external objects impress it with different ideas by means of the senses;	光や音やにおい、味、熱など、外部の物体が持つ性質が、感覚を通じて脳にさまざまな概念を与えること。
how hunger, thirst, and the other internal affections can likewise impress upon it divers ideas;	飢え、乾きなど、体内の欲求が同じように脳にさまざまな概念を与えること。
what must be understood by the common sense (sensus communis) in which these ideas are received,	こうした概念が受け取られたときに、通常の感覚 (sensus communis) はなにを理解しなくてはならないか。
by the memory which retains them, by the fantasy which can change them in various ways, and out of them compose new ideas,	あるいはそれを蓄える記憶にはなにが必要か、そしてそれを様々な形で変えてしまう空想にはなにが必要か、そしてそこから新しい考えを生み出すにはなにが要るか。
and which, by the same means, distributing the animal spirits through the muscles, can cause the members of such a body to move in as many different ways, and in a manner as suited, whether to the objects that are presented to its senses or to its internal affections, as can take place in our own case apart from the guidance of the will.	そして同じやりかたで動物霊気を筋肉に配分することにより、肉体のいろいろな部分がわれわれの意志に導かれないような場合でも、感覚に示された物体や内的な欲求にしたがって、さまざまにちがった形で動くようになることもしめした。
Nor will this appear at all strange to those who are acquainted with the variety of movements performed by the different automata,	これは、いろいろな¥ruby{自動人形}{オートマトン}のさまざまな動きになじみのある人なら、あまり不思議とも思わないだろう。
or moving machines fabricated by human industry,	あるいは人間の産業で製造されている、動く機械を見てもわかる。
and that with help of but few pieces compared with the great multitude of bones, muscles, nerves, arteries, veins, and other parts that are found in the body of each animal.	こうした人形や機械は、動物の大量の骨や筋肉や神経、動脈、静脈などの部品と比べて、ごく少数の部品だけでそういう動きを実現している。
Such persons will look upon this body as a machine made by the hands of God,	そういう人々は、動物の肉体を見て、神の手が作った機械だと考えるだろう。
which is incomparably better arranged, and adequate to movements more admirable than is any machine of human invention.	機械としては比較にならないほど緻密に構成されていて、運動に対する適正は人間の発明したどんな機械より見事だというだけだ。
And here I specially stayed to show that,	そしてここでわたしが示したいのは次のようなことだ。
were there such machines exactly resembling organs and outward form an ape or any other irrational animal, we could have no means of knowing that they were in any respect of a different nature from these animals;	サルなどの理性を持たない動物の器官や外形を正確にまねた機械があったとしたら、われわれはそれがこういう動物とは別の性質を持っているということは、いっさい知りようがない。
but if there were machines bearing the image of our bodies, and capable of imitating our actions as far as it is morally possible, there would still remain two most certain tests whereby to know that they were not therefore really men.	しかしもしわれわれの姿に似せた機械があって、それがわれわれのふるまいを、事実上可能な限りまねできたとしても、それが人間でないと判断できる、きわめて確実な試験方法が二つ残るのである。
Of these the first is that they could never use words or other signs arranged in such a manner as is competent to us in order to declare our thoughts to others:	このうちまず最初のものは、獣たちは、他者に対して思考を伝えるような形では、ことばなどの記号を並べることが絶対にできない、ということだ。
for we may easily conceive a machine to be so constructed that it emits vocables, and even that it emits some correspondent to the action upon it of external objects which cause a change in its organs;	単語を発するように作られた機械を考えるのは簡単だし、その発しかたが、外部の物体によって内部器官に変化が加えられるのに応じて変わるようなものですら可能だろう。
for example, if touched in a particular place it may demand what we wish to say to it;	たとえば、もしある特定の場所にふれたら、望みを言えと要求し、
if in another it may cry out that it is hurt, and such like;	別のところにさわったら痛いと叫ぶ、といったような機械だ。
but not that it should arrange them variously so as appositely to reply to what is said in its presence,	でも、そのことばをいろいろ変えて配置して、それに対して言われたことにきちんと返答するような機械はできない。
as men of the lowest grade of intellect can do.	知性が最低の人間であっても、そのくらいはできる。
The second test is, that although such machines might execute many things with equal or perhaps greater perfection than any of us, they would, without doubt, fail in certain others	第二の試験は、そうした機械はいろいろなことを、人間と同じくらいの完成度で、いやそれ以上の完成度をもって実行できるだろうけれど、それはまちがいなく他のことでは失敗するだろうということだ。
from which it could be discovered that they did not act from knowledge, but solely from the disposition of their organs:	ここから、その機械が知識に基づいて動いているのではなく、その器官の仕組みに応じて動いているだけだ、ということが発見できる。
for while reason is an universal instrument that is alike available on every occasion, these organs, on the contrary, need a particular arrangement for each particular action;	理性というのは普遍的な仕組みであって、あらゆる状況に適用できるけれど、そうした器官というのは個別の行動について、特定のしつらえが必要になるわけだ。
whence it must be morally impossible that there should exist in any machine a diversity of organs sufficient to enable it to act in all the occurrences of life, in the way in which our reason enables us to act.	だから、われわれの理性が可能にしているような形で、人生のあらゆる状況に対応を可能とするような器官の多様性をもった機械というのは、道徳的にも存在し得ないはずだ。
Again, by means of these two tests we may likewise know the difference between men and brutes.	この2つの試験の結果として、人間と獣のちがいもわかるはずだ。
For it is highly deserving of remark, that there are no men so dull and stupid, not even idiots, as to be incapable of joining together different words, and thereby constructing a declaration by which to make their thoughts understood;	どんなに愚かで魯鈍な人間でも、ことばをつなぎあわせて、思考を理解させるような宣言を作れないような人間はいない。
and that on the other hand, there is no other animal, however perfect or happily circumstanced, which can do the like.	ところが一方では、どんなに完全で恵まれた環境におかれても、そんなことができる動物はいないのである。
Nor does this inability arise from want of organs:	そしてしゃべれないのは、別に器官がないせいではない。
for we observe that magpies and parrots can utter words like ourselves, and are yet unable to speak as we do,	九官鳥やオウムは、人間と同じようなことばを発することができるけれど、でも人間のようにしゃべることはできない。
that is, so as to show that they understand what they say;	つまり自分の言っていることを理解していることを示せない。
in place of which men born deaf and dumb, and thus not less, but rather more than the brutes, destitute of the organs which others use in speaking, are in the habit of spontaneously inventing certain signs by which they discover their thoughts to those who, being usually in their company, have leisure to learn their language.	ところがつんぼで愚鈍に生まれついた人は、しゃべるための器官の欠如という点では獣よりひどいわけだが、それでも独自になんらかの身振りを発明して、かれらの言語を学ぶだけの余裕がある者、通常は身のまわりの者たちに、自分の考えを表明できるようになるのである。
And this proves not only that the brutes have less reason than man,	そしてここから証明されるのは、獣は人間より理性が少ないというだけではない。
but that they have none at all:	獣には理性がまったくない、ということが証明されるのだ。
for we see that very little is required to enable a person to speak;	というのも、人がしゃべれるために必要なものは実にわずかだ、というのはわかる。
and since a certain inequality of capacity is observable among animals of the same species, as well as among men,	そして、人間たちの中でもいろいろ能力の差があるように、動物の同じ種の中でも、ある程度の能力差は見られる。
and since some are more capable of being instructed than others, it is incredible that the most perfect ape or parrot of its species, should not in this be equal to the most stupid infant of its kind or at least to one that was crack-brained,	そして中には仕込みやすいものもいるのを考えると、サルやオウムの中でもっとも完成されたものが、人間のもっとも愚鈍な子供や、脳障害のある子供にすら匹敵するものとならないのは、驚くべきことだろう。
unless the soul of brutes were of a nature wholly different from ours.	これは、獣の魂が本質的に、人間の魂とはまったくちがっているからだと考えるしかない。
And we ought not to confound speech with the natural movements which indicate the passions,	そして、しゃべることと、感情を示す自然な運動とを近藤してはならない。
and can be imitated by machines as well as manifested by animals;	そういう運動のほうは、動物も示すが機械で簡単にまねできるのだ。
nor must it be thought with certain of the ancients, that the brutes speak, although we do not understand their language.	また古人のように、獣たちはしゃべるのだけれど、われわれにその言語が理解できないだけだと考えてもいけない。
For if such were the case, since they are endowed with many organs analogous to ours, they could as easily communicate their thoughts to us as to their fellows.	というのも、もしそれが事実なら、獣たちはわれわれと似たような器官をたくさん与えられているのだから、仲間として自分の考えをわれわれに楽に伝えることができるはずだろう。
It is also very worthy of remark, that, though there are many animals which manifest more industry than we in certain of their actions, the same animals are yet observed to show none at all in many others:	さらに行動の一部の面では、われわれよりずっと活発に動く動物たちはたくさんいるけれど、その動物たちも、ほかの多くの面ではまったく活動を見せてくれないのである。
so that the circumstance that they do better than we does not prove that they are endowed with mind,	だからかれらがある面でわれわれより優れているというのは、かれらに精神が備わっているという証明にはならない。
for it would thence follow that they possessed greater reason than any of us, and could surpass us in all things;	もしそうなったら、動物たちのほうがわれわれのだれよりも高い理性を備えていて、あらゆる面でわれわれを上回っているはずだからだ。
on the contrary, it rather proves that they are destitute of reason,	むしろそれは、かれらに理性が欠けているということを証明しているのだ。
and that it is nature which acts in them according to the disposition of their organs:	そしてその器官の命ずるままに動くのが動物の天性なのだということになる。
thus it is seen, that a clock composed only of wheels and weights can number the hours and measure time more exactly than we with all our skin.	つまり歯車やおもりだけでできている時計のほうが、これだけの皮膚を備えたわれわれよりも正確に時を刻み、時間をはかれることからも、これはわかるだろう。
I had after this described the reasonable soul, and shown that it could by no means be educed from the power of matter, as the other things of which I had spoken,	こうしてわたしは、まともな魂というものを説明し、それがほかのところで説明したような物質の力だけからは、絶対に導けないのを示した。
but that it must be expressly created;	それは独立に創られなくてはならないのだ。
and that it is not sufficient that it be lodged in the human body exactly like a pilot in a ship, unless perhaps to move its members,	そして、単に四肢を動かすだけならともかく、それが船の航海士のように肉体の中に置かれるだけでは不十分だということも示した。
but that it is necessary for it to be joined and united more closely to the body, in order to have sensations and appetites similar to ours, and thus constitute a real man.	人間のような感覚や欲求を持つ、本物の人間をつくるためには、その魂が肉体ともっと密接に結びついて統合されなくてはならない。
I here entered, in conclusion, upon the subject of the soul at considerable length, because it is of the greatest moment:	結局わたしがここで、魂のことについて長々と書いてきたのは、それがいちばん火急の問題だからだ。
for after the error of those who deny the existence of God, an error which I think I have already sufficiently refuted, there is none that is more powerful in leading feeble minds astray from the straight path of virtue than the supposition that the soul of the brutes is of the same nature with our own;	神の存在を否定する者たちの誤り（この誤りについては、すでに十分に反論をしたつもりだ）をのぞけば、獣たちの魂がわれわれの魂と同じ性質のものだという思いこみほど強力に、弱い精神を惑わして美徳のまっすぐな道からはずれさせてしまうものはないからだ。
and consequently that after this life we have nothing to hope for or fear, more than flies and ants;	そういう思いこみがあるとすぐに、この人生が終わってしまえば、ハエやアリと同じでその後にはなにも期待できず、またおそれるものもないのだ、という考えが出てきてしまう。
in place of which, when we know how far they differ we much better comprehend the reasons which establish that the soul is of a nature wholly independent of the body, and that consequently it is not liable to die with the latter	ところが、人間と獣の魂がどんなにちがっているかがわかれば、魂がその性質からして肉体とはまったく独立している理由がはっきりわかり、だから肉体といっしょに死んでしまうようなこともないのもわかる。
and, finally, because no other causes are observed capable of destroying it,	というのも魂を破壊できるような力を持つ原因は一つも観察されていないからだ。
we are naturally led thence to judge that it is immortal.	よってわれわれは、魂が不死であるという判断にたどりつくことになる。
PART VI	第 6 部
Three years have now elapsed since I finished the treatise containing all these matters;	こういう話をすべて書いた論文を完成させてから、もう3年たった。
and I was beginning to revise it, with the view to put it into the hands of a printer, when I learned that persons to whom I greatly defer, and whose authority over my actions is hardly less influential than is my own reason over my thoughts, had condemned a certain doctrine in physics,	そしてそろそろ印刷業者に渡そうかと思って改訂を始めたところで、わたしが大いに敬意を表し、わが理性が思考に与えるのと同じくらいの権威をわが行動に与えている人々が、ある物理学の説を糾弾したという話をきいた。
published a short time previously by another individual to which I will not say that I adhered,	この学説はある人がしばらく前に出版したものだったのだけれど、わたしはその学説を支持しているとは言わない。
but only that, previously to their censure I had observed in it nothing which I could imagine to be prejudicial either to religion or to the state, and nothing therefore which would have prevented me from giving expression to it in writing, if reason had persuaded me of its truth;	でも、こうして検閲される前にわたしが見た限りでは、そこには宗教に対しても国家に対しても、偏向していると思えるようなところはいっさい見あたらなかったし、理性的に考えてそれが真実だと思ったら、そう書き記すことをためらうべき理由はいっさい見あたらなかった。
and this led me to fear lest among my own doctrines likewise some one might be found in which I had departed from the truth, notwithstanding the great care I have always taken not to accord belief to new opinions of which I had not the most certain demonstrations, and not to give expression to aught that might tend to the hurt of any one.	わたしは新しい見解は非常に確実な実証がなくては採用しないように細心の注意をはらい、記述についても、だれも傷つけないよう念を入れている。
This has been sufficient to make me alter my purpose of publishing them;	この一件で、出版しようという目標は捨てることにした。
for although the reasons by which I had been induced to take this resolution were very strong, yet my inclination, which has always been hostile to writing books,	出版しようという決意にいたった理由づけはとても強力ではあったけれど、もともと本を書くというのはあまり気がすすまないことだったのだ。
enabled me immediately to discover other considerations sufficient to excuse me for not undertaking the task.	この性向のおかげで、出版作業に手をつけない口実となるような、他の関心事がすぐに見つかった。
And these reasons, on one side and the other, are such, that not only is it in some measure my interest here to state them, but that of the public, perhaps, to know them.	そしてこういう理由というのは、なんのかのいってわたしとしても描いておきたいことだし、世間的にも知っておくほうが利益になるようなものだからだ。
I have never made much account of what has proceeded from my own mind;	わたしは、自分の精神から生まれ出たものについて、あまり考えたことがない。
and so long as I gathered no other advantage from the method I employ beyond satisfying myself on some difficulties belonging to the speculative sciences, or endeavoring to regulate my actions according to the principles it taught me, I never thought myself bound to publish anything respecting it.	自分としては、思弁科学に属するいくつかの問題について自分を満足させたり、それが教えてくれる原理にしたがって自分の行動を律したりする以外には、自分の使う手法からなんのメリットも得ていない以上、それについてなにかを出版すべきだなどと考えたこともない。
For in what regards manners, every one is so full of his own wisdom,	振る舞いに関する限り、みんなそれぞれ一家言を持っている。
that there might be found as many reformers as heads, if any were allowed to take upon themselves the task of mending them,	だから、人の振る舞いを改めていいことになったら、それこそ人の数だけ改革者が出てくるだろう。
except those whom God has constituted the supreme rulers of his people or to whom he has given sufficient grace and zeal to be prophets;	だからそんな仕事は、神が民草の大いなる支配者に任命した人か、あるいは優雅さと情熱を与えられて預言者となる人々だけがやればいい。
and although my speculations greatly pleased myself, I believed that others had theirs, which perhaps pleased them still more.	わたしの思弁は、自分自身を大いに満足させてはくれたけれど、ほかの人は、これよりもっと満足できるような思弁を持っているのだろうと思った。
But as soon as I had acquired some general notions respecting physics, and beginning to make trial of them in various particular difficulties, had observed how far they can carry us, and how much they differ from the principles that have been employed up to the present time,	でも、物理に関する一般原則を考えついて、それを個別のいろんな問題で試してみると、それがいかに広く適用できるかはすぐにわかったし、それがいままで使われてきたいろんな原理とどれほど異なっているかもわかってしまった。
I believed that I could not keep them concealed without sinning grievously against the law by which we are bound to promote, as far as in us lies, the general good of mankind.	だから、これを隠しておくことは、できるだけ人類の福祉を推進すべきだという法に対する憂慮すべき罪になると感じた。
For by them I perceived it to be possible to arrive at knowledge highly useful in life;	わたしの考えついた原則を使えば、人生においてとても役にたつ知識に到達することが可能だと思えたし、
and in room of the speculative philosophy usually taught in the schools, to discover a practical, by means of which, knowing the force and action of fire, water, air the stars, the heavens, and all the other bodies that surround us, as distinctly as we know the various crafts of our artisans, we might also apply them in the same way to all the uses to which they are adapted, and thus render ourselves the lords and possessors of nature.	学校でふつうは教わる思弁的な哲学のかわりに、火や水や星や天など、われわれを取り巻くすべての物体の力とふるまいを、われらが工匠たちのさまざまな技巧を理解するくらいきちんと理解するための現実的な手段を発見できるようになるとも感じ、それをそうした物体が使われるあらゆる場面で同じように追うようして、われわれを自然の主にして所有者とすることができるだろうと思った。
And this is a result to be desired,	そしてこれは、望ましい結果だろう。
not only in order to the invention of an infinity of arts, by which we might be enabled to enjoy without any trouble the fruits of the earth, and all its comforts, but also and especially for the preservation of health,	これは無数の技芸を産み出して、この世の果実や快適さをなんの苦労もなく楽しむためというだけでなく、健康を保つためにも（いやそのためにこそ）望ましい。
which is without doubt, of all the blessings of this life, the first and fundamental one;	健康というのは、この人生での祝福のうち、一番の、もっとも根本的なものだ。
for the mind is so intimately dependent upon the condition and relation of the organs of the body, that if any means can ever be found to render men wiser and more ingenious than hitherto, I believe that it is in medicine they must be sought for.	というのも、精神というのは肉体器官の状況や関係に実に密接に依存しているから、人間を今よりもっと賢く器用にするための方法が見つかるものならば、それは医学分野に求めなくてはならないと思うのだ。
It is true that the science of medicine, as it now exists, contains few things whose utility is very remarkable:	医学は現状のままでも、とてもめざましい効用をもつ知見を産み出している。
but without any wish to depreciate it, I am confident that there is no one, even among those whose profession it is, who does not admit that all at present known in it is almost nothing in comparison of what remains to be discovered;	でもそれを貶めるつもりはないけれど、医学に従事している者でさえ、まだわかっていないことに比べたら、いまわかっていることなんてないに等しいというのは一人残らず認めるはずだ。
and that we could free ourselves from an infinity of maladies of body as well as of mind, and perhaps also even from the debility of age, if we had sufficiently ample knowledge of their causes, and of all the remedies provided for us by nature.	無数の肉体や精神の疾患、あるいは高齢に伴う能力減退ですら、その原因について十分な知識を持っていて、それに対して自然が提供する対処法を理解していれば、人類はそういうものから逃れることができるようになることもみんな同意するはずだ。
But since I designed to employ my whole life in the search after so necessary a science, and since I had fallen in with a path which seems to me such, that if any one follow it he must inevitably reach the end desired, unless he be hindered either by the shortness of life or the want of experiments, I judged that there could be no more effectual provision against these two impediments than if I were faithfully to communicate to the public all the little I might myself have found, and incite men of superior genius to strive to proceed farther, by contributing, each according to his inclination and ability, to the experiments which it would be necessary to make,	でもわたしは、全人生をこんなに必要とされている科学の探求にうちこむように仕立てたし、そしてわたしが通った道をたどれば、人生の短さや実験の必要性によってじゃまされない限り、だれでも望む目標に必ず到達できると思ったので、いまの二つの生涯に対するいちばん有効な対抗措置としては、誠心誠意をもってわたし自身の発見したわずかながらのことを伝えて、もっと優れた才能の持ち主が、努力して、それぞれの指向や才能に応じて必要な実験をして貢献することで、それをもう少し先まで進めてくれるよううながすことだと思えた。
and also by informing the public of all they might discover, so that, by the last beginning where those before them had left off, and thus connecting the lives and labours of many, we might collectively proceed much farther than each by himself could do.	そして、世界に対して発見できるかもしれないことすべてを伝えることで、先人たちがやり終えたところを出発点として、多くの人生や寿命をつなぎあわせることで、人類全体として、個々人だけで到達できるよりずっと先まで進めるようにするのがいいと思えた。
I remarked, moreover, with respect to experiments, that they become always more necessary the more one is advanced in knowledge;	さらに、実験について言えば、知識がどんどん高まるにつれて実験はますます必要になってくるのを知った。
for, at the commencement, it is better to make use only of what is spontaneously presented to our senses, and of which we cannot remain ignorant, provided we bestow on it any reflection, however slight, than to concern ourselves about more uncommon and recondite phenomena:	最初の頃は、一般的でない事柄や深遠な現象にかまけたりするよりも、自分の感覚に直接提示され、無視できないないものを使って、多少なりとも思索を行うほうがいい。
the reason of which is, that the more uncommon often only mislead us so long as the causes of the more ordinary are still unknown;	その理由は、一般的でないものは、もっとふつうの事柄の原因がまだわかっていないときには、誤解をもとだからだ。
and the circumstances upon which they depend are almost always so special and minute as to be highly difficult to detect.	そういう一般的でないものが依存している状況というのは、必ずといっていいほど実に特殊で起こりにくいものなので、検出するのがとてもむずかしいのだ。
But in this I have adopted the following order:	でも、これについては、こんな順序を採用することにした。
first, I have essayed to find in general the principles,	まず一般的なものの中から原理を見出そうとする。
or first causes of all that is or can be in the world, or first causes of all that is or can be in the world,	原理というはつまり、この世界に存在するもの、あるいは存在可能なものすべての第一原因だ。
without taking into consideration for this end anything but God himself who has created it, and without educing them from any other source than from certain germs of truths naturally existing in our minds	この目的のためには、それを創り出した神自身以外はなにも考えず、そしてそれを導き出すにあたっては、われわれの精神の中に自然に存在している、真理の宝石以外には何の源も使わない。
In the second place, I examined what were the first and most ordinary effects that could be deduced from these causes;	二番目には、こうした原因から真っ先に導き出せる、いちばんふつうの結果が何かを検討した。
and it appears to me that, in this way, I have found heavens, stars, an earth, and even on the earth water, air, fire, minerals, and some other things of this kind, which of all others are the most common and simple, and hence the easiest to know.	そしてどうやらこうすることで、万物の中でいちばんあり不売れていて単純で、したがって一番わかりやすいものである、天や星、地球、そして地上の水や空気、火、好物といったようなものを見つけることができた。
Afterwards when I wished to descend to the more particular, so many diverse objects presented themselves to me, that I believed it to be impossible for the human mind to distinguish the forms or species of bodies that are upon the earth, from an infinity of others which might have been, if it had pleased God to place them there, or consequently to apply them to our use,	その後、もっと個別のものに降りていこうとしたら、すさまじく多様な対象が出てきてしまい、だから人間の精神が、地上に存在する形態や存在の種類を、神さえそれをよしとしたなら存在し得たかもしれない無数のものから区別したり、さらにそれを活用したりするのは、そのままでは不可能だと思えた。
unless we rise to causes through their effects, and avail ourselves of many particular experiments.	それをやるには、結果を通じて原因にまでさかのぼり、個別の実験をいろいろやらなくてはならない。
Thereupon, turning over in my mind I the objects that had ever been presented to my senses I freely venture to state that I have never observed any which I could not satisfactorily explain by the principles had discovered.	そこから、頭の中でわたしの感覚の前に一度でも現れた物体を転がしつつ、わたしは自分の発見した原理に基づいて満足のいく説明できないようなものには、一つとしてお目にかかったことがないと敢えて断言しよう。
But it is necessary also to confess that the power of nature is so ample and vast, and these principles so simple and general, that I have hardly observed a single particular effect which I cannot at once recognize as capable of being deduced in man different modes from the principles, and that my greatest difficulty usually is to discover in which of these modes the effect is dependent upon them;	でも一方では、自然の力は実に広大で多様であり、こうした原理のほうはとても単純かつ一般的なので、どの個別の結果をとっても、そうした原理からさまざまなちがった形で導き出せることがすぐに認識できてしまい、だからいちばんむずかしいのは、そのさまざまなやり方のうち、どの結果がどれに依存しているのかを発見することなのだ、ということは告白しておこう。
for out of this difficulty cannot otherwise extricate myself than by again seeking certain experiments,	この困難から逃れるためには、これまた各種の実験をしてみるしかない。
which may be such that their result is not the same, if it is in the one of these modes at we must explain it, as it would be if it were to be explained in the other.	実験をすれば、あの説明にしたがって出てくる結果の場合と、この説明にしたがって出てくる結果の場合とがちがっているようにできる。
As to what remains, I am now in a position to discern, as I think, with sufficient clearness what course must be taken to make the majority those experiments which may conduce to this end:	そして残ったものはというと、わたしはこの目的に資するような実験をどのように行うべきか、その大半を十分はっきりと見て取ることができるように思う。
but I perceive likewise that they are such and so numerous, that neither my hands nor my income, though it were a thousand times larger than it is, would be sufficient for them all;	でも同じくわたしは、そうした実験があまりに多種多様で、わたしの手も収入も、それがいまの千倍あったとしても、すべてやるわけにはいかないのも認識できる。
so that according as henceforward I shall have the means of making more or fewer experiments, I shall in the same proportion make greater or less progress in the knowledge of nature.	そして以上から、行う実験の多少と比例する形で、自然についての知識に関する進歩も増えたり減ったりすることになる。
This was what I had hoped to make known by the treatise I had written,	わたしが論文で知ってもらおうとしたのは、こういうことなのだ。
and so clearly to exhibit the advantage that would thence accrue to the public, as to induce all who have the common good of man at heart, that is, all who are virtuous in truth, and not merely in appearance, or according to opinion, as well to communicate to me the experiments they had already made, as to assist me in those that remain to be made.	そして、そうすることで一般に対して蓄積されるメリットをはっきりと示し、人類の共通の利益を大事にしている人々、つまりただの外見や意見にしたがうだけではなく、真理を美徳とする人々にも、かれらの行った実験をわたしに伝えて、まだ行っていない実験を行えるようわたしを助けてほしい、ということを伝えたかったのだ。
But since that time other reasons have occurred to me, by which I have been led to change my opinion,	でもそれからほかの考えが生まれて、そのためにわたしは自分の見解を変えることになった。
and to think that I ought indeed to go on committing to writing all the results which I deemed of any moment, as soon as I should have tested their truth, and to bestow the same care upon them as I would have done had it been my design to publish them.	あらゆる時点で、なにかの正しさを試験して確認したら、その結果をすべて記録しておいて、出版しようと思ったものと同じだけの注意を払うべきだと考えるようになったのだ。
This course commended itself to me, as well because I thus afforded myself more ample inducement to examine them thoroughly,	こういうことを思いついたのは、自分の考えについてもっと十分に検討を行うよう自らを則すという目的もあった。
for doubtless that is always more narrowly scrutinized which we believe will be read by many, than that which is written merely for our private use (and frequently what has seemed to me true when I first conceived it, has appeared false when I have set about committing it to writing), as because I thus lost no opportunity of advancing the interests of the public, as far as in me lay, and since thus likewise, if my writings possess any value, those into whose hands they may fall after my death may be able to put them to what use they deem proper.	自分一人で使うために書いただけのものに比べて、多数の人間に読まれると思ったものは、いつももっと厳しくチェックをするのはまちがいないところだし（そして、思いついたときには事実だと思えたことが、書いてみると実はまちがいだったということもよくあったので）、さらにそうすれば人類一般の利益を促進する機会を、自分に可能な限り追求する機会を失わずにすみ、そしてわたしの著作が多少なりとも価値があるなら、死後にだれかの手にわたったときにも、その人たちがそれを適切と考えるやり方で勝つようしてくれるだろうと思ったのだ。
But I resolved by no means to consent to their publication during my lifetime,	でも、いかなる理由があっても、存命中はそれらの出版に同意しまいと決意した。
lest either the oppositions or the controversies to which they might give rise, or even the reputation, such as it might be, which they would acquire for me, should be any occasion of my losing the time that I had set apart for my own improvement.	それが巻き起こしかねない反論や毀誉褒貶もあったし、その著作のおかげで、もし万が一、わたしが有名になったりしてしまったら、自分を向上させるためにとっておいた時間が失われてしまうと思ったからだ。
For though it be true that every one is bound to promote to the extent of his ability the good of others, and that to be useful to no one is really to be worthless, yet it is likewise true that our cares ought to extend beyond the present, and it is good to omit doing what might perhaps bring some profit to the living, when we have in view the accomplishment of other ends that will be of much greater advantage to posterity.	万人は、自分の力の限り、他人にとってよいことを行うようにつとめるべきだというのは事実ではあるし、だれにとっても便利な存在でないというのは、まさに無価値な人間になるということではあるけれど、でも一方ではわれわれの気づかいは現在だけにとどまるべきではないし、後世にとってずっと大きなメリットをもたらす何かを達成しようとしているなら、いま生きている人々に対してメリットのあることを多少は削るのもよいことだ、というのも真実だ。
And in truth, I am quite willing it should be known that the little I have hitherto learned is almost nothing in comparison with that of which I am ignorant, and to the knowledge of which I do not despair of being able to attain;	そしてわたしは、自分がこれまでに学んできたことは、まだ知らないことの量や、獲得できなくても仕方ないと思える知識の総量に比べれば、ほとんど無に等しいということも、是非とも知ってほしいと思う。
for it is much the same with those who gradually discover truth in the sciences, as with those who when growing rich find less difficulty in making great acquisitions, than they formerly experienced when poor in making acquisitions of much smaller amount.	というのも、学問でだんだん真理を発見していくのは、人がお金持ちになるにつれて、貧乏だった頃にはごく少額の買い物でも苦労したのが、高価な買い物でも大した苦労をしなくなるのと同じようなものだからだ。
Or they may be compared to the commanders of armies,	あるいは、軍の指揮官と比べてもいい。
whose forces usually increase in proportion to their victories,	その軍勢は、その勝利の数に比例して増大するのがふつうだ。
and who need greater prudence to keep together the residue of their troops after a defeat than after a victory to take towns and provinces.	そして町や地域を制圧するのに勝利した後よりは、敗北した後に部隊の残党をまとめておく時のほうが、大きな辛抱を強いられる。
For he truly engages in battle who endeavors to surmount all the difficulties and errors which prevent him from reaching the knowledge of truth,	というのも、その人は真理の知識に到達するのを阻害しているあらゆる困難やまちがいを乗り越えようと、まさに戦いを挑むことになるわけだ。
and he is overcome in fight who admits a false opinion touching a matter of any generality and importance,	そして一般性のある重要な事柄について、まちがった意見を認めてしまったら、戦いで敗北したのと同じだ。
and he requires thereafter much more skill to recover his former position than to make great advances when once in possession of thoroughly ascertained principles.	そこからかつての立場を回復するためには、完全に確実となった原理をいったんつかんで、そこから大きな進歩をとげるのに比べれば、ずっと多くの技能を必要とするようになるからだ。
As for myself, if I have succeeded in discovering any truths in the sciences (and I trust that what is contained in this volume 1 will show that I have found some), I can declare that they are but the consequences and results of five or six principal difficulties which I have surmounted,	わたしはといえば、わたしが学問において何らかの真理を発見しおおせたとするなら（そしてこの文に含まれている内容で、多少の真理が発見できたことは示せていると信じるが）、それはわたしが原理的な困難5つか6つを克服しおおせたことの帰結にして結果にすぎないと断言できる。
and my encounters with which I reckoned as battles in which victory declared for me.	そしてそういう困難との対決を戦闘と考えればわたしは勝利をおさめたわけだ。
I will not hesitate even to avow my belief that nothing further is wanting to enable me fully to realize my designs than to gain two or three similar victories;	さらには、わたしの計画を完全に実現するためには、同じような勝利をあと2、3個おさめれば十分だという信念を、ここでためらうことなく表明しよう。
and that I am not so far advanced in years but that, according to the ordinary course of nature, I may still have sufficient leisure for this end.	そしてわたしは、通常の寿命にしたがうならば、その目的を達成するのに十分なくらい余生がある年齢にしかなっていない。
But I conceive myself the more bound to husband the time that remains the greater my expectation of being able to employ it aright,	しかしわたしは、自分できちんと律することができるという期待が大きい時間を養うのに専心したいのだ。
and I should doubtless have much to rob me of it, were I to publish the principles of my physics:	そしてもしわたしが物理学の原理を刊行したら、そうした時間はまちがいなく大幅に奪われてしまうだろう。
for although they are almost all so evident that to assent to them no more is needed than simply to understand them, and although there is not one of them of which I do not expect to be able to give demonstration, yet, as it is impossible that they can be in accordance with all the diverse opinions of others, I foresee that I should frequently be turned aside from my grand design, on occasion of the opposition which they would be sure to awaken.	その原理はすべて実に自明なので、それを理解しさえすれば、それに同意できるはずだし、そのどれ一つとして、わたしに証明できないようなものはないはずだけれど、それが他人の多様な意見すべてと折り合うなどということは不可能なので、確実に起きるはずの反論が出てくるたびに、しょっちゅうわたしは自分の大計画から注意をそらされることになってしまうと予想されるからだ。
It may be said, that these oppositions would be useful both in making me aware of my errors,	こうした反論は、わたしに自分のまちがいを認識させてくれるという点で役にたつとはいえるかもしれない。
and, if my speculations contain anything of value, in bringing others to a fuller understanding of it;	そしてわたしの思索に多少なりとも価値があるなら、他人がそれをもっと十分に理解できるようにしてくれる点でも役にたつかもしれない。
and still farther, as many can see better than one, in leading others who are now beginning to avail themselves of my principles, to assist me in turn with their discoveries.	そしてもっと言えば、目玉は多い方がよく見えるので、わたしの原理にしたがおうとしている他の人々を導くことで、かわりにかれらが独自の発見をして、わたしを助けてくれるようになる、という意義もあるかもしれない。
But though I recognize my extreme liability to error, and scarce ever trust to the first thoughts which occur to me, yet-the experience I have had of possible objections to my views prevents me from anticipating any profit from them.	しかしながら、自分がきわめてまちがいを犯しやすいことは認識しているし、思いついたことをそのまま信じるなどということはほとんどないにしても、わたしの観点に対するあり得る反論についてのこれまでの経験から言うと、そこから何かの利益が得られるとはとても期待できない。
For I have already had frequent proof of the judgments, as well of those I esteemed friends, as of some others to whom I thought I was an object of indifference, and even of some whose malignancy and envy would, I knew, determine them to endeavor to discover what partiality concealed from the eyes of my friends.	というのも、自分の判断に対しては十分な証明を加えてきたし、友人として尊重している人々の判断も仰いだし、わたしに対して特に関心のない人々の判断も仰いだし、さらにはわたしに対して悪意と羨望を持っていて、友人たちの目からは部分的に隠されていたものを一生懸命探すであろう人々の判断すら仰いでいるのだから。
But it has rarely happened that anything has been objected to me which I had myself altogether overlooked,	それでも、わたしがまったく見落としていた点について何か反論がきたことはほとんどない。
unless it were something far removed from the subject:	あっても、まったく的はずれなものばかりだ。
so that I have never met with a single critic of my opinions who did not appear to me either less rigorous or less equitable than myself.	だからわたしの批判者で、わたしより厳密でないか、わたしほど公正でないような人物には、一人としてお目にかかったことがないのだ。
And further, I have never observed that any truth before unknown has been brought to light by the disputations that are practised in the schools;	さらに、スコラ学派の実践しているような論争によって、これまで知られていない真理が明らかになった例を、わたしは寡聞にして知らない。
for while each strives for the victory, each is much more occupied in making the best of mere verisimilitude, than in weighing the reasons on both sides of the question;	それぞれの参加者は議論での勝利をもとめてがんばるけれど、いすれの人も、単なるもっともらしい議論を上手につくることにばかりかまけていて、議論の双方の理由づけをきちんと計ろうとはしないのだ。
and those who have been long good advocates are not afterwards on that account the better judges.	そしてある論をずっと支持してきた人たちも、将来的にその点について、よりよい判断ができるわけではない。
As for the advantage that others would derive from the communication of my thoughts, it could not be very great;	他の人々がわたしの思考を学んで得るメリットについていえば、それはあまり大きなものではないはずだ。
because I have not yet so far prosecuted them as that much does not remain to be added before they can be applied to practice.	というのも、わたしはまだ自分の思考を十分に展開しておらず、それを現実に適用できるようになるためには、まだまだ多くのことを追加する必要が残っているからだ。
And I think I may say without vanity, that if there is any one who can carry them out that length, it must be myself rather than another:	そしてそれを十分に押し進めることができる人物がいるとすれば、それはほかのだれよりも、このわたしだろうと虚栄心ぬきで言える。
not that there may not be in the world many minds incomparably superior to mine, but because one cannot so well seize a thing and make it one's own, when it has been learned from another, as when one has himself discovered it.	この世に、わたしなど比較にならないほど優れた頭脳がたくさんある可能性を否定するわけではないが、何かをつかんで自分のものとする場合には、他人からそれを学んだ人よりも、それを自分で発見した人のほうがずっと優れているからだ。
And so true is this of the present subject that,	そして目下のテーマについてはこれが実によく当てはまるのだ。
though I have often explained some of my opinions to persons of much acuteness, who, whilst I was speaking, appeared to understand them very distinctly, yet, when they repeated them, I have observed that they almost always changed them to such an extent that I could no longer acknowledge them as mine.	自分の見解を、とても頭の鋭敏な人々に何度か説明してみたが、わたしが説明しているときにははっきりと理解してくれたようだったのに、それを復唱してもらうと、必ず大きくそれを変えてしまっていて、もはや自分の考えとして認めがたいものとなっているのだ。
I am glad, by the way, to take this opportunity of requesting posterity never to believe on hearsay that anything has proceeded from me which has not been published by myself;	ちなみにわたしはこの場を借りて、わたしが自分で刊行したもの以外に、わたしが何かを発表しているというような噂を信じないだけの慎みをお願いしたい。
and I am not at all astonished at the extravagances attributed to those ancient philosophers whose own writings we do not possess;	著作がまったく伝わっていないような古代哲学者に帰せられる、各種のとんでもない議論にはまったく感心しない。
whose thoughts, however, I do not on that account suppose to have been really absurd,	でも、かれらの思想がだからといって、本当にばかげたものだったわけではないと思う。
seeing they were among the ablest men of their times,	かれらはその時代でいちばん有能な人々だったわけだから。
but only that these have been falsely represented to us.	ただその思想がまちがった形でわれわれに伝えられているだけだろう。
It is observable, accordingly, that scarcely in a single instance has any one of their disciples surpassed them;	さらには、その弟子たちが師匠を超えた例というのも、ほんの一例たりともないということもわかるだろう。
and I am quite sure that the most devoted of the present followers of Aristotle would think themselves happy if they had as much knowledge of nature as he possessed,	そしいて、今日アリストテレスをいちばん熱心に支持する人たちは、自然についてアリストテレスと同じだけの知識を得られれば満足してしまうのはまちがいないだろう。
were it even under the condition that they should never afterwards attain to higher.	それ以上の知識はその後一切得られないという条件がついたとしても、である。
In this respect they are like the ivy which never strives to rise above the tree that sustains it,	この意味でかれらは、自分を支える木より高いところには決して登ろうと努力しない、つる草のようなものだ。
and which frequently even returns downwards when it has reached the top;	そういうつる草は、いったんてっぺんにたどり着くと、下のほうに下がってきてしまうこともよくある。
for it seems to me that they also sink,	そういう追随者たちも、いわば沈んでしまうのだ。
in other words, render themselves less wise than they would be if they gave up study, who, not contented with knowing all that is intelligibly explained in their author, desire in addition to find in him the solution of many difficulties of which he says not a word, and never perhaps so much as thought.	つまり、その著者によってはっきりわかるように説明されたことをすべて知るだけでは気がすまずに、その人物が一言も発言していないどころか、おそらくは考えてもいないような問題について、その人物の中に答えを見つけようとするのだ。
Their fashion of philosophizing, however, is well suited to persons whose abilities fall below mediocrity;	だが、そういう連中の哲学的ポーズは、能力が凡庸以下の人々にはとても都合がいい。
for the obscurity of the distinctions and principles of which they make use enables them to speak of all things with as much confidence as if they really knew them, and to defend all that they say on any subject against the most subtle and skillful, without its being possible for any one to convict them of error.	かれらが使う原理やものごとの区分があいまいさなために、かれらはあらゆることについて自信をもって知ったかぶりができるようになり、自分の発言すべてについて、どんなに細かく達者な反論であっても弁護ができるようになり、だれもかれらがまちがっているといって糾弾できなくなってしまうのだ。
In this they seem to me to be like a blind man, who, in order to fight on equal terms with a person that sees, should have made him descend to the bottom of an intensely dark cave:	この点でかれらは、めくらが目あきと対等にやりあおうとして、とても暗い洞窟の底にその目あきをつれてきたようなものだと思う。
and I may say that such persons have an interest in my refraining from publishing the principles of the philosophy of which I make use;	そしてそういう連中は、わたしが使用している哲学原理を刊行しないほうが都合がいいのだ、とも言っておこう。
for, since these are of a kind the simplest and most evident, I should, by publishing them, do much the same as if I were to throw open the windows, and allow the light of day to enter the cave into which the combatants had descended.	というのも、わたしの哲学原理はなかでもいちばん簡単で自明だから、それを刊行することで、いわばわたしは窓をサッと開けて、対戦者たちが降りていった洞窟の中に、日中の光を入れてしまうことになるからだ。
But even superior men have no reason for any great anxiety to know these principles,	でも、優れた人々でさえ、こうした原理を知らなければという不安を抱くべき理由はまったくない。
for if what they desire is to be able to speak of all things, and to acquire a reputation for learning, they will gain their end more easily by remaining satisfied with the appearance of truth,	というのも、かれらが望んでいるのが万物について語れるようになり、学識が高いという評判を得たいだけなら、真実らしく見えることで満足していたほうが、その目的を簡単に達成できる。
which can be found without much difficulty in all sorts of matters, than by seeking the truth itself which unfolds itself but slowly and that only in some departments, while it obliges us, when we have to speak of others, freely to confess our ignorance.	真実らしいことならば、いろんなことを見ているだけで何の苦労もなく見つかるものだが、真理そのものを探そうとすれば、それはゆっくりとしか解明されず、しかもごく一部の分野だけで、しかも一方では他人に話さなくてはならない場合には、自分の無知をはっきりと告白しなくてはならないことになるからだ。
If, however, they prefer the knowledge of some few truths to the vanity of appearing ignorant of none, as such knowledge is undoubtedly much to be preferred, and, if they choose to follow a course similar to mine, they do not require for this that I should say anything more than I have already said in this discourse.	しかしもしかれらが、だれにも無知に見えたくないという虚栄よりも、少数の真理を知ることを望むのであれば、そういう知識はまちがいなく多いに好ましいものであり、そしてかれらがわたしと似た道をたどろうとするのであれば、この文ですでに述べた以上のことをわたしが述べる必要もないだろう。
For if they are capable of making greater advancement than I have made, they will much more be able of themselves to discover all that I believe myself to have found;	なぜなら、もしその人たちがわたしよりも大きな進歩をとげるだけの力があるならば、かれらはわたしが発見したと思うものすべてを、自力で見つける能力がそれ以上にあるはずなのだ。
since as I have never examined aught except in order, it is certain that what yet remains to be discovered is in itself more difficult and recondite, than that which I have already been enabled to find, and the gratification would be much less in learning it from me than in discovering it for themselves.	わたしはすべてを順序をおって検討しているので、これから発見されるべきことというのは、わたしがいままで発見できたことに比べて、もっと難しくて深遠であるはずだし、わたしからそれを教わったら、それを自分で発見するのに比べて、満足がずっと少ないだろう。
Besides this, the habit which they will acquire, by seeking first what is easy, and then passing onward slowly and step by step to the more difficult, will benefit them more than all my instructions.	それにかれらが身につける習慣、つまりまず簡単なものから求めて、そこからゆっくりと一歩ずつ、もっと難しいものを求めていくというやり方は、わたしが教えることすべてよりもかれらの役にたつはずだ。
Thus, in my own case, I am persuaded that if I had been taught from my youth all the truths of which I have since sought out demonstrations, and had thus learned them without labour, I should never, perhaps, have known any beyond these;	自分についていえば、もしわたしがこれまで証明を自力で探し出してきたような真理すべてについて、若い頃にすべて教わっていたとしたら、それを越えるものはいっさい学ばなかっただろうと確信する。
at least, I should never have acquired the habit and the facility which I think I possess in always discovering new truths in proportion as I give myself to the search.	少なくとも、自分が力を注いだぶんだけ新しい真理を発見するという習慣と能力は、絶対にミニつかなかっただろう。
And, in a single word, if there is any work in the world which cannot be so well finished by another as by him who has commenced it, it is that at which I labour.	つまり一言で言えば、この世でその創始者以外にはきちんと終えられないような仕事があるとすれば、それはわたしが取り組んでいるこの仕事なのだ。
It is true, indeed, as regards the experiments which may conduce to this end, that one man is not equal to the task of making them all;	確かに、この目的に貢献するような実験においては、たった一人の人間がそのすべてを行うことはできないだろう。
but yet he can advantageously avail himself, in this work, of no hands besides his own, unless those of artisans, or parties of the same kind, whom he could pay, and whom the hope of gain (a means of great efficacy) might stimulate to accuracy in the performance of what was prescribed to them.	工匠などの集団に支払いをして、かれらが利益を得ようとして（とても有効な手段だ）頼まれたことの実行を厳密にやってくれるような場合をのぞけば、その人物は自分以外のだれの手も頼りにできない。
For as to those who, through curiosity or a desire of learning, of their own accord, perhaps, offer him their services, besides that in general their promises exceed their performance, and that they sketch out fine designs of which not one is ever realized, they will, without doubt, expect to be compensated for their trouble by the explication of some difficulties, or, at least, by compliments and useless speeches,	好奇心や学習意欲にかられて、自らの意志でサービスを提供してくれるような人は、だいたいにおいて、実際の成果よりも誇大な約束をしがちだし、壮大な意図だけは説明してくれても、どれ一つとして実現されず、さらにそういう人々はまちがいなく、手伝ったかわりになにか問題を説明してくれとか、最低でもお世辞とか無駄なおしゃべりを代償に求める。
in which he cannot spend any portion of his time without loss to himself.	その人は、そんなことに時間を費やすことで、結局は損をして終わってしまうのだ。
And as for the experiments that others have already made, even although these parties should be willing of themselves to communicate them to him (which is what those who esteem them secrets will never do), the experiments are, for the most part, accompanied with so many circumstances and superfluous elements, as to make it exceedingly difficult to disentangle the truth from its adjuncts- besides, he will find almost all of them so ill described, or even so false (because those who made them have wished to see in them only such facts as they deemed conformable to their principles),  that, if in the entire number there should be some of a nature suited to his purpose, still their value could not compensate for the time what would be necessary to make the selection.	そして他の人がすでにそうした実験を行っている場合、その人々はそれについて、喜んでその人物に伝えるべきではあるのだが（それを秘密にするのに価値があると思っている人々は絶対にそうしないだろう）、実験はほとんどの場合、無数の条件やよけいな要素がくっついてくるものであり、真実と付随的なものとを峻別するのは、とてもむずかしい――さらにその実験のほとんどすべては記述があまりに不十分で、時にはウソが書いてあったりするので（というのもそれを記述した人たちは自分の原理原則にあてはまるような事実だけをそこに見ようとしたりするから）、全体の数字の中にはなにかその人の目的に会うような性質のものが含まれているかもしれないけれど、その価値は、それを選り分けるのに必要となる時間に見合うものではない。
So that if there existed any one whom we assuredly knew to be capable of making discoveries of the highest kind, and of the greatest possible utility to the public;	だからもし、最高級の発見ができて、世間に対して考え得る最高の公用をもたらせるのが確実な人がいたとしよう。
and if all other men were therefore eager by all means to assist him in successfully prosecuting his designs,	そしてそのため、ほかの人みんな、手を尽くしてかれの思い通りの探求をさせてやろうと思っていたとしよう。
I do not see that they could do aught else for him beyond contributing to defray the expenses of the experiments that might be necessary;	もしそうなら、必要となる実験の費用を分担してやるよりほかにないだろう。
and for the rest, prevent his being deprived of his leisure by the unseasonable interruptions of any one.	そしてあとは、他人からタイミングの悪いじゃまが入って、かれが時間を自由に使えなくなるのを防ぐくらいだろう。
But besides that I neither have so high an opinion of myself as to be willing to make promise of anything extraordinary, nor feed on imaginations so vain as to fancy that the public must be much interested in my designs;	でも、わたしはなにか非凡な発見ができるなどと約束するほどの自負はないし、世間一般がわたしの意図なんかに大した興味を抱くと夢想するほどの虚栄心もない。
I do not, on the other hand, own a soul so mean as to be capable of accepting from any one a favor of which it could be supposed that I was unworthy.	でも一方では、わたしが無価値だと思えるような恩恵をほかのだれからであれ受けられると思うほどの邪悪な魂も持ってはいないのだ。
These considerations taken together were the reason why, for the last three years, I have been unwilling to publish the treatise I had on hand,	こういうことをいろいろ考えていたために、過去3年にわたってわたしは手元の論文の出版をためらってきた。
and why I even resolved to give publicity during my life to no other that was so general, or by which the principles of my physics might be understood.	そして、存命中の評判についても、ごく一般的なものや、わたしの物理学の原理を理解してもらうための原理に限ろうと決意したのも、それが理由だ。
But since then, two other reasons have come into operation that have determined me here to subjoin some particular specimens, and give the public some account of my doings and designs.	でもそれ以来、別の理由が2つ生じてきて、そのためにわたしはここにいくつかの材料を追加して、自分のやってきたことや計画について世間に知らせようと考えた。
Of these considerations, the first is, that if I failed to do so, many who were cognizant of my previous intention to publish some writings, might have imagined that the reasons which induced me to refrain from so doing, were less to my credit than they really are;	その考察事項のうち最初のものは、もしわたしがそれを発表しなかったら、著作を刊行しようというわたしの昔の意図を知っている人たちは、わたしが著作を発表しないでいるのはわたしにとって実際よりも都合の悪いことがいろいろあるからだと想像するかもしれないからだ。
for although I am not immoderately desirous of glory, or even, if I may venture so to say, although I am averse from it	わたしは極端に栄光を求めたりはしないし、敢えて言っていいなら、それを避けたいと思っている。
in so far as I deem it hostile to repose which I hold in greater account than aught else,	栄光というのは、ほかのなによりもわたしが打時にしている休息をじゃまするものだと思えるからだ。
yet, at the same time, I have never sought to conceal my actions as if they were crimes, nor made use of many precautions that I might remain unknown;	でも同時に、自分の行動についてそれが犯罪であるかのように隠そうとしたこともないし、敢えて無名でいようとしていろいろな手だてを講じたりしたこともない。
and this partly because I should have thought such a course of conduct a wrong against myself, and partly because it would have occasioned me some sort of uneasiness which would again have been contrary to the perfect mental tranquillity which I court.	そしてこれは一部は、そういう行いが自分自身に対してまちがっていると思ったこともあるし、一部はそれがある種のとまどいを自分に引き起こして、それがわたしの宿している完全な精神的平静をじゃまするものだったからでもある。
And forasmuch as, while thus indifferent to the thought alike of fame or of forgetfulness, I have yet been unable to prevent myself from acquiring some sort of reputation, I have thought it incumbent on me to do my best to save myself at least from being ill-spoken of.	そして、名声と無名とのどちらについてもわたしは無関心だったのだけれど、でも自分が何かしらの評判を獲得してしまうのは防ぎようがなく、だからわたしとしては、少なくとも悪く言われるようなことだけは、なるべく避けるに越したことはないと考えるようになったのだ。
The other reason that has determined me to commit to writing these specimens of philosophy is, that I am becoming daily more and more alive to the delay which my design of self-instruction suffers,	こうした哲学的な材料について著述をしようと思ったもう一つの理由は、日ごとに、自己指導というわが方針の遅れに気がつかざるを得ないということだ。
for want of the infinity of experiments I require, and which it is impossible for me to make without the assistance of others:	必要とされる実験は無数にあるし、そういう実験も他人の助けを借りなくては、一人でやるのは不可能だ。
and, without flattering myself so much as to expect the public to take a large share in my interests, I am yet unwilling to be found so far wanting in the duty I owe to myself,	そして世間がわたしの関心事を大きく共有してくれると思うほどうぬぼれてはいないけれど、でも自分自身に課した義務の天でこんなに遅れをとっている状態なのもいやなのだ。
as to give occasion to those who shall survive me to make it matter of reproach against me some day,	そうなればいつの日かわたしより長生きしたものたちが、わたしを批判する材料としてその遅れを使うかもしれない。
that I might have left them many things in a much more perfect state than I have done, had I not too much neglected to make them aware of the ways in which they could have promoted the accomplishment of my designs.	いろんなことを、自分の設計にしたがって達成するためにとれたかもしれない手段について、世間に知らせるのをこんなに怠らなければ、いろんなことを実際よりもずっと完成された状態にしてい後世に残せたのだ、などと言われたくないのだ。
And I thought that it was easy for me to select some matters which should neither be obnoxious to much controversy, nor should compel me to expound more of my principles than I desired, and which should yet be sufficient clearly to exhibit what I can or cannot accomplish in the sciences.	そして、毀誉褒貶の種にならず、さらにわたしが望むよりも自分の原理を先にまで進めてしまうようなこともないけれど、一方で自分が学問の領域でなにを達成できて、なにを達成できないかをじゅうぶんにはっきりと示すような材料を選ぶのは、簡単だろうと思えた。
Whether or not I have succeeded in this it is not for me to say;	これが成功したかは、わたしの言うべきことではない。
and I do not wish to forestall the judgments of others by speaking myself of my writings;	そして自分の書いたものについて自ら語ることで、ほかの人たちの判断をゆがめたくもない。
but it will gratify me if they be examined, and, to afford the greater inducement to this I request all who may have any objections to make to them, to take the trouble of forwarding these to my publisher,	でも、自分の著作が検討されてればわたしはうれしいし、そしてそれをさらに引き出すために、この著作についてなにか反論のある人はみんな、ご苦労だがそれを出版社宛に送ってほしいのだ。
who will give me notice of them, that I may endeavor to subjoin at the same time my reply;	そうすれば出版社はそれをわたしに伝え、そしてわたしはそれに対してこちらの返事を添付するようにしよう。
and in this way readers seeing both at once will more easily determine where the truth lies;	こうすることで、読者たちはその反論と、わたしの答えを同時に見ることで、真実がどこにあるかをもっと容易に見られるようになる。
for I do not engage in any case to make prolix replies, but only with perfect frankness to avow my errors if I am convinced of them, or if I cannot perceive them, simply to state what I think is required for defense of the matters I have written, adding thereto no explication of any new matte that it may not be necessary to pass without end from one thing to another.	わたしはどんな場合でも儀礼的な返事をするつもりはなく、自分のまちがいに納得がいけば、その誤りを率直に認め、そしてまちがいが納得できなければ、自分の書いたことを弁護するために必要だと思うことを単に述べ、そこに特に必要もない新しい材料についてだらだらと果てしなく書き足すようなことはしないつもりだ。
If some of the matters of which I have spoken in the beginning of the "Dioptrics" and "Meteorics" should offend at first sight,	「光学（Dioptrics）」と「気象学（Meteoorics）」の最初でわたしが語ったようなことは、一見すると不穏当に思えるかもしれない。
because I call them hypotheses and seem indifferent about giving proof of them,	そこでわたしは、それを仮説と呼んで、それに対して証明を行うのに関心がないかのように見えるからだ。
I request a patient and attentive reading of the whole,	でも、我慢して鷹揚になって、本を全部、虚心に読んでほしい。
from which I hope those hesitating will derive satisfaction;	そうすればそうしたためらいが、満足を導き出してくれると期待したい。
for it appears to me that the reasonings are so mutually connected in these treatises, that, as the last are demonstrated by the first which are their causes, the first are in their turn demonstrated by the last which are their effects.	これらの論文の中での理由づけというのは、実に相互にからみあっているので、最後のものはその原因である最初のものによって実証され、最初のものが一方では、その結果である最後のものによって実証されたりするのだ。
Nor must it be imagined that I here commit the fallacy which the logicians call a circle;	さらに、ここから論理学者が循環論法と呼ぶ誤謬にわたしが陥っていると思ってはいけない。
for since experience renders the majority of these effects most certain, the causes from which I deduce them do not serve so much to establish their reality as to explain their existence;	というのもこうした結果のほとんどは、経験的にほぼ確実とされるので、わたしがその結果を導いてくる原因は、その結果の現実性を証明するものではなく、むしろその存在を説明するためのものなのだ。
but on the contrary, the reality of the causes is established by the reality of the effects.	むしろ逆に、結果の現実性が、その原因の現実性を確立するのだと言える。
Nor have I called them hypotheses with any other end in view except that it may be known that I think I am able to deduce them from those first truths which I have already expounded;	さらにわたしがそれを仮説と呼んだのは、わたしがそれらを、すでに説明した第一真理から導いてこられると思ったことを知らせるためという以外に何のねらいもない。
and yet that I have expressly determined not to do so, to prevent a certain class of minds from thence taking occasion to build some extravagant philosophy upon what they may take to be my principles, and my being blamed for it.	わたしがそれをやるまいと意図的に決めたのは、ある種の思考の持ち主たちが、わたしの原理を勝手に想像してそれをもとにとんでもない哲学を構築する口実を与え、それについてこのわたしが責められるのがいやだったからだ。
I refer to those who imagine that they can master in a day all that another has taken twenty years to think out, as soon as he has spoken two or three words to them on the subject;	わたしがここでいっているのは、ある人が20年かけて考え抜いたものを、たった二言三言説明されただけで、一日のうちに修得できると想像しているような人たちだ。
or who are the more liable to error and the less capable of perceiving truth in very proportion as they are more subtle and lively.	あるいは繊細だったり活気があったりするのに見事に比例して、まちがいを犯しやすく真理を理解する能力が低い人たちのことだ。
As to the opinions which are truly and wholly mine, I offer no apology for them as new,	実際に完全にわたし自身のものである見解については、それが目新しいものだとあえて主張するつもりもない
-- persuaded as I am that if their reasons be well considered they will be found to be so simple and so conformed, to common sense as to appear less extraordinary and less paradoxical than any others which can be held on the same subjects;	――というのも、その理由づけをよく検討してもらえれば、それがきわめて単純で常識にかなっていて、同じ対象についていわれたほかのどんな説に比べても、非凡だったり、矛盾だったりするところはずっと少ないはずだと自ら確信しているからだ。
nor do I even boast of being the earliest discoverer of any of them,	さらには、そのいずれについても、それを最初に発見したのが自分だと自慢するつもりもない。
but only of having adopted them, neither because they had nor because they had not been held by others, but solely because reason has convinced me of their truth.	単に、他の人がそれを受け入れたからというのではなく、ひたすら理性がそれを真実であると納得させてくれたために自分はそれを受け入れたのだ、と主張するだけだ。
Though artisans may not be able at once to execute the invention which is explained in the "Dioptrics," I do not think that any one on that account is entitled to condemn it;	「光学（Dioptrics）」で説明した発明を工匠たちがすぐに実現できなくても、それを根拠にしてその発明自体を糾弾する資格はだれにもないと思う。
for since address and practice are required in order so to make and adjust the machines described by me as not to overlook the smallest particular,	というのも、わたしが記述した機械をごく細部まで見逃すことなくつくりあげて調整するには、集中力と訓練が必要になるからだ。
I should not be less astonished if they succeeded on the first attempt than if a person were in one day to become an accomplished performer on the guitar, by merely having excellent sheets of music set up before him.	だから、それが一発で成功したら、だれかが優れた音楽の楽譜を目の前に並べただけでその日のうちにギターの名手になってしまうよりも驚くべきことだろう。
And if I write in French, which is the language of my country, in preference to Latin, which is that of my preceptors, it is because I expect that those who make use of their unprejudiced natural reason will be better judges of my opinions than those who give heed to the writings of the ancients only;	そしてわたしが教師たちの言語であるラテン語ではなく、わが国の言語たるフランス語で書くのも、古人の著作だけをよりどころにしている人々よりは、偏見のない自然な論理展開を活用する人たちのほうが、わたしの意見をもっとよく判断してくれるだろうと期待してのことだ。
and as for those who unite good sense with habits of study, whom alone I desire for judges, they will not, I feel assured, be so partial to Latin as to refuse to listen to my reasonings merely because I expound them in the vulgar tongue.	そして、よい判断力を学習の習慣と結びつける人々（そういう人たちだけにわたしの見解を判断してもらいたい）は、単に卑しきフランス語で表現されているからというだけの理由で、わたしの理論展開を拒絶するほどラテン語びいきにはなっていないだろう。
In conclusion, I am unwilling here to say anything very specific of the progress which I expect to make for the future in the sciences, or to bind myself to the public by any promise which I am not certain of being able to fulfill;	最後に、わたしはここで、学問の未来のために自分がもたらそうとしている進歩について、あまり断言するつもりはないし、自分が果たせるかもできない公約をして自分をしばるつもりもない。
but this only will I say,	でもこれだけは言っておこう。
that I have resolved to devote what time I may still have to live to no other occupation than that of endeavoring to acquire some knowledge of Nature,	わたしは自分に残された余生を、自然についての知識を獲得するための努力にだけ費やすことを決意した。
which shall be of such a kind as to enable us therefrom to deduce rules in medicine of greater certainty than those at present in use;	そしてそれは、医学の分野で、いま使われているものより確実な規則を引き出せるものにするつもりだ。
and that my inclination is so much opposed to all other pursuits,	そしてわたしの目指すものは、ほかの方向性とはちがっている。
especially to such as cannot be useful to some without being hurtful to others,	特に、ある人に苦痛をもたらさないと、ほかの人に便利に使えないようなものとはちがう。
that if, by any circumstances, I had been constrained to engage in such, I do not believe that I should have been able to succeed.	いかなる状況でもそんな探求をしなくてはならないような状態に追い込まれていたら、わたしは成功できなかったはずだ。
Of this I here make a public declaration,	この点は公式に宣言しよう。
though well aware that it cannot serve to procure for me any consideration in the world, which, however, I do not in the least affect;	ただし、そうしたところで、この世界から認知を得る役にたつわけではないのは充分に承知しているし、またそもそもそんなことはいささかも気にしているわけではない。
and I shall always hold myself more obliged to those through whose favor I am permitted to enjoy my retirement without interruption than to any who might offer me the highest earthly preferments.	そしてわたしは常に、この世の最高の富貴を与えてくれるような人物よりも、わたしがじゃまされずに隠退生活を楽しむことを可能にするだけの配慮を与えてくれている人たちのほうに、感謝の念を捧げるものである。
