FATTY COON AT HOME	ふとっちょあらいぐまの家
1  Fatty Coon was so fat and round that he looked like a ball of fur, with a plumelike tail for a handle.	1 ふとっちょあらいぐまは、とても太っていてまん丸で、まるで毛皮のボールのよう、そこに取っ手ではなく、羽かざりのようなしっぽがついた姿をしていました。
But if you looked at him closely you would have seen a pair of very bright eyes watching you.	しかしまぢかに寄って見てみますと、するどくかがやくふたつの目が、あなたをじっと見かえしているのに、お気づきになるでしょう。
2 Fatty loved to eat.	2 ふとっちょは食べることが大好きでした。
--he loved eating better than anything else in the world.	――世界中のなによりも、食べることが好きでした。
That was what made him so fat.	ひどく太っているのはそのせいでした。
And that, too, was what led him into many adventures.	そしてたくさんの冒険をすることになったのもまた、そのせいでした。
3 Close by a swamp, which lay down in the valley, between Blue Mountain and Swift River, Fatty Coon lived with his mother and his brother and his two sisters.	3 ふとっちょあらいぐまは、お母さんと弟とふたりの妹といっしょに、ブルー山とスウィフト川のあいだの谷間に横たわる沼の近くに住んでいました。
A mong them all there was what grown people call "a strong family resemblance,"	一家はそのあたりに住んでいた大人たちみんなのあいだで、『強力るいじ家系』と呼ばれていました。
which is the same thing as saying that they all looked very much a like.	一家全員がとてもよく似ている、というのと同じ意味です。
The tail of each one of them	彼らそれぞれのしっぽに
--mother and children too	――お母さんに子どもたちも
--had six black rings around it.	――六つの黒い輪っかのもようがついていました。
Each of them had a dark brown patch of fur across the face, like a mask.	それぞれの顔は、黒い布切れを横にわたしたように毛が生えていて、まるでマスクをしているように見えました。
And--what do you think?--each of them,	それに、彼らそれぞれが――どう思います？
even Fatty and his brother and his sisters, had a stiff, white moustache!	――ふとっちょに弟に妹たちまでもが、かたくて白い口ひげを生やしていました！
4 Of course, though they all looked so much alike, you would have known which was Mrs. Coon, for she was so much bigger than her children.	4 一家はみなとてもよく似た姿をしていたとはいうものの、もちろんみなさんはおわかりでしょうが、あらいぐま夫人は子どもたちに比べるとずっと大きな体でした。
And you would have known which was Fatty--he was so much rounder than his brother and his sisters.	そして、おわかりでしょう、ふとっちょは――弟や妹たちよりもずっとまん丸な体でした。
5 Mrs. Coon's home was in the hollow branch of an old tree.	5 あらいぐま夫人の家は、古い木の枝に空いたうろの中にありました。
It was a giant of a tree	それは巨大な木で
--a poplar close by a brook which ran into the swamp	――そのポプラの木は、沼に流れこむ小川のそばに立っていました
--and the branch which was Mrs. Coon's home was as big as most tree-trunks are.	――枝のうろの中のあらいぐま夫人の家は、ふつうの木の幹に空いたうろの中と同じくらいの広さがありました。
6 Blackie was Fatty's brother	6 黒っちょは、ふとっちょの弟です
--for the mask on his face was just a little darker than the others'.	――顔のマスクの色が、ほかの者よりもほんの少しだけ黒かったからです。
Fluffy was one of Fatty's sisters,	ふわっちょは、ふとっちょの妹の一ぴきです。
because her fur was just a little fluffier than the other children's.	毛皮が、ほかの子どもよりほんの少しだけふわふわだったからです。
And Cutey was the other sister's name,	もう一ぴきの妹の名前は、かわいっちょです。
because she was so quaint.	なぜなら、たいそうかわいかったからです。
7 Now, Fatty Coon was forever looking around for something to eat.	7 さて、ふとっちょあらいぐまは、いつでも食べものを探しまわっていました。
He was never satisfied with what his mother brought home for him.	お母さんがふとっちょのために家に持ちかえる食べもので満足したことなど、決してありませんでした。
No matter how big a dinner Mrs. Coon set before her family, as soon as he had finished eating his share	あらいぐま夫人がどんなに大きなごちそうを家族の前に置こうと、ふとっちょは自分の分け前をたちまち平らげてしまいました。
Fatty would wipe his white moustache carefully	そして、ていねいに白い口ひげをふき
--for all the world like some old gentleman	――どこからどう見ても老紳士のようです
--and hurry off in search of something more.	――もっと食べものを探しに、いそいそと出かけていくのでした。
Sometimes he went to the edge of the brook and tried to catch fish by hooking them out of the water with his sharp claws.	8 あるときはふとっちょは小川の川べりに行き、するどいかぎづめで水の中の魚を引っかけて、つかまえようとしました。
Sometimes he went over to the swamp and hunted for duck among the tall reeds.	またあるときは沼に出かけ、背の高いアシの中にかくれているカモをつかまえようとしました。
And though he did not yet know how to catch a duck, he could always capture a frog or two;	カモのつかまえ方はまだ知りませんでしたが、カエルならばいつも一ぴきか二ひきはつかまえられました。
and Fatty ate them as if he hadn't had a mouthful of food for days.	そして、まるで何日もひと口も食べたことがないようなようすで、つかまえたカエルをむしゃむしゃ食べるのでした。
To tell the truth, Fatty would eat almost anything he could get	9 本当のことを申しますと、ふとっちょはとれるものならほとんどなんでも食べました
--nuts, cherries, wild grapes, blackberries, bugs, small snakes, fish, chickens, honey	――木の実、サクランボ、野ブドウ、ヤブイチゴ、虫、小さなヘビ、魚、ニワトリ、ハチミツ
--there was no end to the different kinds of food he liked.	――ふとっちょが好きな食べものの種類はさまざまあり、きりがありませんでした。
He ate everything.	なんでもかんでも食べました。
And he always wanted more.	そして、いつももっとなにか食べたいと思っていました。
"Is this all there is?"	10 「これで全部なの？」
Fatty Coon asked his mother one day.	ある日、ふとっちょあらいぐまはお母さんにたずねました。
He had gobbled up every bit of the nice fish that Mrs. Coon had brought home for him.	あらいぐま夫人がふとっちょのために持ちかえったおいしい魚を、きれいにむさぼり食べたあとのことでした。
It was gone in no time at all.	それはじつにあっというまのことでした。
Mrs. Coon sighed.	11 あらいぐま夫人はため息をつきました。
She had heard that question so many times;	もういく度となくその質問を聞いてきたからです。
and she wished that for once Fatty might have all the dinner he wanted.	一度でよいから、ふとっちょが欲しがるだけごちそうをたらふく食べさせてやれればいいのにと思っていたのです。
"Yes	12 「そうなんだよ
--that's all,"	――これで全部なんだよ」
she said,	あらいぐま夫人は言いました。
"and I should think that it was enough for a young coon like you."	.「お前くらいの子どもはこれで十分なはずだろう」
Fatty said nothing more.	13 ふとっちょはそれ以上なにも言いませんでした。
He wiped his moustache on the back of his hand (I hope you'll never do that!) and without another word he started off to see what he could find to eat.	彼は口ひげを手の甲でぬぐうと（みなさんは真似しないでくださいね！）、ひと言もいわずに、食べものをさがしに出かけました。
FATTY LEARNS SOMETHING ABOUT EGGS	ふとっちょ、卵について学ぶ
When Fatty Coon started off alone to find something more to eat, after finishing the fish that his mother had brought home for him, he did not know that he was going to have an adventure.	1 お母さんが持ちかえった魚を食べおわり、もっとたくさんの食べものをさがしにひとりで出かけたとき、ふとっちょあらいぐまはこれが冒険になることを知りませんでした。
He nosed about among the bushes and the tall grasses and caught a few bugs and a frog or two.	彼はやぶや背の高い草のあいだをかぎまわり、数ひきの虫と、一、二ひきのカエルをつかまえました。
But he didn't think that THAT was much.	でもそんなものではもの足りないと思いました。
He didn't seem to have much luck, down on the ground.	地面をはいずりまわっていても、あまり幸運にめぐまれそうにありませんでした。
So he climbed a tall hemlock, to see if he could find a squirrel's nest, or some bird's eggs.	そこでリスの巣か鳥の卵をさがそうと、背の高いヘムロックの木に登りました。
Fatty loved to climb trees.	2 ふとっちょは木登りが大好きでした。
Up in the big hemlock he forgot, for a time, that he was still hungry.	ヘムロックの大木に登り、ほどなくすると、彼は腹ぺこを忘れてしまいました。
It was delightful to feel the branches swaying under him, and the bright sunshine was warm upon his back.	枝がゆらゆらとゆれ、あかるい陽光が背中をぽかぽかと温めて、とてもよい心地でした。
He climbed almost to the very tip-top of the tree and wound himself around the straight stem.	木のてっぺん近くまで登ると、ふとっちょはまっすぐな木の幹に体を巻きつけました。
The thick, springy branches held him safely,	木の葉が厚くしげり、ばねのようにしなる枝が、彼の体を安全に包みこみました。
and soon Fatty was fast asleep.	彼はまもなくぐっすりと眠りこみました。
Next to eating, Fatty loved sleeping.	ふとっちょは食べることの次に眠ることが好きでした。
And now he had a good nap.	彼はまもなく大きないびきをかきはじめました。
Fatty Coon woke up at last,	3 ようやくふとっちょあらいぐまは目をさましました。
yawned, and slowly unwound himself from the stem of the tree.	あくびをし、木の幹に巻きつけていた体をそろそろとほどきました。
He was terribly hungry now.	今ではとてつもなくお腹が空いていました。
And he felt that he simply MUST find something to eat at once.	ただちに食べものを見つけなくてはだめだと感じました。
Without going down to the ground, Fatty climbed over into the top of another big tree and his little beady, bright eyes began searching all the branches carefully.	4 ふとっちょは地面に下りることなしに隣りの大木のてっぺんにわたり、すべての枝のあいだをくまなくさがそうと、つぶらなビーズのような目を光らせました。
Pretty soon Fatty smiled.	彼はすぐさま笑みをうかべました。
He smiled because he was pleased.	どうしてかというと、よろこんだからです。
And he was pleased because he saw exactly what he had been looking for.	どうしてよろこんだのかというと、まさにお目当てのものを見つけたからです。
Not far below him was a big nest, built of sticks and lined with bark and moss.	それほど離れていない下方に、小枝を組んで木の皮とコケをしきつめた大きな鳥の巣がありました。
It was a crow's nest, Fatty decided,	カラスの巣だ、とふとっちょは考えました。
and he lost no time in slipping down to the crotch of the tree where the nest was perched.	彼は木のまたにかかった巣に向かって、さっさとすべり下りていきました。
There were four white eggs in the nest	5 巣の中には四個の白い卵がありました
--the biggest crow's eggs Fatty had ever seen.	――ふとっちょがこれまで見たうちで一番大きなカラスの卵でした。
And he began to eat them hungrily.	彼は意地きたなく食べはじめました。
His nose became smeared with egg, but he didn't mind that at all.	鼻が卵まみれになりましたが、ぜんぜん気にしませんでした。
He kept thinking how good the eggs tasted	なんておいしい卵なんだろう、とばかり考えていました
--and how he wished there were more of them.	――そして、この卵がもっとたくさんあればいいのになあと思いました。
There was a sudden rush through the branches of the tall tree.	6 とつぜん、なにかが高い木の枝えだのあいだをぬって襲いかかってきました。
And Fatty Coon caught a hard blow on his head.	ふとっちょあらいぐまの頭上を、強い風がさっと吹きぬけました。
He felt something sharp sink into his back, too.	同時に、なにかするどいものがふとっちょの背中をぐさりと突きさしました。
And he clutched at the edge of the nest to keep from falling.	ふとっちょは落っこちないように巣のはしにしがみつきました。
Fatty was surprised,	7 ふとっちょはおどろきました。
to say the least, for he had never known crows to fight like that.	ひかえ目に言っても、カラスがこんなふうに攻撃してくるとは聞いたこともありませんでしたから。
And he was frightened,	彼はこわくなりました。
because his back hurt.	背中を傷つけられたからです。
He couldn't fight, because he was afraid he would fall if he let go of the nest.	巣から手を放したら下に落っこちそうでおそろしかったので、戦えそうにありませんでした。
There was nothing to do but run home as fast as he could.	8 できるかぎりはやく走って、家に逃げかえるよりほかにありません。
Fatty tried to hurry;	ふとっちょは急ごうとしました。
but there was that bird, beating and clawing his back, and pulling him first one way and then another.	けれど鳥が、彼の背中を叩いたり引っかいたり、あっちに引っぱったりこっちに引っぱったりしました。
He began to think he would never reach home.	ふとっちょは二度と家にかえれないのだと思いはじめました。
But at last he came to the old poplar where his mother lived.	けれどとうとうお母さんのいる古いポプラの木にたどり着きました。
And soon, to his great joy, he reached the hole in the big branch;	大きな枝のうろにたどり着くと、まもなくふとっちょは大いに安心しました。
and you may well believe that Fatty was glad to slip down into the darkness	暗がりの中にすべり込んでふとっちょが大よろこびしたのを、みなさんもご想像がつくでしょう。
where his mother, and his brother Blackie, and Fluffy and Cutey his sisters, were all fast asleep.	そこではお母さんと、弟の黒っちょと、ふわっちょとかわいっちょの妹たちが、そろってぐっすりと眠っていました。
He was glad, because he knew that no crow could follow him down there.	カラスはここまでついて来られないのだとわかり、ふとっちょはよろこんだのです。
Mrs. Coon waked up.	9 あらいぐま夫人が目をさましました。
She saw that Fatty's back was sadly torn	彼女は、ふとっちょの背中がいたましく切りさかれているのに目を止めました
(for coons, you know, can see in the dark just as well as you can see in the daylight).	（あらいぐまというものは、みなさんもご存知でしょうが、みなさんが昼中に見るのと同じくらいに暗がりがよく見えるのです）。
"What on earth is the matter?"	10 「一体ぜんたいなにがあったんだい？」
she exclaimed.	あらいぐま夫人はさけびました。
Poor Fatty told her.	11 ふとっちょはあわれっぽくわけを話しました。
He cried a little,	彼はちょっぴり泣きました。
because his back hurt him, and because he was so glad to be safe at home once more.	背中が痛むのと、ふたたび安全なわが家にかえることができたうれしさのためでした。
"What color were those eggs?"	12 「その卵はなに色だったの？」
Mrs. Coon inquired.	あらいぐま夫人がたずねました。
"White!"	13 「白だよ！」
said Fatty.	ふとっちょは答えました。
"Ah, ha!"	14 「ハハア！」
Mrs. Coon said.	あらいぐま夫人は言いました。
"Don't you remember that crows' eggs are a blueish green?	「カラスの卵は青みがかった緑色だということを忘れたのかい？
That must have been a goshawk's nest.	それはオオタカの巣にちがいないよ。
And a goshawk is the fiercest of all the hawks there are.	オオタカはすべてのタカの中でも一番どうもうなんだよ。
It's no wonder your back is clawed.	背中を引っかかれてもふしぎはないよ。
Come here and let me look at it."	こっちに来て見せてごらん」
Fatty Coon felt quite proud,	15 ふとっちょあらいぐまはすっかり誇らしくなりました。
as his mother examined the marks of the goshawk's cruel claws.	お母さんが調べているのは、オオタカにむごたらしく切りさかれた傷あとなのです。
And he didn't feel half as sorry for himself as you might think,	彼は、おそらくみなさんが考えている半分も、自分をかわいそうだと思っていませんでした。
for he remembered how good the eggs had tasted.	卵の味がどれほどおいしかったかを思い出していたからです。
He only wished there had been a dozen of them.	彼はただ、あの卵を一ダースも食べられたらよかったのになあ、とばかり考えていました。
FATTY DISCOVERS MRS. TURTLE'S SECRET	ふとっちょ、かめ夫人のひみつを発見する
After his adventure with the goshawk Fatty Coon did not go near the tree-tops for a long time.	1 オオタカの冒険があってから長いあいだ、ふとっちょあらいぐまは、木のてっぺんに近寄りませんでした。
Whenever he left home he would crawl down the old poplar tree in which he lived;	自分の住んでいる家である古いポプラの木のうろから出るときは、かならず下におりました。
and he wouldn't climb a single tree until he came home again.	家にかえるのでなければ、ただの一本の木にも登りませんでした。
Somehow, he felt safer on the ground.	地面の上にいれば、とにかく安心できました。
You see, he hadn't forgotten the fright he had had, nor how the goshawk's claws had hurt his back.	だって、木のてっぺんで恐ろしい思いをしたことも、オオタカのかぎづめで背中を傷つけられたことも、忘れてはいなかったのですからね。
It was just three days after his scare, to be exact,	2 正確に言えば、恐ろしい目にあってから、ちょうど三日目のことでした。
when Fatty Coon found himself on the bank of the creek which flowed slowly into Swift River.	ふとっちょあらいぐまは、スウィフト川のゆるい流れにできた入江の浅瀬に、ひょっこり出くわしました。
Fatty had been looking for frogs, but he had had no luck at all.	カエルをさがしていたのですが、まったくつきに恵まれていませんでした。
To tell the truth, Fatty was a little too young to catch frogs easily, even when he found one;	本当のことを言いますと、ふとっちょはまだ小さすぎて、カエルを見つけられたときだって、簡単につかまえることはできませんでした。
and he was a good deal too fat, for he was so plump that he was not very spry.	それに、うんと太っており、体がたいそう丸かったので、あまりすばしっこくなかったのです。
Now, Fatty was hiding behind some tall rushes, and his sharp little eyes were looking all about him,	3 入江に出くわしたふとっちょは、背の高いイグサの草むらのかげに隠れ、するどいつぶらな目で辺りをぐるりと見まわしました。
and his nose was twitching as he sniffed the air.	鼻をひくつかせ、空気のにおいをかぎました。
He wished he might find a frog.	カエルはいないかしらと思いました。
But not one frog appeared.	けれど、一ぴきの姿も見あたりませんでした。
Fatty began to think that some other coon must have visited the creek just before him and caught them all.	ほかのあらいぐまが、ふとっちょが来るちょっと前にやって来て、ここのカエルを全部とってしまったにちがいない、と、ふとっちょは考えはじめました。
And then he forgot all about frogs.	つづいて、ふとっちょはカエルのことをすっかり忘れてしまいました。
Yes!	4 そうですとも！
Frogs passed completely out of Fatty Coon's mind.	カエルのことなど、ふとっちょあらいぐまは、頭からすっかり追い出してしまいました。
For whom should he spy	そんなものより、もっと興味深いものに目を注いでいたのです。
but Mrs. Turtle!	かめ夫人です！
He saw her little black head first,	最初にふとっちょが見つけたのは、かめ夫人の小さな黒い頭でした。
bobbing along through the water of the creek.	それは、入江の岸にそって、ぷかぷかと流れていました。
She was swimming toward the bank where Fatty was hidden.	かめ夫人は、ふとっちょが隠れている岸辺にむかって、泳いできました。
And pretty soon she pulled herself out of the water and waddled a short distance along the sand at the edge of the creek.	泳ぎつくと、かめ夫人はすぐさま水から上がり、入江のほとりの砂の上を、よちよち歩き出しました。
Mrs. Turtle stopped then;	5 かめ夫人は、少し歩いたところで、立ち止まりました。
and for a few minutes she was very busy about something.	そして少しのあいだ、とても忙しそうになにかをしました。
First she dug a hole in the sand.	最初、彼女は砂に穴をほりました。
And Fatty wondered what she was looking for.	ふとっちょは、彼女はなにをさがしているのかしら、と思いました。
But he kept very quiet.	でも、ふとっちょはじっと静かに隠れつづけました。
And after a time Mrs. Turtle splashed into the creek again and paddled away.	しばらくすると、かめ夫人はまた入江の水にざぶんと入り、泳いで去っていきました。
But before she left she scooped sand into the hole she had dug.	けれど、彼女は立ち去る前に、ほった穴に砂をかけていきました。
Before she left the place she looked all around,	それから、辺りをぐるりと見まわしました。
as if to make sure that no one had seen her.	まるで、だれか彼女を見ていた者はいないかと、確かめるように。
And as she waddled slowly to the water Fatty could see that she was smiling	それから、川にむかってよちよちとゆっくり歩いていくとき、ふとっちょは、彼女がほほ笑んでいるのを見ました。
as if she was very well pleased about something.	まるで、大いに満足しているというように。
She seemed to have a secret.	かめ夫人は、ひみつを隠しているように見えました。
Fatty Coon had grown very curious, as he watched Mrs. Turtle.	6 かめ夫人をぬすみ見ているうちに、ふとっちょあらいぐまは、ひどく興味をかき立てられました。
And just as soon as she was out of sight he came out from his hiding place in the tall reeds and trotted down to the edge of the creek.	彼女の姿が見えなくなると、ふとっちょはすぐさま隠れていた背の高いイグサの草むらからとび出し、小走りで入江のほとりに下りていきました。
He went straight to the spot where Mrs. Turtle had dug the hole and filled it up again.	かめ夫人が穴をほり、また埋めもどした場所に、まっすぐに向かいました。
And Fatty was so eager to know what she had been doing	彼女がしたことがなんだったのか、知りたくてたまりませんでした。
that he began to dig in the very spot where Mrs. Turtle had dug before him.	足元のかめ夫人がほった場所を、ほり返しはじめました。
It took Fatty Coon only about six seconds to discover Mrs. Turtle's secret.	7 ほんの六つ数えるうちに、ふとっちょあらいぐまは、かめ夫人のひみつを発見しました。
For he did not have to paw away much of the sand	そこは深い砂でできた川岸だったので、前足のかぎづめを使わなくても、かんたんにほれました。
before he came upon	目の前にあらわれたのは
--what do you suppose?	――なんだと思いますか？
Eggs!	卵です！
Turtles' eggs!	かめの卵です！
Twenty-seven round, white eggs,	二十七個の、丸くて白い卵です。
which Mrs. Turtle had left there in the warm sand to hatch.	かめ夫人は、卵をかえすために、あたたかい砂の中に埋めておいたのです。
THAT was why she looked all around to make sure that no one saw her.	それこそが、彼女がだれも見ていないかと、辺りをぐるりと確かめたわけだったのです。
THAT was why she seemed so pleased.	それこそが、とても満足そうだったわけなのです。
For Mrs. Turtle fully expected	かめ夫人は、期待で胸をふくらませていたのです。
that after a time twenty-seven little turtles would hatch from those eggs	しばらくしたら、これらの卵から二十七ひきの子がめがかえるのだと思って
--just as chickens do	――ちょうどニワトリのようにね
--and dig their way out of the sand.	――そして、自分で砂をかき分けて、穴の中から出てくるでしょう。
But it never happened that way at all.	8 けれど、決してそうはなりませんでした。
For as soon as he got over his surprise at seeing them, Fatty Coon began at once to eat those twenty- seven eggs.	ふとっちょあらいぐまは、卵を見つけたおどろきからさめるやいなや、ただちに二十七個の卵にぱくつきはじめました。
They were delicious.	おいしい卵でした。
And as he finished the last one he couldn't help thinking how lucky he had been.	最後のひとつを食べおわるころには、なんて幸運だったんだろうと思わずにはいられませんでした。
FATTY COON'S MISTAKE	ふとっちょあらいぐまのしくじり
Fatty Coon was very fond of squirrels.	1 ふとっちょあらいぐまは、リスが大好きでした。
And you may think it strange when I tell you	そして、こんなふうにお話すると、おかしいと思うでしょう。
that not one of the squirrels anywhere around Blue Mountain was the least bit fond of Fatty Coon.	ブルー山に住んでいるリスたちの中で、ふとっちょあらいぐまをほんの少しでも好いている者は、一ぴきもいませんでした、なんて。
But when I say that Fatty Coon was fond of squirrels, I mean that he liked to eat them.	しかし、ふとっちょあらいぐまがリスが好きだというときは、食べるのが好きだという意味なのです。
So of course you will understand now why the squirrels did not care for Fatty at all.	ですから、リスたちがふとっちょのことを嫌っているわけは、もちろん、もうおわかりでしょう。
In fact, they usually kept just as far away from him as they could.	実際のところ、リスたちはいつも、ふとっちょからできるだけ遠ざかっているようにしていました。
It was easy, in the daytime, for the squirrels to keep out of Fatty's way, when he wandered through the tree-tops,	2 昼中ならば、木のてっぺんからてっぺんへとうろつき回るふとっちょを避けているのは、リスたちには簡単でした。
for the squirrels were much sprier than Fatty.	リスたちは、ふとっちょよりもずっとよく、相手を見つけ出すことができました。
But at night	けれど、夜は
--ah!	――ああ！
that was a very different matter.	事情がずいぶんちがうのです。
For Fatty Coon's eyes were even sharper in the dark than they were in the daylight;	ふとっちょあらいぐまの目は、昼中のリスたちよりも、夜の暗やみのほうが、いっそうするどいのです。
but the poor squirrels were just as blind as you are when you are safely tucked in bed and the light is put out.	しかし、哀れなリスたちは、みなさんが寝室の明かりを消し、ベッドの毛布に安全にくるまっているときと同じくらい、なんにも見えないのです。
Yes	3 そうなのです
--when the squirrels were in bed at night, up in their nests in the trees,	――夜になると、リスたちは、木の上の巣穴の寝どこに入ります。
they could see very little.	彼らはほんの少ししか、見ることができません。
And you couldn't say they were SAFE in bed,	そして、彼らが寝どこの中にいるときは、安全とは言えません。
because they never knew when Fatty Coon,	なぜなら、ふとっちょあらいぐまがリスをつかまえにやって来ても、彼らには決してわからないからです。
or his mother, or his brother, or one of his sisters, or some cousin of his, might come along and catch them before they knew it.	または、ふとっちょのお母さんや、弟や、妹のどちらかか、あるいはふとっちょのいとこがやって来ても、つかまえられる前にそうと知ることができないのです。
Fatty thought it great sport to hunt squirrels at night.	4 ふとっちょは、夜のリス狩りを、とても楽しい気晴らしと考えていました。
Whenever he tried it he usually managed to get a good meal.	リス狩りをすれば、いつでもつねに、おいしい肉を手に入れることができました。
And after he had almost forgotten about the fright the goshawk had given him in the tall hemlock he began to roam through the tree-tops every night in search of squirrels and sleeping birds.	ヘムロックの大木でオオタカにおそわれた恐ろしさを、おおかた忘れかけてからは、彼はリスや眠っている鳥をさがして、毎晩のように木のてっぺんをうろつき回るようになりました。
But a night came at last when Fatty was well punished for hunting squirrels.	5 しかし昨日の晩は、リス狩りをしていて、こりごりする目にあいました。
He had climbed half-way to the top of a big chestnut tree, when he spied a hole in the trunk.	ふとっちょは、大きなクリの木を半分ほど登ったところで、幹に空いた穴をのぞき込みました。
He rather thought that some squirrels lived inside that hole.	その穴の中に、リスが住んでいるにちがいないと思い込んだのです。
And as he listened for a few seconds he could hear something moving about inside.	しばらく耳をすませていると、中でなにかが動く物音が聞こえました。
Yes!	しめしめ！
Fatty was sure that there was a squirrel in there	ふとっちょは、中にリスがいると確信しました
--probably several squirrels.	――数ひきのリスがいるのだろうと。
Fatty Coon's eyes turned green.	6 ふとっちょあらいぐまの目が、緑色に変わりました。
It was a way they had,	それがあらいぐまのくせなのです。
whenever he was about to eat anything, or whenever he played with his brother Blackie, or Fluffy and Cutey, his sisters; or whenever he was frightened.	食べるときや、弟の黒っちょや妹のふわりっちょやかわいっちょと遊ぶとき、おびえているときなど、どんなときでも、こうなるのです。
And now Fatty was so sure that he was going to have a fine lunch that his eyes turned as green as a cat's.	今は、おいしいおやつを食べられるのだと確信したので、ネコみたいに目が緑色に変わったのです。
He reached a paw inside the hole and felt all around.	彼は前足を穴の中に入れ、中をさぐり回りました。
WOW!	7 ウワア！
Fatty gave a cry;	ふとっちょはさけび声を上げました。
and he pulled his paw out much faster than he had put it in.	前足を、入れたときよりもはるかにはやく、出しました。
Something had given him a cruel dig.	なにかが、彼の手をひどく強く突きとばしたのです。
And in a jiffy Fatty saw what that "something" was.	〝なにか〟はすぐにわかりました。
It was a grumpy old tramp coon, whom Fatty had never seen before.	ふとっちょがこれまで見かけたことのない、気むずかしそうな顔をした、年老いた浮浪あらいぐまでした。
"What do you mean, you young rascal,	8 「どういうつもりだ、いたずらっ子め。
by disturbing me like this?"	こんなふうに休んでいるところを邪魔するのは？」
the ragged stranger cried.	みすぼらしいよそ者が、さけびました。
"Please, sir,	9 「ごめんなさい。
I never knew it was you,"	あなただとは思いもしなかったんです」
Fatty stammered.	ふとっちょは、口ごもりながら言いました。
"Never knew it was me!	10 「思いもしなかっただと！
Who did you think it was?"	だれだと思ったんだ？」
"A--a squirrel!"	11 「リ……リスだと思って！」
Fatty said faintly.	ふとっちょは、消え入りそうな声で言いました。
And he whimpered a little,	彼はちょっぴりべそをかきました。
because his paw hurt him.	前足で、浮浪あらいぐまを引っかいてしまったからです。
"Ho, ho!	12 「ほ、ほう！
That's a good one!	そりゃあいい！
That's a good joke!"	おもしろい冗談だ！」
The tramp coon laughed heartily.	浮浪あらいぐまは、心の底からおかしそうに笑い声を立てました。
And then he scowled so fiercely that poor Fatty nearly tumbled out of the tree.	それから、恐ろしい顔でふとっちょをにらみつけたので、ふとっちょはあやうく木から転がり落ちそうになりました。
"You go home,"	「家へ帰れ」
he said to Fatty.	浮浪あらいぐまは、ふとっちょに言いました。
"And don't you let me catch you around here again.	「今度ここに来たら、ただじゃおかんぞ。
You hear?"	聞こえたか？」
"Yes, sir!"	13 「はい、わかりました！」
Fatty said.	ふとっちょは言いました。
And home he went.	そして、家に帰りました。
And you may be sure that he let THAT tree alone after that.	その後、ふとっちょがその木をそうっとしておいたことを、みなさんも疑わないでしょう。
He never went near it again.	ふとっちょは、二度とその木に近づきませんでした。
FATTY COON GOES FISHING	ふとっちょあらいぐまと魚つり
One day Fatty Coon was strolling along the brook which flowed not far from his home.	1 ある日、ふとっちょあらいぐまは、家からそれほど遠くないところを流れる小川をうろついていました。
He stopped now and then, to crouch close to the water's edge,	水辺のふちで、あっちこっちで立ち止まっては、うずくまりました。
in the hope of catching a fish.	魚は取れないかと思っていたのです。
And one time, when he lay quite still among the rocks, at the side of a deep pool,	あるとき彼は、小川の深いよどみのほとりの岩のあいだに横たわり、静かにじっとしていました。
with his eyes searching the clear water,	目は、すきとおった水の中をさぐっていました。
Fatty Coon suddenly saw something bright,	ふいに、なにやら光るものを見つけました。
all yellow and red, that lighted on the water right before him.	全身が黄色と赤色をしたものが、ふとっちょあらいぐまの右手前方の水の上で、ぴかぴか光っていました。
It was a bug,	カブトムシだ。
or a huge fly.	それか、大きなハエだ。
And Fatty was very fond of bugs	ふとっちょは、カブトムシが大好きでした
--to eat, you know.	――食べるのが、ね。
So he lost no time.	ですから、ぐずぐずしませんでした。
The bright thing had scarcely settled on the water	その光るものは、水の上でちょこちょこ動きまわり、少しもじっとしていませんでした。
when Fatty reached out and seized it.	ふとっちょは、すきを見て前足を伸ばし、それをつかみ取りました。
He put it into his mouth, when the strangest thing happened.	それを口の中にほうり込むと、たいそうおかしなことが起こりました。
Fatty felt himself pulled right over into the water.	ふとっちょの体が右側にぐいと引っぱられ、水の中に引きずり込まれたのです。
He was surprised,	2 ふとっちょはおどろきました。
for he never knew a bug or a fly to be so strong as that.	カブトムシやハエの力がこれほど強いとは、聞いたこともありませんでしたから。
Something pricked his cheek	なにかがふとっちょのほっぺたをちくりと刺しました。
and Fatty thought that the bright thing had stung him.	彼は、光るものが刺したのだと思いました。
He tried to take it out of his mouth, and he was surprised again.	光るものを口から出そうとして、またおどろきました。
Whatever the thing was, it seemed to be stuck fast in his mouth.	光るものは、彼の口の中にしっかりと突きささり、なにがなんでも離れないようでした。
And all the time Fatty was being dragged along through the water.	そのあいだ、ふとっちょは、水の中を引きずられ続けていました。
He began to be frightened.	彼は、恐くなってきました。
And for the first time he noticed that there was a slender line	最初に気づいたのは、細い糸でした。
which stretched from his mouth straight across the pool.	それは、彼の口から伸びて、小川のよどみの向こうへとまっすぐに続いていました。
As he looked along the line Fatty saw a man at the other end of it	糸をずっとたどっていきますと、糸のとぎれれた先に、人間がいるのが見えました
--a man, standing on the other side of the brook!	――人間が、小川の反対岸に立っていました！
And he was pulling Fatty toward him as fast as he could.	人間は、できるかぎりのはやさで糸をたぐり、ふとっちょを自分のほうに引きよせていました。
Do you wonder that Fatty Coon was frightened?	3 みなさんは、ふとっちょあらいぐまが、ただおびえていただけだったと思いますか？
He jumped back	彼は、後ろに飛びすざりました
--as well as he could, in the water	――水の中で、できるかぎりそうしました
--and tried to swim away.	――そして、泳いで逃げようとしました。
His mouth hurt;	口の中をけがしました。
but he plunged and pulled just the same,	それでもひるまずに、変わらない強さで、水の中にもぐったり、後ろに引いたりしました。
and jerked his head and squirmed and wriggled and twisted.	頭をぐいぐい引っぱったり、もがいたり、身をよじったり、のたうったりしました。
And just as Fatty had almost given up hope of getting free, the gay-colored bug, or fly, or whatever it was, flew out of his mouth	もう逃げられないと、ほとんどあきらめかけた、まさにそのとき、派手な色のカブトムシだか、ハエだか、とにかくなんだかが、ふとっちょの口の中から飛び出しました。
and took the line with it.	それと一緒に、糸もどこかに飛んでいきました。
At least, that was what Fatty Coon thought.	少なくとも、ふとっちょあらいぐまはそう思いました。
And he swam quickly to the bank and scampered into the bushes.	ふとっちょは急いで川岸まで泳ぎ、やぶの中に逃げ込みました。
Now, this was what really happened.	4 さて、これは本当に起こったできごとでした。
Farmer Green had come up the brook to catch trout.	農夫のグリーンは、マスを取りに小川にやって来ました。
On the end of his fish-line he had tied a make-believe fly,	グリーンは、つり糸の先に、ぎじ餌を結んでおきました。
with a hook hidden under its red and yellow wings.	赤と黄色の羽根のうら側に、つり針が隠されているものです。
He had stolen along the brook very quietly,	彼は、小川の流れにそって、とても静かにぎじ餌を動かしました。
so that he wouldn't frighten the fish.	魚をおどろかせないためです。
And he had made so little noise that Fatty Coon never heard him at all.	とても少ししか物音を立てなかったので、ふとっちょあらいぐまは、グリーンにまったく気づきませんでした。
Farmer Green had not seen Fatty,	農夫のグリーンには、ふとっちょの姿が見えませんでした。
crouched as he was among the stones.	ふとっちょは、岩のあいだでかがんでいましたから。
And when Fatty reached out and grabbed the make-believe fly Farmer Green was even more surprised at what happened than Fatty himself.	ふとっちょがぎじ餌に手を伸ばしてつかみ取ったとき、農夫のグリーンは、ふとっちょ自身よりもなおいっそう、このできごとにおどろきました。
If the fish-hook hadn't worked loose from Fatty's mouth Farmer Green would have caught the queerest fish anybody ever caught, almost.	ふとっちょの口からつり針が外れなければ、農夫のグリーンはもうちょっとで、これまでだれ一人つったことのないような、奇妙な魚をつり上げるところでした。
Something seemed to amuse Farmer Green, as he watched Fatty dive into the bushes;	5 農夫のグリーンは、ふとっちょがやぶの中に逃げ込むのをながめながら、ひどくおもしろがっているようでした。
and he laughed loud and long.	彼は、長いこと大声でげらげら笑っていました。
But Fatty Coon didn't laugh at all.	でも、ふとっちょあらいぐまは、ちっとも笑いませんでした。
His mouth was too sore; and he was too frightened.	口の中があまりにもひどく痛んでいたし、ひどくおびえてもいたのです。
But he was very, very glad	でも、とてもとても、よろこんでもいました。
that the strange bug had flown away.	おかしなカブトムシが、どこかに飛んでいってくれたのですから。
FATTY AND THE GREEN CORN	ふとっちょとグリーン農場のとうもろこし
It was mid-summer when Fatty Coon had what he then believed to be the finest time in all his life.	1 その夏のさかり、ふとっちょあらいぐまは、一生のうちでいちばん素晴らしい時をすごしていると信じていました。
And later, when he was older, he still thought	のちになり、年寄りになってもまだ、そう思っていました。
that nothing had ever happened to him that was quite so enjoyable as that surprise his mother gave him when he was a young coon.	彼が幼いあらいぐまだったとき、お母さんがびっくりするところに連れていってくれたときのような楽しい出来事は、二度となかったのです。
Of course it was something to eat	2 もちろん、食べるところですよ
--the surprise.	――びっくりするところというのは。
You must have guessed that, knowing Fatty Coon as you do.	みなさんは、ふとっちょあらいぐまのことはもうご存知ですから、きっとそうだろうとお思いになったでしょう。
"Come, children!"	3 「おいで、子どもたち！」
Mrs. Coon said.	あらいぐま夫人が言いました。
"Come with me!	「わたしについておいで！
I'm going to give you a treat	びっくりするようないいところに連れてったげるよ
--something specially nice."	――とっておきのすてきなところだよ」
"Is it something to eat?"	4 「食べにいくの？」
Fatty asked,	ふとっちょがたずねました。
as they started off in the direction of Farmer Green's fields.	ふとっちょたちは、農夫のグリーンの農場にむかって歩いていました。
"Yes	5 「そうよ
--and the best thing you ever tasted,"	――お前がこれまで食べた中で、いちばんおいしいごちそうだよ」
Mrs. Coon said.	あらいぐま夫人が言いました。
Fatty was greatly excited.	6 ふとっちょは大いに興奮しました。
His little bright eyes turned green in the moonlight.	月明かりの下で、彼のつぶらなかがやく目が、緑色に変わりました。
He wondered what the surprise would be.	どんなびっくりするごちそうがあるのかしらと思いました。
And, as usual, he was very hungry.	いつものことですが、彼は腹ぺこでした。
He walked close beside his mother,	彼は、お母さんにぴったりくっついて歩きました。
for he wanted to be the first to taste the surprise.	びっくりするようなごちそうを、まっさきに味見したかったからです。
You would think that he would have wanted his two sisters to taste it first,	みなさんは、ふとっちょが二人の妹に最初に味見させてあげると思うでしょう。
and his brother Blackie, too.	それに、弟の黒っちょにも。
But you must not forget that Fatty was greedy.	しかし、ふとっちょは食いしんぼうだということを忘れてはなりません。
And greedy people are not thoughtful of others.	食いしんぼうというのは、ほかの人を思いやったりしないものなのです。
When Mrs. Coon turned out of the lane and crawled through the fence,	7 あらいぐま夫人は、小道をわきに反れ、柵の下を腹ばいになってくぐり抜けました。
Fatty squeezed between the rails	ふとっちょは、横木のすきまを無理やり通り抜けました。
very nimbly, for him.	彼にしては、とても素早い身のこなしでした。
"Here we are!"	8 「ここだよ！」
said his mother.	お母さんが言いました。
Fatty looked about him.	9 ふとっちょは辺りを見まわしました。
They stood in a field grown high with tall stalks of some sort,	そこは、背の高い茎の植物が空高く生いしげった畑の中でした。
which turned to green, ribbon-like leaves half way up from the ground.	茎の植物は青あおと色づき、リボンのような形の葉っぱは、根もとから半分だけ空にむいて立ちあがり、先っぽはひらひらと垂れ下がっていました。
Fatty grunted.	ふとっちょは、不満にうめき声をあげました。
He was very impolite, you see.	とてもおぎょうぎが悪いですよね。
"Well	10 「ねえ
--what is there to eat that's so fine?"	――おいしい食べ物ってなんなのさ？」
he asked.	ふとっちょは言いました。
"This stuff isn't good.	「こんなのおいしくないじゃないか。
It's like eating reeds."	アシみたいな味がするよ」
He had already bitten into one of the stalks.	彼は、すでに茎の一本をかじっていました。
"What do you call that?"	11 「あれはなんと呼ぶの？」
Mrs. Coon asked.	あらいぐま夫人がたずねました。
She showed Fatty a long roll of green that grew out of one of the stalks.	彼女は、茎の一本から伸びている、緑色の皮で巻かれた長いものを、ふとっちょに指ししめしました。
"That's something like a cattail,"	12 「ガマの穂みたいなやつさ」
said Fatty.	ふとっちょが言いました。
"It isn't good to eat."	「食べたっておいしくないよ」
"Have you ever tried one?"	13 「食べてみたことがあるのかい？」
asked his mother.	お母さんがたずねました。
"N--no,"	14 「ううん」
Patty said.	ふとっちょは言いました。
"But Freddie Bluejay told me they weren't good."	「でも、アオカケスのフレディがおいしくないって言ったよ」
"He did, did he?"	15 「フレディがそう言ったの？」
Mrs. Coon said nothing more.	あらいぐま夫人は、それ以上なにも言いませんでした。
She stood up on her hind legs and pulled one of the tall stalks down	彼女は後足で立ちあがると、背の高い茎の一本を、下に引っぱりました。
until she could reach that long, green thing that grew there.	そして、茎から伸びている緑色の皮に巻かれた長いものを、前足でつかみました。
In a jiffy she had torn it from its stalk.	次の瞬間、彼女は茎から緑色の長いものをもぎ取りました。
And then she stripped the green covering off it.	それから、長いものから緑色の皮をはぎ取りました。
"Try that!"	「かじってごらん！」
said Mrs. Coon with a smile.	あらいぐま夫人は、にっこり笑って言いました。
Of course it was Fatty who tasted it first.	16 もちろん、ふとっちょがまっさきに味見しました。
He took a good mouthful of the white kernels,	彼は、白い粒つぶを口いっぱいにほおばりました。
and he was overjoyed.	そして、大喜びしました。
Such sweetness!	なんて甘いんだろう！
Such delicious, milky juice!	このまったりとした汁のおいしさはどうだろう！
It was a moment that Fatty never forgot.	この瞬間のことを、ふとっちょは生涯忘れませんでした。
Fatty began tearing down the stalks for himself	17 ふとっちょは、自分で茎からもぎ取り始めました。
and he never said another word until at last he simply had to stop eating just to catch his breath.	そして、ひと息つくためにとうとう食べるのを止めるまで、ひと言もしゃべりませんでした。
"What's its name, Mother?"	18 「これはなんという名前なの、お母さん？」
he inquired.	ふとっちょがたずねました。
"Corn, my child."	19 「とうもろこしと言うんだよ、ぼうや」
"Well, why doesn't Freddie Bluejay like it?"	20 「アオカケスのフレディは、どうしてこれが嫌いなんだろう？」
Fatty asked.	ふとっちょが言いました。
"He's probably very fond of corn,"	21 「たぶん大好きなのさ」
said Mrs. Coon.	あらいぐま夫人は言いました。
"And I've no doubt he was afraid	「心配だったんだよ。
that you would eat up this whole field, once you started."	お前がこれを食べ始めたら、畑を全部食べつくしちまうんじゃないかってね」
"I'd like to,"	22 「そうしたいなあ」
said Fatty, with a sigh.	ふとっちょは、ため息まじりに言いました。
"I'd like to eat all the corn in the world."	「世界中のとうもろこしを全部食べちゃいたいよ」
VII JOHNNIE GREEN IS DISAPPOINTED	ジョニー・グリーン、がっかりする
It made Fatty Coon feel sad, just to think that there was that field full of corn,	1 ふとっちょあらいぐまは、畑いっぱいのとうもろこしのことを考えると、悲しくなってしまいました。
and that he could never eat all of it.	全部食べつくすなんて、絶対にできっこないのですもの。
But Fatty made up his mind	でも、ふとっちょは決心しました。
that he would do the best he could.	できるかぎりのことをしてやろうと。
He would visit the cornfield every night and feast on those sweet, tender kernels.	毎晩のようにとうもろこし畑をおとずれ、甘くて柔らかいとうもろこしの粒を満喫してやろうと。
The very next night Fatty set out toward Farmer Green's.	2 次の日、夜になると、ふとっちょはさっそく農夫のグリーンの畑に出発しました。
It was hardly dark.	とても暗いとは言えない夜でした。
But Fatty could not wait any longer.	でも、暗い夜がおとずれるまでなんて、待っていられませんでした。
He could not even wait for his mother and his sisters and his brother.	お母さんや妹たちや弟が出かけるのを待っていることすら、できませんでした。
He hurried away alone.	彼は、ひとりで先を急ぎました。
And when he came in sight of the cornfield he felt better.	とうもろこし畑が見えてくると、ほっとしました。
He had been the least bit afraid that the corn might be gone.	とうもろこしがなくなってしまうのではないかと、心配でしかたがなかったのです。
He thought that maybe Farmer Green had picked it, or that some of the forest people had eaten it all.	農夫のグリーンがつみ取ってしまうか、森の住民たちが全部たいらげてしまうかもしれないと、思っていたのです。
But there it was	でも、ちゃんとありました
--a forest of corn, waving and rustling in the moonlight as the breeze touched it.	――とうもろこしの森が、月光の下でそよ風に吹かれて、波うち、カサカサと音を立てていました。
Fatty felt very happy as he slipped through the rail-fence.	ふとっちょは大よろこびしながら、柵の横木をすり抜けました。
I wouldn't dare say how many ears of corn Fatty ate that night.	3 その晩、ふとっちょはとうもろこしの実を、おそらくいくらも食べはしなかったでしょう。
And he would have eaten more, too, if it hadn't been for just one thing.	それに、あるたった一つのものがなければ、もっとたくさん食べられた、とも言えなかったでしょう。
A dog barked.	一ぴきの犬が吠え声を立てました。
And that spoiled Fatty's fun.	それで、ふとっちょの楽しみは台なしになってしまいました。
For the dog was altogether too near for Fatty to feel safe.	犬の吠え声は、ふとっちょが危険にかんじるほど、とても近いところで聞こえました。
He even dropped the ear of corn he was gnawing	彼がかじりかけのとうもろこしの実をほうり出すほどの、近い場所でした。
and hurried toward the woods.	ふとっちょは、森にむかって急いで逃げ出しました。
It was lucky for Fatty that he started when he did.	4 すぐに駆け出したのは、ふとっちょにとって幸運でした。
For that dog was close behind him in no time.	時間をおかずに、犬が彼の背後にせまってきたからです。
There was only one thing to do:	することは一つしかありません。
Fatty knew that he must climb a tree at once.	ただちに木に登らなければいけないということを、ふとっちょは知っていました。
So he made for the nearest tree in sight	それで、まぢかにあって目に入ったおあつらえ向きの木に登りました
--a big, spreading oak,	――大きくて、枝が横に広がった、オークの木でした。
which stood all alone just beyond the fence.	その木は、柵の上におおいかぶさるようにして、一本だけ森から離れて立っていました。
And as Fatty crouched on a limb he felt safe enough,	ふとっちょは大枝の上でうずくまると、すっかり安全になったように思いました。
though the dog barked and whined, and leaped against the tree, and made a great fuss.	それなのに犬は、吠えたり、鼻を鳴らしたり、木に飛びついたり、たいそう大騒ぎしました。
Fatty looked down at the dog and scolded a little.	5 ふとっちょは犬を見下ろして、少々しかってやりました。
He was not afraid.	犬は恐くありませんでした。
But it made him cross to be driven out of the cornfield.	けれど、とうもろこし畑から追い払われたことで、腹が立ちました。
And he wished the dog would go away.	犬なんかどこかに行ってしまえばいいのにと思いました。
But the dog	けれど犬は
--it was Farmer Green's Spot	――農夫のグリーンの飼犬で、スポットといいました
--the dog had no idea of leaving.	――立ち去るつもりはありませんでした。
He stayed right there and barked so loudly	犬は木の下にいつづけて、ひどく大声で吠え立てました。
that it was not long before Farmer Green and his hired man came in sight.	ほどなくすると、農夫のグリーンと農場の作男がやって来る姿が見えました。
And with them was Johnnie Green and a little, young dog that had just been given to him.	ジョニー・グリーンと、つい最近ジョニーがもらった小さな子犬も、彼らと一緒でした。
When Farmer Green saw Fatty he seemed disappointed.	6 農夫のグリーンは、ふとっちょを見て、がっかりした様子でした。
"He's too young to bother with,"	「手をわずらわすには小さすぎる」
he said.	と、グリーンは言いました。
"His skin's not worth much.	「あいつの毛皮はいくらにもならんよ。
We'll go 'long and see what we can find."	行こう、ほかにいるか探そう」
But Johnnie Green stayed behind.	7 けれど、ジョニー・グリーンはあとに残りました。
He wanted that young coon.	彼は、あのあらいぐまの子が欲しかったのです。
And he intended to have him, too.	そして、つかまえるつもりでもありました。
Leaving the young dog to watch Fatty Coon, Johnnie went back to the farmhouse.	子犬をふとっちょあらいぐまの見張りに残して、ジョニーは農家の母屋に戻りました。
After a while he appeared again with an axe over his shoulder.	しばらくすると、ジョニーは肩に斧をかついだ姿で、またあらわれました。
And when he began to chop away at the big oak,	そして、オークの大木を切り始めました。
Fatty Coon felt very uneasy.	ふとっちょあらいぐまは、ひどく不安になりました。
Whenever Johnnie drove his axe into the tree, both the tree and Fatty shivered together.	ジョニーが斧を木にたたき込むたびに、木と一緒にふとっちょもふるえました。
And Fatty began to wish he had stayed away from the cornfield.	ふとっちょは、とうもろこし畑から逃げ出せたらいいのにと願い始めました。
But not for long,	しかし、それも長いことではありませんでした。
because Johnnie Green soon gave up the idea of chopping down the big oak.	ジョニー・グリーンが、オークの大木を切りたおすという考えを、さっさとあきらめたからです。
The wood was so hard to cut, and the tree was so big,	木は、切るのには固すぎ、そして大きすぎました。
that Johnnie had not chopped long before he saw that it would take him all night to cut through it.	長い時間かかったのちに夜通しかかることが分かる前に、ジョニーは切るのを止めました。
He looked up longingly at Fatty Coon.	ジョニーは、もの欲しげにふとっちょあらいぐまを見上げました。
And Johnnie started to climb the tree himself.	そして、彼みずから木に登り始めました。
But the higher he climbed, the higher Fatty climbed.	けれど、ジョニーが登ると、ふとっちょはそれだけ上に登りました。
And Johnnie knew that he could never catch that plump young coon in that way.	このやり方では、ふとったあらいぐまの子を決してつかまえられないことを、ジョニーは知りました。
At last Johnnie Green started off,	8 とうとう、ジョニー・グリーンは歩き出しました。
calling his dog after him.	子犬も、彼に呼ばれてあとについていきました。
And then Fatty Coon came down.	それから、ふとっちょあらいぐまは下におりました。
But he did not go back to the cornfield.	でも、とうもろこし畑には戻りませんでした。
He decided that he had had adventures enough for one night.	ひと晩の冒険としてはもうじゅうぶん、ということにしたのです。
But Fatty had learned something	けれど、学ぶことはありました
--at least he thought he had.	――少なくとも、ふとっちょはそう思いました。
For he made up his mind that once he climbed a tree, no man could reach him.	いったん木に登ってしまえば、人間はだれも彼に触れることができないのだと、決め込んだのです。
TREES COULD NOT BE CHOPPED DOWN!	〈木を切りたおすことはできない！〉
That was what Fatty believed.	と、ふとっちょは信じ込んでしまったのです。
Perhaps you will know, later, whether Fatty ever found out that he was mistaken.	いつか、ふとっちょが間違いだったと知るときが来るのかどうか、みなさんはたぶんあとでお分かりになるでしょう。
VIII A TERRIBLE FRIGHT	ぞっとするような恐怖
It was the very next night after old dog Spot had treed Fatty Coon in the big oak near the cornfield.	1 ふとっちょあらいぐまが、老犬スポットに追われてとうもろこし畑のそばのオークの大木に登った、次の晩でした。
They had finished their evening meal at Farmer Green's house.	農夫のグリーンの家では、夕食を食べおわったところでした。
The cows were milked, the horses had been fed, the chickens had all gone to roost.	牛の乳をしぼり、馬にかいばをやり、ニワトリはすべて鳥小屋の中にしまわれました。
And Farmer Green looked up at the moon, rising from behind Blue Mountain.	農夫のグリーンは、ブルー山の山かげからのぼる月を見上げました。
"We'll go coon-hunting again to-night,"	2 「今夜もあらいぐま狩りに行くぞ」
he said to Johnnie and the hired man.	彼は、ジョニーと作男に言いました。
"The corn has brought the coons up from the swamp.	「沼のあらいぐまども、とうもろこしにつられてまた出て来るはずだ。
We'll start as soon as it grows a little darker."	月が少しかげったら、すぐ出発だぞ」
Well	3 さあ
--after a while they set out for the cornfield.	――しばらくすると、彼らはとうもろこし畑に出かけました。
And sure enough!	やっぱりです！
old Spot soon began to bark.	老犬スポットが、ほえ始めました。
"He's treed!"	4 「スポットが木に追いこんだぞ！」
said Farmer Green, pretty soon.	すぐさま農夫のグリーンが言いました。
And they all hurried over to the edge of the woods,	彼らはそろって、森のふちを目指して急ぎました。
where Spot had chased a coon up into a tall chestnut tree.	そこでスポットが、あらいぐまを背の高いクリの木に追いこんでいました。
In the moonlight they could see the coon quite plainly.	月明かりの下で、彼らはあらいぐまの姿をまざまざと見ることができました。
"Another little feller!"	「別のちっこいやつだ！」
cried Farmer Green.	農夫のグリーンがさけびました。
"I declare,	「まいったね。
all the coons that come to the cornfield seem to be young ones.	とうもろこし畑にやって来るあらいぐまは、どれもこれも子どもなのかい。
This one's no bigger than the one we saw last night."	昨日の晩おれたちが見たやつよりも、小さいじゃないか」
Now, although Farmer Green never guessed it, it was Fatty Coon who was up there in the tall chestnut.	5 とはいうものの、農夫のグリーンには、高い木の上にいるのがふとっちょあらいぐまだということなど、わかりっこありませんでした。
He had run almost to the woods this time,	ふとっちょはこのとき、もう少しで森の中に逃げこむところでした。
before he had to take to a tree.	ですが、その手前で、木に登らねばなりませんでした。
In fact, if Spot hadn't been quite so close to him Fatty could have reached the woods, and then he would have just jumped from one tree to another.	じつのところ、スポットがあれほど近くまでふとっちょにせまらなかったら、ふとっちょは森の中にたどり着き、木から木へと飛び移って逃げ去ることができました。
But there were no trees near enough the big chestnut for that.	しかし、大きなクリの木のまわりには、飛び移れるほど近くに木がなかったのです。
Fatty had to stay right there and wait for those men to pass on.	ふとっちょはそこにとどまり、人間たちが行ってしまうまで待たねばなりませんでした。
He wasn't afraid.	彼は、おそれてはいませんでした。
He felt perfectly safe in his big tree.	大きな木の上で、すっかり安心しきっていました。
And he only smiled when Johnnie Green said to his father--	ジョニー・グリーンが父親にこう言ったときも、彼はほほ笑みを浮かべただけでした――
"I wish I had that young coon.	6 「ぼく、あのあらいぐまの子がほしいよ。
He'd make a fine pet."	あいつはかわいいペットになるよ」
"A pet!"	7 「ペットだと！」
exclaimed Farmer Green.	農夫のグリーンがさけびました。
"You remember that pet fox you had, that stole my chickens?"	「キツネをペットにして、ニワトリを盗まれたのを忘れたのか？」
"Oh, I'd be careful,"	8 「気をつけるからさ」
Johnnie promised.	ジョニーは約束しました。
"Besides, don't you think we ought to catch him,	「それに、つかまえたほうがいいと思わないの？
so he won't eat any more corn?"	そうすれば、あいつももうとうもろこしを食べないよ」
Farmer Green smiled.	9 農夫のグリーンはほほ笑みました。
He had been a boy himself, once upon a time,	彼自身も、大昔は少年でした。
and he had not forgotten the pet coon that he had owned when he was just about Johnnie's age.	ちょうどジョニーくらいの年ごろに、あらいぐまをペットにしたことがあったのを忘れてはいなかったのです。
"All right!"	10 「いいだろう！」
he said at last.	グリーンはとうとう言いました。
"I'll give you one more chance, Johnnie.	「もう一度だけチャンスをやるぞ、ジョニー。
But you'll have to see that this young coon doesn't kill any of my poultry."	だが、あのあらいぐまの子がおれの鳥を殺さないよう、おれが見張るはめになるんだろうな」
Johnnie promised that nothing of the sort should happen.	11 ジョニーは、そのようなことにはならないと約束しました。
And then his father and the hired man picked up their axes;	それから、彼の父親と作男は、斧をとり上げました。
and standing on opposite sides of the tall chestnut tree, they began to chop.	ふたりは高いクリの木をはさんで向かい合わせに立つと、木を切り始めました。
How the chips did fly!	12 なんとまあ、木くずが飛ぶこと！
At the very first blow Fatty knew	最初の一げきから、ふとっちょにもわかりました。
that this was an entirely different sort of chopping from that which Johnnie had attempted the night before.	今度のは、前の晩にジョニーがしようとしたのとは、切り方がまるでちがいました。
The great tree shook as if it knew that it would soon come crashing down upon the ground.	大木はまるで、ほどなくして地面に打ちたおされることを知っているかのように、身をふるわせました。
And as for Fatty Coon, he could not see but that he must fall when the tree did.	13 ふとっちょあらいぐまはというと、先のことはわかりませんでしたが、木がたおされるときには自分も落ちるのだろうと思いました。
He, too, shivered and shook.	彼もまた、恐ろしさに身をふるわせました。
And he wrapped himself all the way around a limb and hung on as tight as ever he could.	大枝のまわりに自分の体をすっかり巻きつけ、できるだけしっかりとしがみつき、じっと動かないようにしました。
JOHNNIE GREEN LOSES HIS PET	ジョニー・グリーン、ペットをとり逃す
Now, Farmer Green and his hired man had not chopped long before they stopped to breathe.	1 さて、農夫のグリーンと作男は、すぐに木を切るのを止め、息をつきました。
They had not chopped long	ふたりは少しの間しか切っていませんでした
--but oh!	――けれど、まあ！
what great, yawning holes they had made in the big chestnut!	大きなクリの木に、大きな穴がぱっくりと口を開いていました！
From the limb where he clung Fatty Coon looked down.	ふとっちょあらいぐまは、しがみついていた大枝から、下を見おろしました。
The tree no longer shook.	木はもうそれ以上ゆれませんでした。
And Fatty felt better at once.	ふとっちょは、また安心しました。
You see, he thought that the men would go away, just as Johnnie had gone away the night before.	ほら、前の晩のジョニーのように、行ってしまうのだと思ったものですからね。
But they had no such idea at all.	けれど彼らは、そんなつもりはちっともありませんでした。
"Which way are you going to fell her?"	2 「彼女をどっちに倒すんですかい？」
the hired man asked.	作男がたずねました。
He said HER, meaning the TREE, of course.	〈彼女〉というのは、〈木〉のことですよ、もちろんね。
"That way!"	3 「こっちだ！」
said Farmer Green, pointing toward the woods.	農夫のグリーンは、森のほうを指さして言いました。
"We'll have to drop her that way,	「こっちに倒さないといかん。
or she'll fall right across the road,	さもないと、彼女が道をすっかりふさいじまう。
and of course THAT would never do."	もちろん、そんなことは絶対にするわけにいかんよ」
"But will she clear the trees on the edge of the woods?"	4 「しかし、彼女、森のはしの木をなぎ倒しちまうんじゃないかね？」
The hired man appeared somewhat doubtful.	作男は、いくぶん疑わしげな顔をしました。
"Oh, to be sure	5 「ああ、たしかに
--to be sure!"	――たしかにな！」
answered Farmer Green.	農夫のグリーンが答えました。
And with that they set to work again.	6 そして、ふたりはふたたび仕事を始めました。
But this time they both chopped on the same side of the tree	けれど今度は、ふたりそろって木の同じがわを切りました
--the side toward the woods.	――森のほうのがわをです。
Now, if Fatty Coon was frightened before, you will believe that he was still more frightened when the big chestnut tree began to sag.	7 さて、前回ふとっちょあらいぐまがおびえたとしたら、大きなクリの木がかしぎ始めたとき、彼がますますおびえたことを、みなさんも疑わないでしょう。
Yes!	そうなのです！
it began to lean toward the woods.	クリの木が、森のほうに向かってかしぎ始めたのです。
Slowly, slowly it tipped.	ゆっくり、ゆっくり、かしいでいったのです。
And Fatty was scared half out of his mind.	ふとっちょは、恐ろしさに半分くるったようになりました。
He climbed to the very top of the tree,	彼は木のてっぺんに登りました。
because he wanted to get just as far away from those men as he could.	できるだけ人間たちから遠ざかっていたかったのです。
And there he waited.	そして、待ちました。
There was nothing else he could do.	ほかにどうすることも出来ません。
Yes!	そうですとも！
he waited until that awful moment should come when the tree would go crashing down upon the ground.	彼は、木が音をたてて地面に倒れる、来るべき恐ろしい瞬間がおとずれるのを待ちました。
What was going to happen to him then?	それから、なにが起きるのかしら？
Fatty wondered.	ふとっちょは、首をかしげました。
And while he was wondering there sounded all at once a great snapping and splitting.	彼が考えている間に、木が裂けるメリメリという大きな音が、一どきに鳴りひびきました。
And Fatty felt the tree falling, falling.	ふとっちょは、木がどんどん、どんどん、かしいでいくのをかんじました。
He could hear Johnnie Green shouting.	ジョニー・グリーンがさけび声をあげるのが聞こえました。
And he shut his eyes and held fast to his branch.	ふとっちょは、目をかたく閉じ、枝にしっかりとつかまりました。
Then came the crash.	それから、ドシンという衝撃におそわれました。
When Fatty Coon opened his eyes he expected to see Johnnie Green all ready to seize him.	8 目を開けたとき、ふとっちょあらいぐまは、ジョニー・グリーンがいまにも自分をつかまえようとしているところが見えるのだと思っていました。
But to his great surprise he was still far above the ground.	ところが、おどろいたことに、地面はまだずっと下のほうにありました。
You see, Farmer Green had been mistaken.	ですからね、農夫のグリーンは、勘ちがいをしていたのですよ。
Either the big chestnut tree was taller than he had guessed, or the woods were nearer than he had thought.	大きなクリの木は、グリーンが見当をつけていたよりもずっと高かったし、森は、彼が考えていたよりもずっと近かったのです。
For instead of dropping upon the ground, Fatty's tree had fallen right against another tree on the edge of the woods.	そのために、ふとっちょがしがみついていた木は、地面にたおれる代わりに、森のはしのほかの木の上にたおれかかったのです。
And there it lay, half-tipped over, with its branches caught fast in the branches of that other tree.	ほかの木の枝が、大きなクリの木の枝をしっかりととらえ、半分かしいだかっこうで横たわったのです。
It was no wonder that Johnnie Green shouted.	9 ジョニー・グリーンがさけび声をあげたのも、むりはありません。
And he shouted still more loudly when he saw Fatty scramble out of the big chestnut and into the other tree,	ふとっちょが大きなクリの木からとなりの木によじ登るのを見て、ジョニーはいっそう大きなさけび声をあげました。
and out of that tree and into another, and then out of THAT tree.	そこからまたとなりの木に移り、そのまたとなりの木に移ると、ジョニーの声はどんどん大きくなりました。
Fatty was going straight into the woods.	ふとっちょは、そのまま森に入っていきました。
It was no wonder that Johnnie Green shouted.	10 ジョニー・グリーンがさけび声をあげたのも、むりはありません。
For he had lost his pet coon.	自分のペットのあらいぐまを逃してしまったのですから。
He had lost him before he ever had him.	まだ一度もつかまえないうちからとり逃してしまったのですから。
And he was sadly disappointed.	ジョニーはひどくがっかりしました。
But Fatty Coon was not disappointed,	11 でも、ふとっちょあらいぐまは、がっかりしませんでした。
for he had not wanted to be a pet at all.	ペットになんか、ちっともなりたくなかったのですから。
And he was very glad	そして、大よろこびしました
--you may be sure	――みなさんだってそうでしょう
--to get safely home once more.	――ふたたび安全なわが家に帰ることができるのですから。
FATTY COON AND THE MONSTER	ふとっちょあらいぐまと怪物
One night Fatty Coon was strolling along the road that wound through the valley.	1 ある晩、ふとっちょあらいぐまは、くねくねと曲がりくねった谷間の道を、ぶらぶら歩いていました。
He was in no hurry,	先を急いではいませんでした。
for he had just left Farmer Green's apple orchard, where he had bolted all the apples he could possibly eat.	農夫のグリーンのリンゴ畑で、食べられるだけのリンゴを飲みこむようにお腹に詰めこんできたばかりでしたから。
The night was dark and though it was not very late, all the country people seemed to be in bed.	まだそれほど夜おそくないというのに、辺りは暗く、この土地にくらす住民たちは、みなベッドに入って眠っているかのようでした。
There were no farmers driving along the road.	道を馬車で走ってくる農夫もいませんでした。
Fatty had it all to himself.	ふとっちょは、すべてが自分のものであるというような、いい気分になっていました。
And so he walked slowly homewards.	ですから、家路にむかってのんびり歩いていました。
It was then	そのときです。
that the terrible monster almost caught him.	恐ろしい怪物に、もうちょっとでつかまえられそうになったのは。
This is how it all happened.	2 それは、このようにして起こりました。
There was a br-br-br-r-r-r in the air.	ブル、ブル、ブル、ル、ル、ル、という音が、辺りにひびきわたりました。
Fatty really should have heard it long before he did.	ふとっちょは、本当ならばもっとはやくその音が聞こえていなければいけませんでした。
But he had eaten so many apples that he had begun to feel sleepy;	でも、あんまりたくさんのリンゴを食べて、眠くなり始めていました。
and his ears were not so sharp as they should have been.	耳がいつもよりもするどくなかったのです。
And when at last Fatty heard that br-r-r-r it was quite loud.	ブル、ル、ル、ル、という音がようやくふとっちょの耳にとどいたとき、ずいぶん大きな音になっていました。
He was startled.	ふとっちょは、ぎょっとしました。
And he stopped right in the middle of the road to listen.	そして、音をよく聞こうと、道のまん中で立ち止まりました。
Fatty had never heard such a sound before.	そんな音は前には一度も聞いたことがありませんでした。
The strange animal was on him before he knew it.	3 その奇妙な動物は、ふとっちょがそうと知る前に、おそいかかってきました。
Its glaring eyes blinded him.	その動物のギラギラと光る目に、ふとっちょの目はくらまされました。
And if it had not screamed at him Fatty would never have escaped.	もしもその動物がふとっちょにむかって金切り声を出さなかったら、ふとっちょは決して逃げ出していなかったでしょう。
It was the terrible screech of the monster which finally made Fatty jump.	その怪物の金切り声のものすごさに、ふとっちょはとうとう飛びあがりました。
It was a frightful cry	恐ろしいさけび声でした
--like six wildcats all wailing together.	――まるで、六ぴきのヤマネコがいっせいに鳴きさけんだような声でした。
And Fatty leaped to one side of the road just before the monster reached him.	怪物につかまえられるまさに直前に、ふとっちょは道のはしに飛びのきました。
The great creature went past Fatty like the wind and tore on up the hill.	4 巨大な生き物は、まるで丘を引きさく突風のようないきおいで、ふとっちょのわきを通りすぎました。
He seemed to be running so fast that he could not stop.	その生き物は、あんまりはやく走りすぎて、止まることができないようでした。
Fatty could hear him panting as he climbed the sharp rise of the road.	その生き物が道の急な登り坂にさしかかると、登りながらあえぐ声が、ふとっちょの耳に聞こえました。
Fatty Coon hurried away.	5 ふとっちょあらいぐまは、家にむかって急いで走りました。
He wanted to get home before the monster could stop and come back to look for him.	怪物が止まることができて、彼をさがしに戻ってくるといけません。
When Fatty told his mother about his narrow escape Mrs. Coon became much excited.	6 危ないところで命びろいしたてんまつをふとっちょから聞かされると、あらいぐま夫人はひどく動ようしました。
She felt sure that Fatty was not mistaken,	ふとっちょが見まちがえたわけではないと、彼女は信じました。
for had she not heard that strange cry herself?	わたしが聞いたおかしなさけび声は、それだったのではないかしら？
There it was again!	7 また聞こえました！
Woo-ooo-ooo-oo-o!	ウウウ、ウウウ、ウウウ、ウウ、ウ！
It began low, rose to a shriek, and then died away again.	始めは低いうなり声だったのが、高まって金切り声になり、そして、ふたたび消え入りました。
Mrs. Coon and Fatty climbed to the very top of their old poplar and gazed down the valley.	8 あらいぐま夫人とふとっちょは、わが家である古いポプラの木のてっぺんに登り、谷間を見下ろしました。
"Look, Mother!"	9 「見て、お母さん！」
Fatty cried.	ふとっちょがさけびました。
"He's stopped at Farmer Green's!	「農夫のグリーンさんの家で止まってる！
You can see his eyes from here!"	ここからでもあいつの目が見えるよ！」
Mrs. Coon looked.	10 あらいぐま夫人は、そちらを見ました。
Sure enough!	まあ、本当だ！
It was just as Fatty said.	ふとっちょが言ったとおりでした。
And that horrid call echoed across the valley once more.	その怪物の恐ろしいさけび声が、ふたたび谷間にこだましました。
Farmer Green stuck his head out of his chamber-window, to see what the man in the automobile wanted.	11 農夫のグリーンは、自動車に乗った男の頼みごとをよく聞こうと、寝室の窓から外に頭をつき出しました。
"Where's the nearest village, please?"	12 「ここから一番近い村の場所を教えていただけませんか？」
the stranger asked.	と、そのよそ者はたずねました。
And after Farmer Green had told him the man drove his car on again.	農夫のグリーンが教えてやると、男はまた自動車を走らせました。
From their tree-top Fatty and his mother watched the monster dash down the valley.	13 ふとっちょとお母さんは、お家の木のてっぺんから、怪物がすごいいきおいで谷間をつっ切っていくのをながめました。
They knew he had gone,	怪物が去っていくのが、ふたりにはわかりました。
because they could see the gleam of those awful eyes.	なぜなら、ギラギラ光る恐ろしい目が、遠くからでも見えましたから。
"Do you suppose he ate up Farmer Green and his family?"	14 「あの怪物、農夫のグリーンさんとグリーンさんの家族を食べちゃったの？」
Fatty asked in a frightened voice.	ふとっちょは、おびえた声でたずねました。
"I hope so,"	15 「そうだといいよ」
she said.	お母さんは言いました。
"Then perhaps there'll be no more traps in theb woods."	「そしたら、もう森の中にわなをしかけられなくなるかもしれないからね」
"But who would plant the corn?"	16 「でも、だれがとうもろこしを作ってくれるの？」
Fatty asked.	ふとっちょはたずねました。
Mrs. Coon did not appear to hear his question.	17 あらいぐま夫人には、ふとっちょの質問が聞こえないようでした。
JASPER JAY TELLS SOME NEWS	カケスのジャスパーが教えてくれたこと
It was quite late in the fall, and the weather had grown very cold.	1 秋がとっぷりとふかまり、辺りがひどく冷えこんできました。
Mrs. Coon and her family had not left their home for several days;	あらいぐま夫人とその子どもたちは、数日のあいだ家の中に閉じこもりっきりでいました。
but on this day she thought it would be pleasant to go out in the sunshine and get a breath of fresh air and a bite to eat.	けれどこの日、あらいぐま夫人は、お陽さまの照る外に出て新せんな空気をすい、ごはんを食べたら気持ちがよかろうと考えました。
Fatty was the only one of her children that was not asleep;	2 ふとっちょは、あらいぐま夫人の子どもたちの中で、ひとりだけ眠っていませんでした。
and he complained of being very hungry.	そして、ひどい空腹をうったえました。
So Mrs. Coon decided to take him with her.	そこであらいぐま夫人は、ふとっちょを一緒に連れていくことにしました。
The hunting was not very good.	3 狩りはおもわしくありませんでした。
There were no birds' eggs at all to be found in the trees.	鳥の卵は、木々の中のどこにも見つかりませんでした。
The river and the brook and the creek were all frozen over, so Fatty and his mother could not catch any fish.	大きい川や、小さい川や、もっと小さい川は、すべて凍りついていましたので、ふとっちょとお母さんは魚をつかまえることができませんでした。
And as for corn	そして、とうもろこしはというと
--Farmer Green had long ago gathered the last ear of it.	――農夫のグリーンが、とうのむかしに最後の実をつみ取ってしまっていました。
Fatty wished that it was summertime.	ふとっちょは、今が夏だったらいいのにと思いました。
But it only made him hungrier than ever, to think of all the good things to eat that summer brings.	けれど、夏のめぐみのおいしい食べ物のことを考えると、ますますお腹が空いてしまうだけでした。
He was feeling very unhappy when his mother said to him sharply--	お母さんがするどい声でこう言ったときには、ふとっちょはすっかりみじめな気分になってしまいました。
"Run up this tree!	4 「その木に登りなさい！
Hurry, now!	急いで！
Don't ask any questions."	なにも聞くんじゃないよ」
Now, Fatty did not always mind his mother as quickly as he might have.	5 さて、いつものふとっちょは、お母さんを気づかうなんてことは、すぐにそうしたってよさそうなときだって、しやしませんでした。
But this time he saw that she had stopped and was sniffing the air	ところがこのとき、お母さんが立ち止まり、辺りの空気のにおいをかぎ回ったのには、すぐに気づきました。
as if there was something about it she did not like.	お母さんはまるで、なにか気に入らないものがあるような様子でした。
That was enough for Fatty.	6 ふとっちょにはそれだけでじゅうぶんでした。
He scrambled up the nearest tree.	彼は、手近な木に大急ぎで登りました。
For he knew that his mother had discovered danger of some sort.	お母さんがなにか危険なものを見つけたということが、彼にはわかったからです。
Mrs. Coon followed close behind Fatty.	7 あらいぐま夫人は、ふとっちょのすぐ後ろからぴったりついてきました。
And they had. no sooner hidden in the branches than Fatty saw what it was that his mother had smelled.	そして、ふたりそろって枝葉の中に隠れるやいなや、お母さんがかぎ取ったものの正体が、姿をあらわしました。
It was Johnnie Green!	8 ジョニー・グリーンです！
He passed right underneath the tree where they were perched.	ジョニーは、ふとっちょたちが身をひそめている木の真下を通りすぎました。
And as Mrs. Coon peeped down at him she shuddered and shivered and shook so hard	あらいぐま夫人は、ジョニーを盗み見て、ブルブルガタガタと、それはひどく身をふるわせました。
that Fatty couldn't help noticing it.	ふとっちょは、そんなお母さんに気づかずにはいられませんでした。
"What's the matter?"	9 「いったいどうしたの？」
he asked, as soon as Johnnie Green was out of sight.	ジョニー・グリーンの姿が見えなくなると、ふとっちょはすぐさまたずねました。
"His cap!"	10　「ぼうしさ！」
Mrs. Coon exclaimed.	あらいぐま夫人がさけびました。
"He is wearing a coon-skin cap!"	「あの子のかぶってるのはね、あらいぐまの毛皮のぼうしなんだよ！」
Now do you wonder that she was upset?	さあ、あらいぐま夫人が腹を立てているのかどうか、みなさんはわかりますよね？
"Don't ever go near Farmer Green's house,"	「農夫のグリーンの家の近くには絶対に行っちゃいけないよ」
she warned Fatty.	あらいぐま夫人は、ふとっちょに注意しました。
"You don't want to be made into a cap, or a pair of gloves, or a coat, or anything like that, do you?"	「ぼうしとか、てぶくろとか、コートとか、そういうもんになりたくないだろう？」
"No, indeed, Mother!"	11 「もちろんだよ、お母さん！」
Fatty was quite sure	ふとっちょは、心から自信を持って言いました。
that such an adventure wouldn't please him at all.	そんな冒険は、ちっとも楽しくないに決まっています。
And he told himself right then and there that he would never go anywhere near Farmer Green's house.	そしてその場で、農夫のグリーンの家にはこんりんざい近寄らないぞと、自分自身に言い聞かせました。
We shall see how well Fatty remembered.	ふとっちょがどのくらいちゃんと覚えていられるのか、わたしたちはこれから知ることになるでしょう。
That very afternoon Fatty Coon heard some very pleasant news.	12 その午後、ふとっちょあらいぐまは、たいそうごきげんな話を聞きました。
It was Jasper Jay who told him.	カケスのジャスパーから聞いたことです。
Jasper Jay was a very noisy blue jay who lived in the neighborhood.	13 カケスのジャスパーは、とてもそうぞうしいアオカケスで、沼に住んでいるふとっちょたちの隣人でした。
He did not go south with most of the other birds when the cold weather came.	ほかの多くの鳥たちは、寒くなると南にわたりますが、彼はそうしませんでした。
He liked the winter	彼は、冬が好きなのです。
and he was forever tearing about the woods, squalling and scolding at everybody.	そして、森のいたるところでひっきりなしにわめき立てたり、うるさく口出しをして、つねに森の住民を困らせていました。
He was a very noisy fellow.	彼は、たいそうな騒動好きなのです。
Well!	14 そしてね！
when Fatty and his mother had reached home after their hunt, Fatty stayed out of doors.	ふとっちょとお母さんは狩りをおえて家にもどると、ふとっちょは家の外にとどまりました。
He climbed to the top of a tall pine tree nearby and stretched himself along a limb, to enjoy the sunshine, which felt very good upon his broad back.	彼は、高いマツの木のてっぺん近くまで登ると、手足を伸ばし、広い背中にお陽さまの光があたる心地よさを楽しみました。
It was there that Jasper Jay found him and told him the pleasant news.	そこをカケスのジャスパーが見つけて、ごきげんな話を教えたのでした。
And Fatty was very glad to hear the news,	ふとっちょは、その話を聞いて大よろこびしました。
because he was still hungry.	なぜなら、まだお腹が空いていたからです。
This is what Jasper Jay told Fatty:	15 カケスのジャスパーがふとっちょに話したこととは、こういうことです。
he told him that Farmer Green had as many as forty fat turkeys, which roosted every night in a spreading oak in Farmer Green's front yard.	農夫のグリーンは、四十羽くらいのふとった七面鳥を飼っており、グリーンの家の前庭に生えている枝をひろげたオークの木に、毎晩鳥小屋代わりにとまらせている、というのです。
"If I liked turkeys I would certainly go down there some night and get one,"	16 「ぼくが七面鳥好きだったら、ぜったい夜にそこに行って、しっけいしちゃうね」
said Jasper Jay.	と、カケスのジャスパーは言いました。
XII FORTY FAT TURKEYS	四十羽のふとった七面鳥
When Jasper Jay told Fatty Coon about Farmer Green's forty fat turkeys Fatty felt hungrier than ever.	1 カケスのジャスパーから農夫のグリーンの四十羽のふとった七面鳥のことを聞くと、ふとっちょはこれまでにないくらいお腹が空いてきました。
"Oh!	2 「あーあ！
I mustn't go near Farmer Green's house!"	ぼくは農夫のグリーンさんの家に近づいちゃだめなんだ！」
he said.	ふとっちょは言いました。
"My mother told me to keep away from there.	「お母さんが離れていなさいって言ったんだもの
. . . What time did you say the turkeys go to roost?"	……七面鳥が鳥小屋にいくのはいつって言ったっけ？」
"Oh! they go to roost every night at sundown,"	3 「毎晩陽がしずんだときさ」
Jasper Jay explained.	カケスのジャスパーは説明しました。
"And there they sit, up in the tree, all night long.	「夜じゅう木の上にいるんだよ。
They're fast asleep.	そこでぐっすり眠ってるんだ。
And you would have no trouble at all in catching as many as you wanted.	きみが欲しいだけいくらでも簡単につかまえられるよ
. . . But of course, if you're afraid	……でももちろん、恐いんなら
--why there's no use of MY talking about it.	――ぼくの言うことなんか聞かなくたっていいよ。
There's a plenty of other coons in these woods who'd be glad to know about those turkeys.	このあたりの森に住むおおぜいのあらいぐまは、あの七面鳥たちのことを聞くとみんな大よろこびするけどね。
And maybe they'd have the manners to say 'Thank you!' too."	下手すると、『ありがとうございます！』なんてぼくにお礼まで言っちゃうよ」
And with a hoarse, sneering laugh Jasper Jay flew away.	そしてカケスのジャスパーは、しわがれ声で意地わるく笑いながら飛び去っていきました。
That was enough for Fatty.	4 それだけ言われればふとっちょにはじゅうぶんでした。
He made up his mind	彼は決心しました。
that he would show Jasper Jay that HE was not afraid.	ふとっちょあらいぐまはこそんなことを恐れはしないと、カケスのジャスパーに知らしめてやろうと。
And he wanted a turkey to eat, too.	それに、七面鳥を食べたくもありました。
He said nothing to his mother about Jasper's news.	お母さんにはジャスパーから聞いた話をだまっていました。
But that very night, when the moon came up, and the lights in Farmer Green's house were all out, Fatty Coon went stealing across the fields.	けれどその晩、月がのぼって月明かりが農夫のグリーンの家をくまなく照らすころ、ふとっちょあらいぐまは畑をしのび足で横切っていきました。
He was not afraid,	5 ふとっちょは恐れてはいませんでした。
for he knew that Farmer Green and all his family were in their beds.	農夫のグリーンとその家族は全員ベッドに入っていることを知っていましたから。
And it was so cold that Fatty felt sure that Farmer Green's dogs would be inside their kennels.	あたりはひどく冷えこんでおり、農夫のグリーンの飼い犬たちは犬小屋に避難しているにちがいないと、ふとっちょは考えました。
Fatty did not intend to make any noise.	6 ふとっちょは物音を立てはしないつもりでした。
The turkeys were asleep	七面鳥たちは眠っています
--so Jasper Jay had told him	――カケスのジャスパーがそう言っていました
--and he expected to grab one of them so swiftly and silently that the other turkeys would never know it.	――そのうちの一羽を、ほかの鳥たちに気づかれずにとてもすばやく静かにつかまえられるだろうと考えていました。
When Fatty Coon came to Farmer Green's yard he had no trouble at all in finding the spreading oak.	7 農夫のグリーンの家の庭にくると、ふとっちょあらいぐまは枝をひろげたオークの木をなんなく見つけました。
He could see the turkeys plainly where they dozed on the bare branches.	その落葉した丸はだかの枝々いっぱいに七面鳥たちがとまり、まどろんでいるのが見えました。
And in less time than it takes to tell it Fatty had climbed the tree.	ふとっちょは、言うよりもはやく木にのぼりました。
On the very lowest limb there was a row of four plump turkeys, all sound asleep.	一番ひくい枝に、四羽のふとった七面鳥がならんでとまり、そろってぐっすり眠っていました。
And Fatty reached out and seized the nearest one.	ふとっちょは手をのばし、一番近くにいた鳥をつかみました。
He seized the turkey by the neck, so that the big bird could not call out.	鳥ののど元をつかんだので、この大きな鳥はさけび声を上げることができませんでした。
But Fatty was not quite quick enough.	けれどふとっちょは、あまりすばやくありませんでした。
Before he could pull her off her perch the turkey began to flap her wings, and she struck the turkey next her,	彼が鳥をこちらに引きよせる前に、鳥は羽根をばたつかせ始め、となりの鳥をたたきました。
so that THAT turkey woke up and began to gobble and flap HER wings.	それでその鳥が目をさまし、ガボガボ鳴いて羽根をばたつかせました。
Then the next turkey on the limb woke up.	それから、そのとなりの枝にとまっていた鳥が目をさましました。
And the first thing that Fatty Coon knew,	ふとっちょあらいぐまは初めて気づきました。
every one of the thirty-nine turkeys that were left was going gobble-gob-gob-gob-gobble!	のこりの三十九羽の七面鳥の一羽一羽それぞれが、ガボ、ガボ、ガボ、ガボ、ガボー！　と鳴き始めるんだってことをです！
And some of them went sailing off across the yard.	そのうちの数羽が、庭の向こうへと舞いおりていきました。
One of them lighted on top of the porch just outside Farmer Green's window	そのうちの一羽が、ちょうど農夫のグリーンの家の窓の外のポーチの上にとまりました。
and it seemed to Fatty that that one made the greatest racket of all.	どうやらふとっちょは、よりによって一番騒々しいさわぎを引き起こしてしまったようです。
Farmer Green's window flew up; and Farmer Green's voice called	8 窓が引き上げられ、農夫のグリーンの声がしました。
"Spot!	「しずまれ！
Spot!"	しずまれ！」
Fatty Coon did not wait to hear anything more.	9 それを聞くと、ふとっちょあらいぐまはぐずぐずしませんでした。
He dropped the turkey he had seized and slipped down to the ground.	彼はつかんでいた七面鳥をほうり出し、地面に向かって木をすべり降りました。
And then he ran toward the woods as fast as he could go.	それから、森に向かってあらんかぎりのはやさでかけ出しました。
Farmer Green's dog Spot was barking now.	10 そのとき、農夫のグリーンの飼い犬のスポットがほえました。
And Fatty wanted to climb one of the trees by the roadside.	ふとっちょは道ばたの木に登りたいと思いました。
But he remembered,	ですが、彼は思い出しました。
the narrow escape he had had when the dog had treed him near the cornfield.	あの犬にとうもろこし畑のそばの木に追いつめられ、あやうい目にあったことがあったのでした。
So he never stopped until he reached the woods.	それで、森にたどり着くまで一度も止まらずに走りつづけました。
Then he went nimbly up into the trees.	そして、すばやく木にかけ登りました。
And while Spot was barking at the foot of the first tree he climbed,	スポットはふとっちょが最初に登った木の根元で立ち止まり、ほえ立てました。
Fatty was travelling through the tree-tops toward home.	そのあいだ、ふとっちょは木のてっぺんからてっぺんへと移りながら家に向かいました。
He never said anything to his mother about Farmer Green's turkeys.	11 ふとっちょは、農夫のグリーンの七面鳥のことを決してお母さんに話しませんでした。
But the next time he saw Jasper Jay Fatty told him exactly what he thought of him.	けれど次にカケスのジャスパーに出会うと、彼のことをどう思っているのか、はっきり言ってやりました。
"Ha! ha!"	12 「アハハハ！」
Jasper Jay only laughed.	カケスのジャスパーはただ笑うだけでした。
And he did not seem at all surprised that Fatty had fallen into trouble.	ふとっちょが大変な目にあったと聞いても、まるでおどろいていないようでした。
To tell the truth, he was only sorry because Fatty had escaped.	本当のことを言いますと、ジャスパーががっかりしたのただ一つ、ふとっちょが逃げおおせたことでした。
Jasper Jay did not like Fatty Coon.	カケスのジャスパーはふとっちょあらいぐまが嫌いでした。
And he had told him about the forty fat turkeys because he hoped that Fatty would get caught if he tried to steal one of them.	彼がふとっちょに四十羽の七面鳥のことを教えたのは、ふとっちょがそのうちの一羽を盗もうとしてつかまってしまえばいいと思ったからなのです。
"Wait till I catch you!"	13 「そのうちにお前をつかまえてやるからな！」
Fatty said.	ふとっちょは言いました。
But Jasper Jay only laughed harder than ever when Fatty said that.	14 けれどカケスのジャスパーは、ふとっちょがそう言ってやる前よりもいっそうけたたましい声で笑うだけでした。
He seemed to think it was a great joke.	ひどくおかしい冗談だと思っているようでした。
He was most annoying.	ジャスパーは、この上なくいらいらさせられるやつなのです。
XIII FATTY MEETS JIMMY RABBIT	ふとっちょ、うさぎのジミーに出会う
For once Fatty Coon was not hungry.	1 ふとっちょあらいぐまは一度だけ、お腹が空いていなかったことがあります。
He had eaten so much of Farmer Green's corn that he felt as if he could not swallow another mouthful.	農夫のグリーンのとうもろこしをそれはたくさん食べて、もうあとひと口も飲みこめそうもないくらいになったときです。
He was strolling homewards through the woods when someone called to him.	森の中を家にむかってぶらぶら歩いていると、彼を呼ぶ者がありました。
It was Jimmy Rabbit.	うさぎのジミーです。
"Where are you going, Fatty?"	2 「どこへ行くの、ふとっちょくん？」
Jimmy Rabbit asked.	うさぎのジミーがたずねました。
"Home!"	3 「家だよ！」
said Fatty.	ふとっちょは言いました。
"Are you hungry?"	4 「お腹すいてる？」
Jimmy Rabbit asked anxiously.	うさぎのジミーは不安そうにたずねました。
"I should say not!"	5 「すいてないと思うよ！」
Fatty answered.	ふとっちょは答えました。
"I've just had the finest meal I ever ate in my life."	「たった今ごはんを食べたとこなんだ。
Jimmy Rabbit seemed to be relieved to hear that.	6 うさぎのジミーはそれを聞いて安心したようでした。
"Come on over and play,"	7 「こっちでいっしょに遊ぼうよ」
he said.	ジミーは言いました。
"My brother and I are playing barber-shop	「弟とぼくとで床屋さんごっこしてるんだよ。
over in the old sycamore tree;	古いスズカケの木のところで。
and we need you."	君がいないと始まらないんだよ」
"All right!"	8 「いいよ！」
said Fatty.	ふとっちょは言いました。
It was not often that any of the smaller forest-people were willing to play with him,	ふとっちょと遊ぼうという森の小さな住民は、めったにいませんでした。
because generally Fatty couldn't help getting hungry and then he usually tried to eat his playmates.	なぜなら、ふとっちょはたいていお腹がすくのを我慢できないし、するといつも遊び仲間を食べようとするからです。
"What do you need me for?"	「ぼくがいないと始まらないって、なにをするの？」
Fatty asked, as he trudged along beside Jimmy Rabbit.	ふとっちょは、うさぎのジミーとならんでてくてく歩きながらたずねました。
"We need you for the barber's pole,"	9 「床屋の看板のあめんぼう柱に、君が必要なんだよ」
Jimmy explained.	ジミーは説明しました。
"You can come inside the hollow tree and stick your tail out through a hole.	「君に木のうろの中に入って、穴からしっぽをつき出してもらいたいんだよ。
It will make a fine barber's pole	それで立派な床屋のあめんぼう柱になるよ
--though the stripes DO run the wrong way, to be sure."	――といっても、しまもようの色がちがってるんだけどさ、確かにね」
Fatty Coon was greatly pleased.	10 ふとっちょあらいぐまはたいそうよろこびました。
He looked around at his tail and felt very proud.	彼はしっぽをつくづくとながめ、とてもほこらしい気分になりました。
"I've got a beautiful tail--haven't I?"	11 「ぼくのしっぽはきれいだろ？」
he asked.	ふとっちょはたずねました。
"Um--yes!"	12 「うーん、まあね！」
Jimmy Rabbit replied,	うさぎのジミーは答えました。
"though I must say it isn't one that I would care for myself	「といっても、ぼくは自分のことを考えて、そんなことはないって言わないといけないんだけどね
... But come along!	……でもまあ、おいでよ！
There may be people waiting to get their hair cut."	だれかが散髪してもらうのを待ってるかもしれないよ」
Sure enough!	13 まあ、本当だ！
When they reached the make-believe barber-shop there was a gray squirrel inside, and Jimmy Rabbit's brother was busily snipping the fur off Mr. Squirrel's head.	ふたりがごっこ遊びの床屋にたどりつくと、灰色リスが中におり、うさぎのジミーの弟が、リス氏の頭の毛をいそがしそうにチョッキンチョッキン切っているところでした。
"How much do you charge for a hair-cut?"	14 「散髪代はいくらなの？」
Fatty asked.	ふとっちょがたずねました。
"Oh, that depends!"	15 「ああ、お客しだいさ！」
Jimmy Rabbit said.	うさぎのジミーは答えました。
"Mr. Squirrel will pay us six cabbage leaves.	「リス氏の頭はキャベツの葉っぱ六枚だ。
But if we were to cut your hair we'd have to ask more.	でも、君の頭を刈るんなら、もっといただかないとね。
We'd want a dozen cabbage leaves, at least."	少なくとも、キャベツの葉っぱ十二枚はほしいね」
"Well, don't I get anything for the use of my tail?"	16 「じゃあ、ぼくはしっぽを使わせてやるんだから、ぼくだってなにかもらってもいいじゃないか？」
Fatty asked.	ふとっちょが言いました。
He had already stuck it out through the hole;	彼はすでにしっぽを穴からつき出しており、
and he had half a mind to pull it in again.	また引っ込めようかしらと思いました。
Jimmy Rabbit and his brother whispered together for a few moments.	17 うさぎのジミーと弟は、しばらくの間ひそひそささやき合いました。
"I'll tell you what we'll do,"	18 「どうするかっていうとね、」
Jimmy said.	ジミーが言いました。
"If you'll let us use your tail for the barber's pole, we'll cut your hair free.	「君が床屋のあめんぼう柱にしっぽを使わせてくれるんなら、タダで君の頭を刈ってあげるよ。
Isn't that fair enough?"	それならじゅうぶんに公平だろ？」
Fatty Coon was satisfied.	19 ふとっちょあらいぐまは満足しました。
But he insisted that Jimmy begin to cut his hair at once.	けれど、ジミーが彼の頭の毛を切り始めると、また言い出しました。
"I'm doing my part of the work now,"	20 「ぼくは今、仕事中なんだよ」
he pointed out.	ふとっちょは指摘しました。
"So there's no reason why you shouldn't do yours."	「だから、君は君の仕事をしていてもいいんだよ」
With that Jimmy Rabbit began.	21 うさぎのジミーは、ふたたびふとっちょの頭の毛を切り始めました。
He clipped and snipped at Fatty's head, pausing now and then to see the effect.	彼はチョキチョキチョッキンとふとっちょの毛を切っては、時どき手を止めて出来具合を確かめました。
He smiled once in a while, behind Fatty's back,	ふとっちょの後ろにまわると、彼は一しゅん笑みを浮かべました。
because Fatty certainly did look funny	なぜなら、ふとっちょがこれを見たら、ぜったいに笑っちゃうからです。
with his fur all ragged and uneven.	ふとっちょの頭の毛は、どこもかしこもギザギザのでこぼこになっていました。
"Moustache trimmed?"	22 「口ひげもいっとく？」
Jimmy Rabbit asked, when he had finished with Fatty's head.	うさぎのジミーはふとっちょの頭の毛を切り終えると、たずねました。
"Certainly	23 「そりゃあ
--of course!"	……当たり前さ！」
Fatty Coon answered.	ふとっちょあらいぐまは答えました。
And pretty soon Fatty's long white moustache lay on the floor of the barber-shop.	すぐさまふとっちょの長くて白い口ひげが、床屋の床にはらりと落ちました。
Fatty felt a bit uneasy as he looked down and saw his beautiful moustache lying at his feet.	ふとっちょは下を見おろし、美しい口ひげが足元に横たわっているのを見ると、ちょっぴり不安になりました。
"You haven't cut it too short, I hope,"	「あんまり短く切りすぎないでくれよ」
he said.	ふとっちょは言いました。
"No, indeed!"	24 「もちさ！」
Jimmy Rabbit assured him.	うさぎのジミーは自信満まんに言いました。
"It's the very latest style."	「これって超はやりのスタイルなんだよ」
"What on earth has happened to you?"	25 「いったい全体なにがあったんだい？」
Mrs. Coon cried,	あらいぐま夫人がさけびました
--when Fatty reached home that night.	――その夜、ふとっちょが家にもどったときのことです。
"Have you been in a fire?"	「火の中にでもつっ込んだのかい？」
"It's the latest style, Mother,"	26 「これが超はやりなんだよ、お母さん」
Fatty told her.	ふとっちょは説明しました。
"At least, that's what Jimmy Rabbit says."	「少なくとも、うさぎのジミーによればそうらしいよ」
He felt the least bit uneasy again.	彼はふたたびほんのちょっぴり不安になりました。
"Did you let that Jimmy Rabbit do that to you?"	27 「うさぎのジミーにそれをやらせたのかい？」
Mrs. Coon asked.	あらいぐま夫人はたずねました。
Fatty hung his head.	28 ふとっちょははずかしさに頭をうなだれ、
He said nothing at all.	だまり込みました。
But his mother knew.	でもお母さんにはわかりました。
"Well!	29 「やれやれ！
you ARE a sight!"	いい笑いものだよ！」
she exclaimed.	お母さんは声だかに言いました。
"It will be months before you look like my child again.	「二、三か月もあれば、またわたしの子らしくなるだろう。
I shall be ashamed to go anywhere with you."	お前を連れて外を出歩くのがはずかしいよ」
Fatty Coon felt very foolish.	30 ふとっちょあらいぐまは、ひどいかつがれ方をしたと思いました。
And there was just one thing that kept him from crying.	泣くのをこらえるのがせいいっぱいでした。
And THAT was THIS:	この借りは返さなくてはなりません。
he made up his mind	ふとっちょは決心しました。
that when he played barber-shop with Jimmy Rabbit again he would get even with him.	うさぎのジミーとふたたび床屋さんごっこをし、仕返しをしてやろうと。
But when the next day came, Fatty couldn't find Jimmy Rabbit and his brother anywhere.	31 しかし翌日、うさぎのジミーとその弟はどこにもいませんでした。
They kept out of sight.	ふたりは姿をくらましていました。
But they had told all the other forest-people about the trick they had played on Fatty Coon.	けれど、ふたりは森の住民すべてにふとっちょあらいぐまにいたずらをした話を言いふらしており、森の住民たちはふとっちょをからかいました。
And everywhere Fatty went he heard nothing but hoots and jeers and laughs.	ふとっちょはどこにいこうと、ホーホーとやじられ、あざけられ、笑われてばかりいました。
He felt very silly.	彼はひどくばかにされたと思いました。
And he wished that he might meet Jimmy Rabbit and his brother.	そして、うさぎのジミーとその弟に会えないだろうかとねがいました。
XIV THE BARBER-SHOP AGAIN	床屋さんごっこ、ふたたび
Although Fatty Coon never could get Jimmy Rabbit and his brother to play barber-shop with him again,	1 ふとっちょあらいぐまがうさぎのジミーとその弟をつかまえ、またいっしょに床屋さんごっこをするなど、決してできませんでした。
Fatty saw no reason why he should not play the game without them.	それなのにふとっちょは、彼らぬきでこの遊びをするなんて考えられませんでした。
So one day he led his brother Blackie over to the old hollow sycamore.	それである日、弟の黒っちょをつれてうろの空いた古いスズカケの木へ出かけました。
His sisters, Fluffy and Cutey, wanted to go too.	妹のふわっちょとかわいっちょも、いっしょに行きたがりました。
But Fatty would not let them.	けれどふとっちょは、ふたりをつれて行きませんでした。
"Girls can't be barbers,"	「女の子は床屋さんになれないんだよ」
he said.	と、ふとっちょは言いました。
And of course they could find no answer to that.	もちろん、ふたりはそれに言いかえすことができませんでした。
As soon as Fatty and Blackie reached the old sycamore I am sorry to say that a dispute arose.	2 こんなことを申し上げるのは残念なのですが、ふとっちょと黒っちょはスズカケの古木にたどり着くやいなや、口げんかを始めました。
Each of them wanted to use his own tail for the barber's pole.	ふたりとも、自分のしっぽを床屋のあめんぼう柱の看板にしたがったのです。
They couldn't both stick their tails through the hole in the tree at the same time.	ふたりそろって一緒にしっぽを木の穴からつき出すなんてできません。
So they finally agreed to take turns.	それでとうとう、順番こにしっぽを出すことで決着しました。
Playing barber-shop wasn't so much fun as they had expected,	3 床屋さんごっこは、ふたりが考えていたようには楽しくありませんでした。
because nobody would come near to get his hair cut.	なぜなら、散髪してもらいに近づいてくる者なんてだれもいませんでしたから。
You see, the smaller forest-people were all afraid to go inside that old sycamore where Fatty and Blackie were.	だってね、森の小さな住民たちはみな恐がって、ふとっちょと黒っちょがいるスズカケの古木の中になんて入ってきませんものね。
There was no telling when the two brothers might get so hungry they would seize and eat a rabbit or a squirrel or a chipmunk.	ふたりの兄弟がとてもお腹がすいたときに、うさぎや灰色リスやシマリスをつかまえて、食べてしまうかもわかりません。
And you know it isn't wise to run any such risk as that.	そんな危険をおかすなんておろかなことだというのは、よくおわかりでしょう。
Fatty offered to cut Blackie's hair.	4 ふとっちょが、黒っちょの頭の毛を切ってやろうと申し出ました。
But Blackie remembered what his mother had said when Fatty came home with his moustache gone and his head all rough and uneven.	けれど黒っちょは、ふとっちょが頭の毛をどこもかしこもギザギザのでこぼこにし、口ひげをなくして家に帰ってきたとき、お母さんがなんと言ったのかを思い出しました。
So Blackie wouldn't let Fatty touch him.	それで黒っちょは、ふとっちょに頭の毛をさわらせませんでした。
But HE offered to cut Fatty's hair	けれど彼は、ふとっちょの頭の毛を切ってやろうと申し出ました
--what there was left of it.	――それは黒っちょが困ることではありませんもの。
"No, thank you!"	5 「えんりょするよ！」
said Fatty.	ふとっちょは言いました。
"I only get my hair cut once a month."	「ぼくは頭の毛を切るの、ひと月にいっぺんだけにしてるんだ」
Of course, he had never had his hair cut except that once, in his whole life.	もちろん彼が頭の毛を切ったのは、全生涯のうちであの一度きりでした。
Now, since there was so little to do inside the hollow tree, Fatty and Blackie kept quarreling.	6 さて、木のうろの中にいてもすることなんてほとんどありませんでしたから、ふとっちょと黒っちょはけんかをし続けていました。
Blackie would no sooner stick his tail through the hole in the side of the tree than Fatty would want HIS turn.	黒っちょが木の壁の穴へしっぽを入れるがはやいか、ふとっちょが自分の番だとせっつきます。
And when Fatty had succeeded in squeezing HIS tail out through the opening Blackie would insist that Fatty's time was up.	ふとっちょが穴へしっぽをねじ込みますと、黒っちょがふとっちょの番はもう終わったと言いはります。
It was Fatty's turn, and Blackie was shouting to him to stand aside and give him a chance.	7 ふとっちょの番になると、はやくどいて番をゆずれと黒っちょがどなりました。
"I won't!"	8 「やーだね！」
said Fatty.	ふとっちょが言いました。
"I'm going to stay here just as long as I please."	「ぼくは満足するまでいつまででもここにいるんだ」
The words were hardly out of his mouth	9 ふとっちょの口からその言葉が出ることはありませんでした。
when he gave a sharp squeal,	その代わりに彼の口から出たのは、するどい金きり声でした。
as if something hurt him.	まるでなにかに痛めつけられたような声です。
And he tried to pull his tail out of the hole.	ふとっちょは穴からしっぽを引きぬこうとしました。
He wanted to get it out now.	今ではそうしたくなっていました。
But alas!	けれど、ああ！
it would not come!	しっぽを引きぬくことができません！
It was caught fast!	なにかにしっぽをがっちりつかまえられていたのです！
And the harder Fatty pulled the more it hurt him.	ふとっちょがしっぽを強く引けばひくほど、それはますます痛くしっぽをつかみました。
"Go out and see what's the matter!"	10 「外に行って、いったいどうなっているのか見てきてよ！」
he cried to Blackie.	ふとっちょは黒っちょに向かってさけびました。
But Blackie wouldn't stir.	11 けれど黒っちょは身動きしませんでした。
He was afraid to leave the shelter of the hollow tree.	安全な木のうろの外に出るのが恐かったのです。
"It may be a bear that has hold of your tail,"	12 「クマにしっぽをつかまえられているのかもしれないよ」
he told Fatty.	黒っちょはふとっちょにいいました。
And somehow, that idea made Fatty tremble all over.	その考えに、ふとっちょはおのずと全身がふるえあがりました。
"Oh, dear!	13 「ああ、そんな！
oh, dear!"	そんなあ！」
he wailed.	ふとっちょは泣き声をあげました。
"What shall I do?	「どうしたらいいの？
Oh! whatever shall I do?"	いったいどうしたらいいの？」
He began to cry.	そして泣き始めました。
And Blackie cried too.	黒っちょもいっしょに泣き出しました。
How Fatty wished that his mother was there to tell him what to do!	ここにお母さんがいて、どうしたらいいのか教えてくれたらどんなにいいだろう、とふとっちょは思いました。
But he knew of no way to fetch her.	14 でもふとっちょは、お母さんを呼んでくることなどできないのはわかっていました。
Even if she were at home she could never hear him calling from inside the tree.	もしもお母さんがお家にいたとしても、この木の中でさけんだって、お母さんには決して聞こえないのです。
So Fatty gave up all hope of her helping.	それでふとっちょは、お母さんに助けを求めるという望みをすっかりあきらめました。
"Please, Mr. Bear, let go of my tail!"	15 「どうかお願いしますクマさん、しっぽを放してください！」
he cried, when he could stand the pain no longer.	しっぽをぎりぎりつかまれる痛みにたえ切れなくなり、ふとっちょはさけびました。
The only answer that came was a low growl,	16 返ってきた返事は、低いうなり声だけでした。
which frightened Fatty and Blackie more than ever.	ふとっちょと黒っちょは前にもましてふるえあがりました。
And then, just as they both began to howl at the top of their voices Fatty's tail was suddenly freed.	そうして、ふたりの泣きさけぶ声が最高潮にたかまったちょうどそのとき、突然つかまえられていたふとっちょのしっぽが自由になりました。
He was pulling on it so hard that he fell all in a heap on the floor of the barber-shop.	ふとっちょはしっぽを思いきり強く引っぱっていたので、床屋の床の上にどうとたおれ込みました。
And that surprised him.	彼はびっくりしました。
But he was still more surprised when he heard his mother say--	17 けれど、お母さんの声が聞こえたときには、ますますびっくりしました――
"Stop crying and come out	18 「泣くのを止めて出ておいで
--both of you!"	――ふたりとも！」
Fatty and Blackie scrambled out of the hollow sycamore.	ふとっちょと黒っちょは、スズカケの木のうろの中からいそいで飛び出しました。
Fatty looked all around.	ふとっちょは辺りを見回しました。
But there was no bear to be seen anywhere	けれど、クマの姿はどこにも見当たりませんでした
--no one but his mother.	――お母さんがいるだけです。
"Did you frighten the bear away, Mother?"	19 「クマを追っ払っちゃったの、お母さん？」
he asked.	ふとっちょはたずねました。
"There was no bear,"	20 「クマなんかいやしなかったよ」
Mrs. Coon told him.	あらいぐま夫人はふとっちょに言いました。
"And it's lucky for you that there wasn't.	「いなくて運がよかった。
I saw your tail sticking out of this tree and I thought I would teach you a lesson.	この木からお前のしっぽがつき出しているのが見えたんで、教えてやろうと思ったのさ。
Now, don't ever do such a foolish thing again.	さあ、これからはもう、こんな馬鹿なまねはするんじゃないよ。
Just think what a fix you would have been in if Johnnie Green had come along.	通りかかったのがジョニー・グリーンだったらどうなっていたのか、よく考えて肝にめいじておくんだよ。
He could have caught you just as easily as anything."	こんなふうに、わけなくあっさりとつかまってしまうんだからね」
Fatty Coon was so glad to be free once more that he promised to be good forever after.	21 ふとっちょあらいぐまはふたたび自由になれたことをよろこび、今後は決してこのようなことはしないと、しっかりと約束しました。
And he was just as good as any little coon could be	そして、幼いアライグマができるかぎりそのとおりにして
--all the rest of that day.	――残りの人生の日々を無事にすごしたのでした。
FATTY VISITS THE SMOKE-HOUSE	ふとっちょ、くんせい小屋に入る
The winter was fast going.	1 冬がかけ足でやって来ました。
And one fine day in February Fatty Coon crept out of his mother's house to enjoy the warm sunshine	二月のある晴れた日、ふとっちょあらいぐまはひなたぼっこのあたたかさを楽しもうと、お母さんの家からはい出しました
--and see what he could find to eat.	――それから、食べ物をさがそうとして。
Fatty was much thinner than he had been in the fall.	2 秋からくらべると、ふとっちょはずいぶんとやせ細っていました。
He had spent so much of the time sleeping that he had really eaten very little.	たいそう多くの時間を眠ってすごし、じつにほんのわずかしか食べていなかったのです。
And now he hardly knew himself as he looked at his sides.	今のふとっちょは、わき腹を見ると、われながらとても自分だとは思えませんでした。
They no longer stuck out as they had once.	もはやかつてのように出っぱっていませんでした。
After nosing about the swamp and the woods all the afternoon Fatty decided that there was no use in trying to get a meal there.	3 午後じゅうかかって沼や森をかぎ回ったすえ、この辺りでごはんを手に入れようとするのは無駄なことだととうとうあきらめました。
The ground was covered with snow.	地面は雪でおおわれていました。
And except for rabbit tracks	うさぎの足あと以外は
--and a few squirrels'	――そして数匹のリスのものと
--he could find nothing that even suggestaed food.	――食べ物のありかを示すものはなにも見つけられませんでした。
And looking at those tracks only made him hungrier than ever.	そんな足あとを見ると、ますますお腹がすいてしまうだけでした。
For a few minutes Fatty thought deeply.	4 しばらくの間、ふとっちょはじっくりと考えました。
And then he turned about and went straight toward Farmer Green's place.	そして彼はくるりと向きをかえ、農夫のグリーンの家のほうにまっすぐに歩いていきました。
He waited behind the fence just beyond Farmer Green's house;	農夫のグリーンの家をかこう柵のかげで、ふとっちょは待ちました。
and when it began to grow dark he crept across the barnyard.	そして暗くなり始めると、庭をこっそりと横ぎっていきました。
As Fatty passed a small, low building he noticed a delicious smell.	5 丈の低い、小さな建物のそばを通りかかったところで、ふとっちょはおいしそうなにおいに気がつき、
And he stopped right there.	ぴたりと足を止めました。
He had gone far enough.	彼はじゅうぶんすぎるほど弱りきっていました。
The door was open a little way.	建物のとびらがほんの少し開いていました。
And after one quick look all around	辺りをすばやく一べつしたのち
--to make sure there was nobody to see him	――確かにだれもいないようにふとっちょは思いました
--Fatty slipped inside.	――中にすべり込みました。
It was almost dark inside Farmer Green's smokehouse	6 農夫のグリーンのくんせい小屋の中は
--for that was what the small, low building was called.	――この丈の低い、小さな建物は、そう呼ばれていました
It was almost dark;	――ほとんど真っ暗でした。
but Fatty could see just as well as you and I can see in the daytime.	ですがふとっちょは、わたしやみなさんが昼なかに見るのと同じくらいに、真っ暗がりがよく見えました。
There was a long row of hams hung up in a line.	そこにはハムがきちんと長い一列にならべられて、ずらりとぶら下がっていました。
Underneath them were white ashes,	その足もとの地面には白い灰がありました。
where Farmer Green had built wood fires, to smoke the hams.	農夫のグリーンがハムをいぶすのに火をおこしたあとでした。
But the fires were out, now;	ですが今は火は消えており、
and Fatty was in no danger of being burned.	ふとっちょがやけどをする心配はありませんでした。
The hams were what Fatty Coon had smelled.	7 ふとっちょあらいぐまは、前にもハムのにおいをかいだことがありました。
And the hams were what Fatty intended to eat.	ハムはふとっちょがいつか食べてやろうと考えていたものでした。
He decided that he would eat them all	彼は、ここにあるハムを全部たいらげてやろうと決心しました
--though of course he could never have done that	――もちろん、そんなことは絶対にできっこありません
--at least, not in one night;	――少なくとも、一晩では無理です。
nor in a week, either.	一週間でもだめです。
But when it came to eating, Fatty's courage never failed him.	けれども食べるときがくれば、ふとっちょは決してひるまないのです。
He would have tried to eat an elephant, if he had had the chance.	もしもそんな機会があれば、彼はゾウだって食べようとするでしょう。
Fatty did not stop to look long at that row of hams.	8 ふとっちょはハムの列をながめて立ちつくしていたりしませんでした。
He climbed a post that ran up the side of the house and he crept out along the pole from which the hams were hung.	小屋のすみの柱をかけ上り、ハムをつるした横棒をつたっていきました。
He stopped at the very first ham he came to.	9 一番こちらがわにあるハムのところにたどり着くと、ふとっちょは立ち止まりました。
There was no sense in going any further.	これ以上考えることなんてありません。
And Fatty dropped on top of the ham and in a twinkling he had torn off a big, delicious mouthful.	ハムの上に下り立つと、またたく間においしいひと口を大きく噛みちぎりました。
Fatty could not eat fast enough.	10 ふとっちょは満足にしっかりと食べることができませんでした。
He wished he had two mouths	ふた口目を食べたかったのですが
--he was so hungry.	――とてもお腹がすいていましたので。
But he did very well, with only ONE.	けれどもしっかりと食べられたのは、たったのひと口だけでした。
In no time at all he had made a great hole in the ham.	彼はハムにたちまちのうちに大穴をあけました。
And he had no idea of stopping.	食べるのを止めようなんて考えてはいませんでした。
But he did stop.	けれど止めました。
He stopped very suddenly.	ひどく唐突に止めました。
For the first thing he knew, something threw him right down upon the floor.	はじめ彼が思ったのは、なにかに床に投げ落とされたということでした。
And the ham fell on top of him and nearly knocked him senseless.	それから、ハムが彼のお腹の上に落ちてきたので、あやうく失神しかけました。
He choked and spluttered;	11 ふとっちょはむせてせき込みました。
for the ashes filled his mouth and his eyes, and his ears, too.	灰が口や目や耳にまでいっぱい入ってしまったのです。
For a moment he lay there on his back;	しばらくの間、彼はあお向けにひっくり返っていました。
but soon he managed to kick the heavy ham off his stomach and then he felt a little better.	しかしすぐさまお腹の上の重たいハムをなんとか蹴りのけ、少し正気を取りもどしました。
But he was terribly frightened.	けれども、彼はひどくおびえていました。
And though his eyes smarted so he could hardly see, he sprang up and found the doorway.	目がずきずきと痛んでよく見えなかったというのに、飛び起きてとびらを見つけ、かけ抜けました。
Fatty swallowed a whole mouthful of ashes as he dashed across the barnyard.	12 内庭をいちもくさんにかけ抜ける間に、ふとっちょは口一杯に灰を吸い込んでしまいました。
And he never stopped running until he was almost home.	家が見えるまで、一度も走る足を止めませんでした。
He was puzzled.	彼は混乱していました。
Try as he would, he couldn't decide what it was that had flung him upon the floor.	なにに床に投げ落とされたのか、考えてみましたがわかりませんでした。
And when he told his mother about his adventure	お母さんにこの冒険のことを話しますと
--as he did a whole month later	――まる一か月後のことでしたが
--she didn't know exactly what had happened, either.	――彼女にも、なにが起きたのかはっきりとはわかりませんでした。
"It was some sort of trap, probably,"	13 「わなの一しゅだったのかもしれないね」
Mrs. Coon said.	とあらいぐま夫人は言いました。
But for once Mrs. Coon was mistaken.	14 けれどあらいぐま夫人はまたまた間違っていました。
It was very simple.	15 じつに単純なことでした。
In his greedy haste Fatty had merely bitten through the cord that fastened the ham to the pole.	食い意地がはってあせったふとっちょは、横棒につるしたハムをゆわえたひもを食いちぎってしまっただけだったのでした。
And of course it had at once fallen, carrying Fatty with it!	当然ながら、ハムはたちまち落っこち、上に乗っていたふとっちょも一緒に落っこちたのでした！
But what do you suppose?	18 けれど、みなさんはこれをどう思います？
Afterward, when Fatty had grown up, and had children of his own, he often told them about the time he had escaped from the trap in Farmer Green's smokehouse.	のちにふとっちょが大人になり、子どもを持つと、農夫のグリーンのくんせい小屋のわなから脱け出したときのことを、しばしば子どもたちに語ってきかせました。
Fatty's children thought it very exciting.	17 ふとっちょの子どもたちは、このお話にたいそう興奮しました。
It was their favorite story.	彼らのお気に入りのお話でした。
And they made their father tell it over and over again.	そして、何度も何度もくり返しねだって、父親にお話させたのでした。
XVI FATTY COON PLAYS ROBBER	ふとっちょ、どろぼうになる
After Fatty Coon played barber-shop with Jimmy Rabbit and his brother it was a long time before he met them again.	1 うさぎのジミーとその弟といっしょに床屋さんごっこをして以来、ふとっちょあらいぐまは長いあいだふたりに出会えませんでした。
But one day Fatty was wandering through the woods when he caught sight of Jimmy.	ところがある日、森の中をぶらぶら歩いているときに、ジミーの姿を見つけました。
Jimmy dodged behind a tree.	ジミーは木のかげにひらりと身をかくしました。
And Fatty saw Jimmy's brother peep from behind another.	ふとっちょは、ジミーの弟がべつの木のかげからこちらをぬすみ見ているのに気づきました。
You see, his ears were so long	だってね、弟の耳はとっても長いでしょう。
that they stuck far beyond the tree, and Fatty couldn't help seeing them.	二本の耳が木のかげからにょっきりつき出ていて、ふとっちょが気づかないわけにいかなかったのですよ。
"Hello!"	2 「やあ！」
Fatty called.	ふとっちょは声をかけました。
"I'm glad to see you."	「会えてうれしいよ」
And he told the truth, too.	それは本心でもありました。
He had been trying to find those two brothers for weeks, because he wanted to get even with them for cutting off his moustache.	数週間のあいだふたりの兄弟を探しつづけてきたのは、仕返しにふたりの口ひげをちょん切ってやりたかったからなのですから。
Jimmy and his brother hopped out from behind their trees.	ジミーとその弟は、それぞれの木のかげからぴょんと飛び出しました。
"Hello!"	3 「やあ！」
said Jimmy.	ジミーが言いました。
"We were just looking for you."	「ちょうど君を見つけようとしていたんだよ」
Probably he meant to say,	たぶん、ジミーはこう言いたかったんでしょう。
"We were just looking AT you."	「ちょうど君から見つからないようにしていたんだよ」
He was somewhat upset by meeting Fatty;	ふとっちょと出会ってしまい、ジミーは少々うろたえていました。
for he knew that Fatty was angry with him.	ふとっちょが自分のしたことに腹を立てているのを知っていましたから。
"Oh, ho!	4 「へーえ！
You were, were you?"	ぼくを見つけようとしていたって？」
Fatty answered.	ふとっちょは言いました。
He began to slide down the tree he had been climbing.	彼は上りかけていた木をそろそろと下り始めました。
Jimmy Rabbit and his brother edged a little further away.	5 うさぎのジミーと弟は、じりじりと後ずさりしました。
"Better not come too near us!"	6 「ぼくらにあんまり近づかないほうがいいよ！」
he said.	ジミーが言いました。
"We've both got the pink-eye,	「ぼくらふたりとも結膜炎なんだ。
and you don't want to catch it."	近づくと君にもうつっちゃうぞ」
Fatty paused and looked at the brothers.	7 ふとっちょは立ち止まり、兄弟をよく見ました。
Sure enough!	まあ、本当だ！
their eyes were as pink as anything.	ふたりの目は、ひどい赤色でした。
"Does it hurt much?"	8 「目になにかが入ったの？」
Fatty asked.	ふとっちょはたずねました。
"Well	9 「うーん
--it does and it doesn't,"	……そうでもあるし、そうでもないよ」
Jimmy replied.	ジミーは答えました。
"I just stuck a brier into one of my eyes a few minutes ago and it hurt awful, then.	「ほんの少し前に、片いっぽうの目にイバラのトゲが目に入ってすごく痛かったんだ。
But you'll be perfectly safe,	でも、君はぜんぜん大丈夫だよ。
so long as you don't touch us."	ぼくらにさわりさえしなければね」
"How long does it last?"	10 「どれくらいで治るの？」
Fatty inquired.	ふとっちょがたずねました。
"Probably we'll never get over it,"	11 「たぶん絶対に治らないよ」
Jimmy Rabbit said cheerfully.	うさぎのジミーはうれしそうに言いました。
And his brother nodded his head, as much as to say,	弟も、力強くうなづきながら言いました。
"That's so!"	「絶対にそうさ！」
Fatty Coon was just the least bit alarmed.	12 ふとっちょあらいぐまはほんのちょっぴり警戒しました。
He really thought that there was something the matter with their eyes.	彼は、ふたりの目がどうかしてしまったのかしらと本気で心配しました。
You see, though the Rabbit brothers' eyes were always pink	ふたりの兄弟はうさぎですから、目はたいていいつも真っ赤っかでしょう
(for they were born that way),	（うさぎは生まれつきそうなのです）。
he had never noticed it before.	それなのにね、ふとっちょはこれまでそのことにちっとも気づかなかったのですよ。
So Fatty thought it would be safer not to go too near them.	ですから、ふとっちょはふたりにあんまり近づかないようにすれば大丈夫なのだろうと思ってしまいました。
"Well, it's too bad,"	13 「そっか、それは残念だな」
he told Jimmy.	ふとっちょはジミーに言いました。
"I'm sorry. I wanted to play with you."	「君たちと遊びたかったんだけど、がっかりだよ」
"Oh, that's all right!"	14 「ああ、それならいいよ！」
Jimmy said.	ジミーが言いました。
"We can play, just the same.	「前みたいに遊べるよ。
I'll tell you what we'll play.	どうやって遊ぶのか教えてあげる。
We'll play--"	あのね――」
"Not barber-shop!"	15 「床屋さんごっこはだめだよ！」
Fatty interrupted.	ふとっちょがさえぎりました。
"I won't play barber-shop,	「床屋さんごっこはしないぞ。
I never liked that game."	あの遊びは大っきらいだ」
Jimmy Rabbit started to smile.	16 うさぎのジミーは笑い始めました。
But he turned his smile into a sneeze.	けれど、笑いをくしゃみでごまかしました。
And he said--	それから、ジミーは言いました――
"We'll play robber.	17 「どろぼうごっこをするんだよ。
You'll like that, I know.	君はきっと気に入るよ。
And you can be the robber.	君はどろぼう役にぴったりだしね。
You look like one, anyhow."	君はとにかくどろぼうみたいなんだから」
That remark made Fatty Coon angry.	18 その言葉にふとっちょあらいぐまは腹を立てました。
And he wished that Jimmy hadn't the pink-eye.	ジミーが結膜炎などにかかっていなければいいのにと思いました。
He would have liked to make an end of him right then and there.	彼はただちにジミーとけりを着けたくて仕方がありませんでした。
"What do you mean?"	19 「どういう意味だ？」
he shouted.	ふとっちょはさけびました。
"Robber nothing!	「ぼくはどろぼうなんかじゃない！
I'm just as good as you are!"	君と同じくらいいい子だよ！」
"Of course, of course!"	20 「もちさ、もちさ！」
Jimmy said hastily.	ジミーがあわてて言いました。
"It's your face, you know,	「君の顔のことだよ、ね。
That black patch covers your eyes just like a robber's mask.	その君の目のまわりの黒いぶちは、どろぼうのマスクにそっくりだろ。
That's why we want you to be the robber."	だから君にどろぼう役になってもらいたいんだよ」
Fatty had slipped down his tree to the ground;	21 ふとっちょは木からすべり下り、地面に下り立ちました。
and now he looked down into the creek.	そして、小川の水にうつった自分の顔を見下ろしました。
It was just as Jimmy said.	ジミーの言ったとおりでした。
Fatty had never thought of it before, but the black patch of short fur across the upper part of his face made him look exactly like a robber.	ふとっちょはこれまで考えもしませんでしたが、彼の顔の上側を横に走っている短い毛の黒ぶちは、まさにどろぼうそっくりでした。
"Come on!"	22 「おいでよ！」
said Jimmy.	ジミーが言いました。
"We can't play the game without you."	「君がいないと始まらないよ」
"Well	23 「うん
--all right!"	……いいよ！」
said Fatty.	ふとっちょは言いました。
He began to feel proud of his mask.	彼は、自分のマスクをほこらしく思い始めました。
"What shall I do?"	「ぼくは何をしたらいいの？」
"You wait right here,"	24 「君はここで待っているんだよ」
Jimmy ordered.	ジミーが命じました。
"Hide behind that tree.	「あの木のかげでかくれてるんだよ。
We'll go into the woods.	ぼくらは森の中へ行くからね。
And when we come back past this spot you jump out and say	それで、ぼくらがこの場所にもどってきたら、ぼくらに飛びかかってこう言うんだ。
'Hands up!'	『手を上げろ！』
... You understand?"	……わかった？」
"Of course!"	25 「もちさ！」
said Fatty.	ふとっちょは言いました。
"But hurry up!	「でもはやくもどって来てね！
Don't be gone long."	長く待つのはいやだからね」
"Leave that to us,"	26 「まかせといてよ」
said Jimmy Rabbit.	うさぎのジミーは言いました。
He winked at his brother;	彼は弟にウィンクしました。
and they started off together.	それからふたりは連れ立って森の中に去っていきました。
Fatty Coon did not see that wink.	27 ふとっちょあらいぐまにはウィンクが見えませんでした。
If he had, he wouldn't have waited there all the afternoon for those Rabbit brothers to return.	もしも見ていたら、午後じゅううさぎの兄弟がもどって来るのを待っていたりしなかったでしょう。
They never came back at all.	兄弟は二度ともどって来ませんでした。
And they told everybody about the trick they had played on Fatty Coon.	そして、ふとっちょあらいぐまをだまくらかしたことをみんなに言いふらしました。
For a long time after that wherever Fatty went the forest-people called "Robber!" after him.	それから長い間、ふとっちょはどこに行っても森の住民から、
And Jasper Jay was the most annoying of all,	カケスのジャスパーの声は、誰よりも悩ましいものでした。
because whenever he shouted "Robber!" he always laughed so loudly and so long.	なぜなら、彼はいつでも
His hoarse screech echoed through the woods.	彼のしわがれた金きり声は、森じゅうにこだましました。
And the worst of it was, everybody knew what he was laughing at.	それが何よりも悪いのは、みんなにふとっちょが笑われていることが知れわたってしまうことでした。
XVII FATTY FINDS THE MOON	ふとっちょ、お月さまを見つける
Wandering through the woods one day, Fatty Coon's bright eyes caught a strange gleam from something	1 ある日森を歩きまわっていたふとっちょあらいぐまは、かがやく目でなにやら奇妙な光るものをとらえました
--something that shone and glittered out of the green.	――なにかがピカピカと光をはなっているのが、森の木々の葉のあいだから見えました。
Fatty wanted to see what it was, though he hardly thought it was anything to eat.	食べ物だとはとても思えませんでしたが、それでもふとっちょは、それがなんなのか見てみたいと思いました。
But whenever he came upon something new he always wanted to examine it.	とはいえ、なにか真新しいものにぶつかったときには、彼はいつも必ず確かめたいと思うのでした。
So now Fatty hurried to see what the strange thing was.	それで、その奇妙なものを見てやろうと先をいそぎました。
It was the oddest thing he had ever found	2 それはふとっちょがこれまで見たものの中で、一番おかしなものでした
--flat, round, and silvery;	――平たくて、丸くて、銀色をしていました。
and it hung in the air, under a tree, just over Fatty's head.	木の下の、ちょうどふとっちょの頭の上あたりの空中に、それは浮かんでいました。
Fatty Coon looked carefully at the bright thing.	ふとっちょあらいぐまはその光るものを注意ぶかくながめました。
He walked all around it, so he could see it from all sides.	それのまわりをぐるりと歩いて、あらゆる方向から見てみました。
And at last he thought he knew what it was.	そしてついに、それがなんなのかわかったと思いました。
He made up his mind that it was the moon!	お月さまです！
He had often seen the moon up in the sky;	3 ふとっちょは空に浮かんでいるお月さまをたびたび見ていました。
and here it was, just the same size exactly, hanging so low that he could have reached it with his paw.	ここにある光るものは、きっかり同じ大きさで、ふとっちょが前足を伸ばせばとどくくらいとても低いところに浮かんでいました。
He saw nothing strange in that;	彼はそれをおかしなことだとは思いませんでした。
for he knew that the moon often touched the earth.	お月さまが時どき地面にくっついているのを知っていたからです。
Had he not seen it many a time, resting on the side of Blue Mountain?	ブルー山の山すその上でお月さまがお休みしているのを、何度も見たではありませんか？
One night he had asked his mother	ある晩、彼はお母さんにたずねました。
if he might go up on the mountain to play with the moon;	山にのぼったらお月さまと遊べるかしらって。
but she had only laughed.	けれどお母さんは笑うだけでした。
And here, at last, was the moon come to him!	ここにきてついに、お月さまがふとっちょのところにやって来たのです！
Fatty was so excited that he ran home as fast as he could go,	ふとっちょはひどく興奮し、家にむかって全速力で走っていきました。
to tell his mother, and his brother Blackie, and Fluffy and Cutey, his sisters.	お母さんや弟の黒っちょや妹のふわっちょやかわいっちょに教えるためです。
"Oh!	4 「ああ！
the moon!"	月！」
Fatty shouted.	ふとっちょはさけびました。
He had run so fast that, being so plump, he was quite out of breath.	彼はとてもふとっており、あまりにはやく走ったので、すっかり息が切れていました。
And that was all he could say.	言うことができたのはそれだけでした。
"Well, well!	5 「まあまあ！
What about the moon!"	月がどうしたっていうのさ！」
Mrs. Coon asked.	あらいぐま夫人がたずねました。
"Anybody would think you had found it, almost."	「なにか見つけたってところだね、だいたい」
And she smiled.	あらいぐま夫人はほほ笑みました。
Fatty puffed and gasped.	6 ふとっちょはハーハーゼイゼイと息をつきました。
And at last he caught his breath again.	それからとうとうまた話せるようになりました。
"Yes	7 「そうなんだ
--I've found it!	――見つけたんだよ！
It's over in the woods	森の中でね
--just a little way from here!"	――ここからすぐのところだよ！」
he said.	ふとっちょは言いました。
"Big, and round, and shiny!	「おっきくて、丸くて、光ってるんだ！
Let's all go and bring it home!"	みんなで行ってお家に連れてこようよ！」
"Well, well, well!"	8 「まあ、まあ、まあ！」
Mrs. Coon was puzzled.	あらいぐま夫人は困りはてました。
She had never heard of the moon being found in those woods;	森の中でお月さまを見たなんて話は、聞いたことがありません。
and she hardly knew what to think.	あらいぐま夫人は、それについてどう考えればいいのかわかりませんでした。
"Are you sure?"	「確かなのかい？」
she asked.	彼女はたずねました。
"Oh, yes, Mother!"	9 「確かだよ、お母さん！」
Fatty could hardly wait,	ふとっちょはぐずぐずしていられませんでした。
he was so eager to lead the way.	先に立ってみんなを連れていきたくて仕方がありませんでした。
And with many a shake of the head, Mrs. Coon, with her family, started off to see the moon.	ふとっちょに何度も説得されて、あらいぐま夫人とその家族は、しぶしぶながらお月さまを見に出かけました。
"There"!	10 「ここだよ！」
Fatty cried, as they came in sight of the bright, round thing.	光る丸いものが見えるところまで来ると、ふとっちょはさけびました。
"There it is	「ほらね
--just as I told you!"	――ぼくの言ったとおりだろ！」
And they all set up a great shouting.	みんなはおどろいて大きなさけび声をあげました。
All but Mrs. Coon. She wasn't quite sure, even yet, that Fatty had really found the moon.	11 あらいぐま夫人もさけび声をあげましたが、彼女はそれでもまだ、ふとっちょが見つけはのは本当にお月さまだろうかとちょっぴり疑っていました。
And she walked close to the shining thing and peered at it.	彼女は光るもにに近づき、じっと見つめました。
But not too close!	けれど近づきすぎてはいけません！
Mrs. Coon didn't go too near it.	あらいぐま夫人はそれに近づきすぎたりはしませんでした。
And she told her children quite sternly to stand back.	彼女は子ども達に、後ろにさがっているようにときびしく言いつけました。
It was well that she did;	彼女のしたことは正しいことでした。
for when Mrs. Coon took her eyes off Fatty's moon and looked at the ground beneath it	あらいぐま夫人はふとっちょの月からふと目をそらし、その下の地面に目をやりました
--well!	――あぶない！
she jumped back	彼女は後ろに飛びのきました。
so quickly that she knocked two of her children flat on the ground.	あんまりすばやく飛んだので、後ろにいた二人の子どもにぶつかってたおしてしまいました。
A trap!	12 わなです！
THAT was what Mrs. Coon saw right in front of her.	あらいぐま夫人は、自分のすぐ足元にわながあるのを見つけたのです。
And Farmer Green, or his boy, or whoever it was that set the trap, had hung that bright piece of TIN over the trap	農夫のグリーンか、彼のやとい人か、あるいはだれかが、ブリキ缶の光る板をぶらさげたわなを仕掛けたのです。
hoping that one of her family would see it and play with it	あらいぐま夫人の家族の一ぴきがこれにじゃれつけばいいと考えて
--and fall into the trap.	――それがわななのです。
Yes	そうなのです
--it was a mercy that Fatty hadn't begun knocking it about.	――ふとっちょがわなの中に歩いていかなくて運がよかったのです。
For if he had he would have stepped right into the trap and it would have shut	もしもふとっちょがわなの中に足をふみ入れていたら、わなが閉まっていたでしょう
--SNAP!	――パチン！
Just like that.	このようにね。
And there he would have been, caught fast.	そうなったら、ふとっちょはしっかりととらえられてしまっていたところでした。
It was no wonder that Mrs. Coon hurried her family away from that spot.	13 あらいぐま夫人が家族を連れていそいでその場を立ち去ったのは、当然のことでした。
And Fatty led them all home again.	ふとっちょは、またしても家族の先頭に立って家に帰りました。
He couldn't get away from his moon fast enough.	だってお月さまからあんまりはやく逃げることができないのですからね。
XVIII THE LOGGERS COME	木こりがやって来た
Fatty Coon was frightened;	1 ふとっちょあらいぐまは、ぎょっとして目をさましました。
he had just waked up and he heard a sound that was exactly like the noise Farmer Green and his hired man had made when they cut down the tall chestnut tree where he was perched.	ちょうど、ふとっちょが逃げ込んだクリの木を、農夫のグリーンと作男が切りたおしたときにそっくりな騒音が聞こえたのです。
"Oh, Mother!	2 「お母さん！
What is it?"	これはなんの音なの？」
he cried.	ふとっちょはさけびました。
"The loggers have come,"	3 「木こりたちが来てるんだよ」
Mrs. Coon said.	あらいぐま夫人が言いました。
"They are cutting down all the big trees in the swamp."	「この沼の大木をぜんぶ切りたおしているのよ」
"Then we'll have to move, won't we?"	4 「なら、ぼくたちは逃げなくちゃならないんだね？」
Fatty asked.	ふとっちょがたずねました。
"No!	5 「いいえ！
They won't touch this tree,"	連中はこの木をかまいやしないよ」
his mother told him.	お母さんは言いました。
"It's an old tree, and hollow	「古い木だし、うろが空いてるからね
--so they won't chop it down.	――そういうのは切らないんだよ。
It's only the good sound trees that they'll take."	連中がえらぶのは、よさそうに見える木だけなんだよ」
"But I thought this was a good tree."	6 「でも、この木はいい木だと思うんだけどなあ」
Fatty was puzzled.	ふとっちょは混乱しました。
"So it is, my son!	7 「そのとおりさ！
It's a good tree for us.	わたしたちにとってはいい木よ。
But not for the loggers.	けど、木こりたちにとってはちがうの。
They would have little use for it."	連中には使い道があまりないのよ」
Fatty Coon felt better when he heard that.	8 ふとっちょあらいぐまはそれを聞くと安心しました。
And he had a good deal of fun, peeping down at the loggers and watching them work.	木こりたちが働く様子を、大いに面白がって上からこっそりのぞき見しました。
But he took care that they should not see HIM.	けど、注意して自分の姿が見えないようにしました。
He knew what their bright axes could do.	木こりのかがやく斧がなにをするものなのか、わかっていましたから。
When night came Fatty had still more fun.	9 夜になると、ふとっちょの楽しみはますます増えました。
When the loggers were asleep Fatty went to their camp in the woods beside the brook and he found many good things to eat.	木こりたちが寝しずまると、ふとっちょは小川のそばの森の中の彼らのキャンプに行き、おいしいごちそうをたくさん見つけました。
He did not know the names of all the goodies;	それらのごちそうの名前はひとつとして知りませんでしたが、
but he ate them just the same.	すべて同じように食べました。
He 'specially liked some potatoes	ふとっちょがとりわけ気に入ったのは、じゃがいもでした。
which the careless cook had left in a pan near the open camp-fire.	ぞんざいな調理人が、平なべの中の残り物を、たき火のそばにほったらかしにしていました。
The fire was out.	たき火は消えていました。
And the pan rested on a stump close beside it.	平なべは、たき火のそばの木の切りかぶの上に置いてありました。
Fatty Coon climbed up and crawled right inside the pan.	ふとっちょあらいぐまは切りかぶにのぼり、平なべの中にこっそりとしのび込みました。
And after he had had one taste of those potatoes he grew so excited	じゃがいもをひと口味見すると、ふとっちょはすっかり夢中になりました
--they were so good	――とてもおいしい味でした
--that he tipped the pan off the stump	――彼は平なべをひっくり返し、切りかぶから落としてしまいました。
and the potatoes rolled right into the ashes.	じゃがいもが灰の中に転がり落ちました。
Fatty had jumped to one side, when the tin pan fell.	10 ブリキの平なべが下に落っこちると、ふとっちょはわきへ飛びのきました。
It made a great clatter;	ガチャンガチャンとたいそう大きな音がしました。
and he kept very still for a few moments, while he listened.	彼はほんのしばらく息をひそめ、耳をすませました。
But no one stirred.	しかし、だれも目をさまして身動きしたりしませんでした。
And then Fatty jumped plump into the ashes.	彼はじゃがいもを追いかけて灰の中にざぶんと飛び込みました。
WHEW!	11 ヒャーッ！
He jumped out again as fast as he could;	ふとっちょは、あらんかぎりのはやさでまた飛びのきました。
for beneath the ashes there were plenty of hot coals.	灰の下に、熱く燃えた石炭がたっぷりしかれていたのです。
Fatty stood in them for not more than three seconds, but that was quite long enough.	ほんの三つ数えるあいだ立ちつづけることも我慢できないほどでした。
The bottoms of his feet burned as if a hundred hornets had stung them.	彼は足のうらをやけどし、まるで百ぴきのハチに刺されたように痛みました。
He stood first on one foot and then on another.	12 ふとっちょはばたばたと足を上げたり下げたりしました。
If you could have seen him you would have thought Fatty was dancing.	みなさんがそれを見たら、ふとっちょはダンスをしているのかしらと思ったでしょう。
And you might have laughed,	みなさんはきっとお笑いになったでしょう。
because he looked funny.	彼の格好はこっけいでしたから。
But Fatty Coon did not laugh.	13 けれどふとっちょあらいぐまは笑いませんでした。
In fact, he came very near crying.	じつのところ、彼は泣き出さんばかりでした。
And he did not wait to eat another mouthful.	もうひと口食べるまで居つづけることもできませんでした。
He limped along toward home.	彼はびっこを引きひき家に帰りました。
And it was several days before he stirred out of his mother's house again.	それから数日のあいだ、彼はお母さんの家から外に出られませんでした。
He just lay in his bed and waited until his burns were well again.	ただベッドに横たわり、やけどが治るのを待っていました。
It was very hard.	14 それはたいそう辛いことでした。
For Fatty did not like to think of all those good things to eat that he was missing.	おいしいごちそうのことを考えて焦れることしかできないのですもの。
And he hoped the loggers would not go away before his feet were well again.	彼は、また歩けるようになるまで木こりたちがどこにも行きませんようにと願いました。
XIX FATTY GROWS EVEN FATTER	ふとっちょ、さらにふとる
When Fatty Coon's burned feet were well once more, the very first night he left his mother's house he went straight to the loggers' camp.	1 足のうらのやけどの具合がよくなったその夜、ふとっちょあらいぐまはお母さんの家を出て、また木こりのキャンプに向かいました。
He did not wait long after dark,	暗くなるまでじっと待ってなんていませんでした。
because he was afraid that some of his neighbors might have found that there were good things to eat about the camp.	だって、森の隣人たちがキャンプのおいしい食べ物を見つけてしまうんじゃないかと心配でしたから。
And Fatty wanted them all.	ふとっちょは、すべてひとり占めにしたかったのです。
To his delight, there were goodies almost without end.	2 うれしいことに、ごちそうはほとんど尽きることがありませんでした。
He nosed about, picking up potato peelings, and bits of bacon.	彼はキャンプをかぎ回り、じゃがいもの皮やベーコンのかけらをつまみ食いしました。
And perhaps the best of all was a piece of cornbread,	すべてのごちそうのうちでおそらく一番おいしいのは、とうもろこしパンでした。
which Fatty fairly gobbled.	ふとっちょはこれをがつがつと大いにむさぼり食べました。
And then he found a box half-full of something	それから、彼はなにかが半分ほどつまった箱を見つけました
--scraps that tasted like apples, only they were not round like apples, and they were quite dry, instead of being juicy.	――中身はリンゴのような味のする切れっぱしでしたが、ただリンゴみたいに丸くないし、みずみずしくなくてすっかり乾いていました。
But Fatty liked them;	けれどふとっちょはこれが気に入りました。
and he ate them all, down to the smallest bit.	最後のちっぽけなくずまで、きれいに平らげました。
He was thirsty, then.	3 それから、彼はのどが乾きました。
So he went down to the brook, which ran close by the camp.	それでキャンプのそばを流れる小川に下っていきました。
The loggers had cut a hole through the ice, so they could get water.	木こりたちは小川に張った氷に穴をあけ、そこで水をくめるようにしていました。
And Fatty crept close to the edge of the hole and drank.	ふとっちょはこの穴のふちに歩いていき、水を飲みました。
He drank a great deal of water,	彼はずいぶんとたっぷり水を飲みました。
because he was very thirsty.	ひどくのどが乾いていたからです。
And when he had finished he sat down on the ice for a time.	飲み終わると、しばらくのあいだ氷の上に座り込んで休みました。
He did not care to stir about just then.	その時、木こりたちが目を覚ますおそれなど気になりませんでした。
And he did not think he would ever want anything to eat again.	それに、もうなんにも食べようという気が起こりませんでした。
At last Fatty Coon rose to his feet.	4 そらからとうとうふとっちょあらいぐまは、立ち上がりました。
He felt very queer.	とてもおかしな感じがしました。
There was a strange, tight feeling about his stomach.	おかしいのは、お腹が張っている感じがするせいでした。
And his sides were no longer thin.	彼のわき腹は、もはややせていませんでした。
They stuck out just as they had before winter came	冬が来る前のようにつき出ていました
--only more so.	――でも、それ以上でした。
And what alarmed Fatty was this:	これにはふとっちょもぎくりとしました。
his sides seemed to be sticking out more and more all the time.	みるみるうちに、どんどんどんどんわき腹がつき出していくようなのです。
He wondered what he had been eating.	5 自分はいったいなにを食べたのかしらと、ふとっちょは首をかしげました。
Those dry things that tasted like apples	リンゴのような味のする乾いたもの
--he wondered what they were.	――これはいったいなにかしら。
Now, there was some printing on the outside of the box which held those queer, spongy, flat things.	6 さて、このスポンジのようにふかふかで平べったい、おかしなものが入った箱の外側には、ラベルが貼ってありました。
Of course, Fatty Coon could not read, so the printing did him no good at all.	もちろんふとっちょあらいぐまは字が読めませんから、彼にはこれがまったく役に立ちませんでした。
But if you had seen the box, and if you are old enough to read, you would have known that the printing said:	けれど、字が読めるくらいに大きいみなさんがこの箱のラベルを見たならば、こんなふうに読むでしょう。
EVAPORATED APPLES	7 『エバ・アップル』。
Now, evaporated apples are nothing more or less than dried apples.	8 エバ・アップルというのは、乾燥リンゴのことにほかなりません。
The cook of the loggers' camp used them to make apple pies.	木こりのキャンプの調理人は、これを使ってアップルパイを作っていました。
And first, before making his pies, he always soaked them in water	調理人はパイを作り始める前に、いつも最初にこの乾燥リンゴを水につけてふやかしておきます。
so they would swell.	すると、乾燥リンゴはふくれ上がります。
Now you see what made Fatty Coon feel so queer and uncomfortable.	9 さて、どうしてふとっちょあらいぐまがひどくおかしな感じがして心地わるくなったのか、みなさんはおわかりですね。
He had first eaten his dried apples.	彼は最初に乾燥リンゴを食べたのです。
And then he had soaked them, by drinking out of the brook.	そして小川の水を飲んだことにより、お腹の中で乾燥リンゴをふやかしてしまったのです。
It was no wonder that his sides stuck out,	彼のわき腹がつき出したのも不思議ではありません。
for the apples that he had bolted were swelling and puffing him out until he felt that he should burst.	丸呑みしたリンゴの切れはしがぷうっとふくらんで、お腹が破れつしそうになるまでに大きくなってしまったのです。
In fact, the wonder of it was that he was able to get through his mother's doorway, when he reached home.	実際のところ、ふとっちょがお母さんの家にたどり着いたとき、戸口の穴をくぐり抜けられたのが不思議なほどでした。
But he did it, though it cost him a few groans.	10 ふとっちょは小さくウーンとうめき声を上げ、なんとか戸口をくぐり抜けました。
And he frightened his mother, too.	これにはお母さんもぎょっとしました。
"I only hope you're not poisoned,"	11 「お前が食べたのが毒でないことを祈るばかりだよ」
she said, when Fatty told her what he had been doing.	ふとっちょが自分のしたことを話すと、お母さんが言いました。
And that remark frightened Fatty more than ever.	12 この言葉に、ふとっちょはますますおびえました。
He was sure he was never going to feel any better.	彼はもう一生よくなることはないのだと信じ込みました。
Poor Mrs. Coon was much worried all the rest of the night.	13 哀れなあらいぐま夫人は、その夜中たいそう心配しました。
But when morning came she knew that Fatty was out of danger.	けれど朝になると、ふとっちょが峠を越えたことを知りました。
She knew it because of something he said.	どうしてわかったのかというと、ふとっちょがこう言ったからです。
It was this:	こうですよ。
"Oh, dear!	14 「あーあ！
I wish I had something to eat!"	なにか食べたいなあ！」
THE TRACKS IN THE SNOW	雪の上の足あと
One fine winter's day Fatty Coon came upon the queerest tracks in the snow.	1 冬のある晴れた日、ふとっちょあらいぐまは雪の上におかしな足あとがあるのに出くわしました。
They were huge	それは大きな足あとでした
--a great deal bigger, even, than bear-tracks,	――クマの足あとさえ、これよりずっと小さいくらいでした。
which Fatty had sometimes seen, for once in a while,	ふとっちょはクマの足あとなら何度か見たことがありました。
before the weather grew too cold, and he fell into his winter's sleep, a bear would come down into the valley from his home on Blue Mountain.	辺りがひどく冷え込んでクマが冬眠する季節がせまると、クマは時どき彼の家のあるブルー山を下りて谷間にやって来るのです。
But these were six times as big as bear tracks.	2 けれどこの足あとは、クマの足あとの六倍もありました。
And Fatty felt a shiver of fear run up and down his back.	ふとっちょは、恐ろしさに背中の上から下までふるえが走るのをかんじました。
He followed the trail a little way.	3 ふとっちょは足あとを少したどっていきました。
But he was very careful.	けれどとても用心深くしていました。
He was always ready to scramble up a tree,	いつでも木に駆け上れるように身がまえていました。
in case he should suddenly see the strange animal	ふいにおかしな動物と出くわしたときにそなえて
--or rather, in case the strange animal should see HIM.	――というか、そのおかしな動物が彼の姿に気づいたときにそなえて。
The great tracks led straight toward Farmer Green's house.	4 その巨大な足あとは、農夫のグリーンの家にまっすぐにむかっていました。
And Fatty did not want to go there.	ふとっちょはそこへは近づきたくありませんでした。
So he hurried home to ask his mother what he had found.	ですから、お母さんに見つけたもののことをたずねようと、家に走っていきました。
Mrs. Coon listened to Fatty's story.	あらいぐま夫人はふとっちょの話に耳をかたむけました。
"I think it must be the monster	5 「あの怪物だと思うんだ。
that almost caught me in the road last summer,"	去年の夏に、ぼくが道でもうちょっとでつかまえられそうになったやつさ」
said Fatty,	と、ふとっちょは言いました。
meaning the automobile	怪物とは自動車のことです。
that had given him a great fright.	彼はそれにたいそう恐い思いをさせれたのです。
"Maybe he's come back again to catch Farmer Green and his family	「もしかして、農夫のグリーンさんと家族をつかまえにもどって来たのかなあ
... Do you suppose he's eaten them up?"	……あの人たちは食べられちゃうんだと思う？」
Mrs. Coon was puzzled.	6 あらいぐま夫人は困わくしました。
And she was somewhat alarmed, too.	それに、少しょう警戒しました。
She wanted to see those strange tracks herself.	自分の目でそのおかしな足あとを見てみたいと思いました。
So she told her other children not to step a foot out of the house until she came back.	それでほかの子どもたちに、彼女がもどって来るまで家から一歩も出てはならないと命じました。
And then she asked Fatty to run along and show her where he had come upon the monster's trail.	そしてふとっちょに、ひとっ走り行ってその怪物の足あとに出くわした場所に彼女を案内するように言いました。
Fatty Coon felt very important, as he led the way across the swamp and into the woods.	7 お母さんの先に立って沼を横ぎり、森に入る道すがら、これは重大事だとふとっちょあらいぐまは思いました。
It was not often that he could show his mother anything.	お母さんを案内することなんてめったにありませんもの。
And he was so proud that he almost forgot his fright.	彼は誇らしい気分にひたるあまり、恐ろしいのをほとんど忘れかけました。
"I guess you're glad I have sharp eyes,"	8 「ぼくの目がするどいんで、お母さんもよかっただろ」
he said, as they hurried along.	道をいそぎながら、ふとっちょは言いました。
"If the tracks are as big as you say they are, your eyes wouldn't have to be very sharp to see them,"	9 「その足あとがお前が言うほど大きいんなら、たいしてするどくなくたって見えるだろう」
his mother told him.	お母さんはふとっちょに言いました。
Mrs. Coon never liked to hear her children boast.	あらいぐま夫人は、自分の子が自慢話をするのを聞くのが大嫌いでした。
She knew that boasting is one of the most unpleasant things anyone can do.	どんな者であろうと自慢話をするのは嫌がられることの一つであるのを、知っていたのです。
"Well	10 「ふーん
--maybe you don't think I saw the monster's tracks at all,"	……ぼくが怪物の足あとを見たっていうの、ぜんぜん信じてないんだね」
said Fatty.	ふとっちょは言いました。
"Maybe you don't think I heard him screech--"	「ぼくがあいつの絶叫を聞いたっていうのも――」
"When did you hear him screech?"	11 「いつ絶叫を聞いたんだって？」
Mrs. Coon asked.	あらいぐま夫人がたずねました。
"This is the first you've said about SCREECHING.	「『絶叫』だなんて言うの、これが初めてじゃないか。
When was it?"	それはいつのことなの？」
"Last summer,"	12 「去年の夏だよう」
Fatty answered.	ふとっちょが言いました。
Mrs. Coon didn't smile.	13 あらいぐま夫人は笑いませんでした。
Perhaps she was too worried for that.	おそらく、あんまり心配しすぎていたせいでしょう。
"It may not be the same monster,"	14 「同じ怪物ではないかもしれないよ」
she said.	あらいぐま夫人は言いました。
"It may not be a monster at all."	「ちっとも怪物ではないかもしれないよ」
But by this time Fatty was sure he was right.	15 けれど今回は、ふとっちょは自分は間違っていないと確信していました。
He was sure he knew more than his mother.	ふとっちょは、お母さんよりも自分のほうが多くのことを知っているのだと確信しました。
"Why can't we go right over to Farmer Green's and take some of his chickens?"	16 「このまま農夫のグリーンさんの家へ行こうよ、ニワトリをつかまえにさ」
he asked.	ふとっちょは言いました。
"The monster has probably eaten him by this time,	「あの怪物、今ごろきっとグリーンさんを食べてるよ。
and all his family, too."	グリーンさんの家族も全員ね」
But Mrs. Coon would do no such thing.	17 けれどあらいぐま夫人は、そんなことをするつもりはありませんでした。
"Show me the tracks,"	18 「足あとをお見せ」
she said firmly.	あらいぐま夫人はがんとして言いました。
And so they went on into the woods.	そして、ふたりは森の中に入っていきました。
"There they are!"	19 「これだよ！」
Fatty cried, a few minutes later.	数分後、ふとっちょあらいぐまはさけびました。
"See, Mother!	「ほらね、お母さん！
They're even bigger than I said."	ぼくが言ったよりも大きいくらいじゃないか」
He heard a funny noise behind him, then.	ふとっちょあらいぐまは、背後がおかしな音がするのを聞きました。
And when Fatty Coon looked around he saw that his mother was actually holding her sides,	辺りを見まわしてみますと、まさにお母さんが両腕でわき腹を抱え込んだところでした。
she was laughing so hard.	お母さんは、はげしく笑い転げました。
"Those are Farmer Green's tracks,"	20 「それは農夫のグリーンの足あとさ」
she said, as soon as she could stop laughing long enough to speak.	さんざん笑ってようやく話せるようになると、お母さんはすぐさま言いました。
"What	21 「どうして
--as big as that?"	……こんなに大きいんだよ？」
Fatty pointed at the huge prints in the snow.	ふとっちょは、雪の上の巨大なこん跡を指さしました。
"Snowshoes!"	22 「かんじきだよ！」
Mrs. Coon said.	あらいぐま夫人は言いました。
"He was wearing snowshoes	「かんじきをはいていたのよ
--great frames made of thongs and sticks,	――かんじきっていうのはね、木の枝と革ひもで作った大きなげたのことよ。
to keep him from sinking into the snow."	これをはくと、雪の中に足が沈みこむのを防げるのさ」
So that was all there was to Fatty's monster.	23 それが、ふとっちょの怪物の正体なのでした。
Somehow, he was disappointed.	彼はいくぶんがっかりしました。
But he was very glad	けれど、それがわかって大よろこびしました。
he had said nothing to Jasper Jay about his strange animal.	カケスのジャスパーにおかしな動物の話をしないで済んだのですもの。
For if he had, he knew he would never have heard the last of it.	もしも話していたら、一生うわさされ続けるに決まっていますから。
And Fatty was glad about another thing, too.	24 ふとっちょは別のことでもよろこびました。
He felt very happy that his mother had not let him go after Farmer Green's chickens.	お母さんが、ふとっちょが農夫のグリーンのニワトリをつかまえに行くのをゆるさなかったのは、とても幸運だったと思うのでした。
THE END	おしまい
