V. THE FAD OF THE FISHERMAN	第五話 釣り人の習慣
A thing can sometimes be too extraordinary to be remembered.	忘れられないほど風変わりなことというのがときどきある。
If it is clean out of the course of things, and has apparently no causes and no consequences,	ことの経過がはっきりしていたとしても、原因も結果もはっきりとしない。
subsequent events do not recall it, and it remains only a subconscious thing, to be stirred by some accident long after.	続いて起こった出来事は思い出されることもなく、かなり経ってから偶然目覚めさせられるまでのあいだ、潜在意識の中にだけ存在し続けることになる。
It drifts apart like a forgotten dream;	忘れられた夢のようなものがバラバラに漂っていた。
and it was in the hour of many dreams, at daybreak and very soon after the end of dark,	夜も明けたばかりの夢の中でのことだ。
that such a strange sight was given to a man sculling a boat down a river in the West country.	西部地方の川をボートで下っている人物がそんな光景を見た。
The man was awake;	もう目は冴えていた。
indeed, he considered himself rather wide awake,	実際かなり冴えた人物だ。
being the political journalist, Harold March, on his way to interview various political celebrities in their country seats.	政治記者のハロルド・マーチは、名士の邸宅で行われるインタビューに向かうところだった。
But the thing he saw was so inconsequent that it might have been imaginary.	だがマーチの見たものは、あまりに空想的で不合理なものだった。
It simply slipped past his mind and was lost in later and utterly different events;	心を駆け抜けると、後にはまったく違うことがとって変わった。
nor did he even recover the memory till he had long afterward discovered the meaning.	かなり後になってその意味に気付くまで、思い出しもしなかった。
Pale mists of morning lay on the fields and the rushes along one margin of the river;	川辺には薄い朝靄がかかり、川べりには藺草が生えている。
along the other side ran a wall of tawny brick almost overhanging the water.	向こうべりには黄色い煉瓦塀が水の上に突き出している。
He had shipped his oars and was drifting for a moment with the stream, when he turned his head and saw that the monotony of the long brick wall was broken by a bridge;	ボートを漕ぎ、しばらく流れに漂っていたが、振り向くと単調な長い煉瓦塀を見渡した。
rather an elegant eighteenth-century sort of bridge	十八世紀の優雅な橋だ。
with little columns of white stone turning gray.	白い柱は灰色に変わっている。
There had been floods and the river still stood very high, with dwarfish trees waist deep in it,	大雨のため川の水位はまだ高いままで、背の低い木は半ば水に浸っていた。
and rather a narrow arc of white dawn gleamed under the curve of the bridge.	夜明けの白い光が、橋のアーチの下から小さな弧を描き輝いている。
As his own boat went under the dark archway he saw another boat coming toward him,	ボートがアーチの下の暗がりにさしかかったとき、向こうからもう一艘のボートがやってくるのが見えた。
rowed by a man as solitary as himself.	漕いでいるのはマーチ同様ひとりだった。
His posture prevented much being seen of him, but as he neared the bridge he stood up in the boat and turned round.	隠れるようにしていたが、橋の近くまで来ると立ち上がって向きを変えた。
He was already so close to the dark entry, however, that his whole figure was black against the morning light,	暗いアーチのすぐそばまで来ていたが、朝日が逆光となり黒い影しか見えなかった。
and March could see nothing of his face except the end of two long whiskers or mustaches that gave something sinister to the silhouette,	マーチは長く伸びた頬髯だか口髭だかしか見ることができなかったが、その髭に不吉な印象を受けた。
like horns in the wrong place.	角が間違った場所に生えたみたいだ。
Even these details March would never have noticed but for what happened in the same instant.	ちょうどそのときあることが起こらなければ、マーチは髭のことすら気付かなかっただろう。
As the man came under the low bridge he made a leap at it and hung,	男は低い橋の下まで来ると飛び上がり、橋にぶら下がった。
with his legs dangling,	足がぶらぶらと揺れている。
letting the boat float away from under him.	ボートはその下を流れていく。
March had a momentary vision of two black kicking legs;	蹴り出された二本の足の影が一瞬見えた。
then of one black kicking leg;	それから足は一本になった。
and then of nothing except the eddying stream and the long perspective of the wall.	ついに足は一本もなくなり、渦巻く流れとどこまでも続く壁だけが残った。
But whenever he thought of it again, long afterward, when he understood the story in which it figured, it was always fixed in that one fantastic shape	その後、これが物語を象徴していたのだとわかってからは、思い出すたび決まって一つの空想にとらわれる
--as if those wild legs were a grotesque graven ornament of the bridge itself, in the manner of a gargoyle.	――暴れていた足は、ガーゴイルのような橋の彫刻飾りだったのではないだろうか。
At the moment he merely passed, staring, down the stream.	その時はただじっと見つめて通り過ぎ、川を下った。
He could see no flying figure on the bridge,	橋の上には人影は見られなかった。
so it must have already fled;	すでに立ち去ったに違いない。
but he was half conscious of some faint significance in the fact	だがマーチは、重要な事実に半ば気付いていたのだ。
that among the trees round the bridgehead opposite the wall he saw a lamp-post;	塀と反対側の橋頭堡の辺りには、木立の中に街灯があった。
and, beside the lamp-post, the broad blue back of an unconscious policeman.	街灯のそばには、気絶した警官の青く広い背中があった。
Even before reaching the shrine of his political pilgrimage he had many other things to think of besides the odd incident of the bridge;	政治家巡りの目的地にたどり着くまでのあいだ、マーチには橋で起こった不思議な出来事以外にも考えることがたくさんあった。
for the management of a boat by a solitary man was not always easy even on such a solitary stream.	一人きりでボートを漕ぐことは、たとえがらがらの川であっても、そうたやすいことではない。
And indeed it was only by an unforeseen accident that he was solitary.	マーチがひとりだったのも、ほんの偶然の出来事のせいなのだ。
The boat had been purchased and the whole expedition planned in conjunction with a friend,	ボートを購入し、友人とともに遠出の計画も練った。
who had at the last moment been forced to alter all his arrangements.	その友人が、最後になって計画を変更させたのだ。
Harold March was to have traveled with his friend Horne Fisher on that inland voyage to Willowood Place,	ハロルド・マーチは友人のホーン・フィッシャーと、ウィローウッド邸までちょっとした旅をするつもりだった。
where the Prime Minister was a guest at the moment.	折りしもそこには総理大臣が招かれていた。
More and more people were hearing of Harold March,	多くの人がハロルド・マーチのことを知っていた。
for his striking political articles were opening to him the doors of larger and larger salons;	マーチの記事は評判がよく、さらなる名士がマーチを招いてくれた。
but he had never met the Prime Minister yet.	だが首相にはまだ会ったことがない。
Scarcely anybody among the general public had ever heard of Horne Fisher;	一般人はホーン・フィッシャーのことなど聞いたことがないだろう。
but he had known the Prime Minister all his life.	だがフィッシャーは首相と長いつきあいだった。
For these reasons, had the two taken the projected journey together,	そんなわけで、ふたりはともに旅する計画を進めた。
March might have been slightly disposed to hasten it and Fisher vaguely content to lengthen it out.	マーチは計画を早めたがったようだが、フィッシャーはどこかぐずぐずとしていた。
For Fisher was one of those people who are born knowing the Prime Minister.	フィッシャーは生まれたときから首相を知っていたが、
The knowledge seemed to have no very exhilarant effect,	それはあまり気を引き立たせる効果はないらしい。
and in his case bore some resemblance to being born tired.	それにフィッシャーときたら、生まれながらにくたびれているみたいだ。
But he was distinctly annoyed to receive, just as he was doing a little light packing of fishing tackle and cigars for the journey, a telegram from Willowood	だが、旅の準備で釣り道具やたばこを詰めていたときのことだ。
asking him to come down at once by train, as the Prime Minister had to leave that night.	首相はその日の晩に発つからすぐに電車でやって来るようにという内容だった。
Fisher knew that his friend the journalist could not possibly start till the next day, and he liked his friend the journalist,	フィッシャーは、友人の記者が次の日まで出発できないとわかっていたし、友人のことが好きだったのだ。
and had looked forward to a few days on the river.	それに、川で何日間か過ごすのを楽しみにしていた。
He did not particularly like or dislike the Prime Minister, but he intensely disliked the alternative of a few hours in the train.	首相のことはとりわけ好きでも嫌いでもなかったが、電車で数時間を過ごすことになって、大嫌いになった。
Nevertheless, he accepted Prime Ministers as he accepted railway trains	だがそれにもかかわらず、フィッシャーは首相も列車の旅も受け入れた
--as part of a system	――体制の一員として。
which he, at least, was not the revolutionist sent on earth to destroy.	少なくとも、体制を破壊しようとする革命家ではなかったから。
So he telephoned to March,	そうしたわけでマーチに電話して頼み込んだ。
asking him, with many apologetic curses and faint damns, to take the boat down the river as arranged, that they might meet at Willowood by the time settled;	吐き出される謝罪の言葉や怒りの言葉の結果、マーチは計画通りボートで川を下り、打ち合わせた時間にウィローウッドで落ち合おうということになった。
then he went outside and hailed a taxicab to take him to the railway station.	それから外に出ると、タクシーを拾い駅まで乗っていった。
There he paused at the bookstall to add to his light luggage a number of cheap murder stories,	駅の本屋に立ち寄ると、廉価なミステリ本を何冊か手軽な荷物に加えた。
which he read with great pleasure, and without any premonition that he was about to walk into as strange a story in real life.	大いに楽しんだが、いましもそんな異常な物語に向かって実際に進んでいる最中だとは思いも寄らなかった。
A little before sunset he arrived,	日没の少し前。
with his light suitcase in hand, before the gate of the long riverside gardens of Willowood Place,	軽いスーツケースを持って、川べりにあるウィローウッド邸の庭の前にたどり着いた。
one of the smaller seats of Sir Isaac Hook, the master of much shipping and many newspapers.	ここは海運業と新聞社の社長、アイザック・フック卿の下屋敷のひとつだ。
He entered by the gate giving on the road, at the opposite side to the river,	フィッシャーは、川向こうの、道路に面した門から中に入った。
but there was a mixed quality in all that watery landscape which perpetually reminded a traveler that the river was near.	種々雑多な水辺の風景が、川が近いということを旅人に自ずと思い出させる。
White gleams of water would shine suddenly like swords or spears in the green thickets.	川原の草の中で突然、水が剣やとげのように白くきらめいた。
And even in the garden itself, divided into courts and curtained with hedges and high garden trees, there hung everywhere in the air the music of water.	中庭が造られたり生け垣や立木で区切られた庭にさえ、水の調べが空中のいたるところに漂っていた。
The first of the green courts which he entered appeared to be a somewhat neglected croquet lawn,	青々とした中庭に入るとまず、あまり手入れのされていないクロケー場があった。
in which was a solitary young man playing croquet against himself.	そこで若い男がひとりクロケーをやっている。
|et he was not an enthusiast for the game, or even for the garden;	だがゲームには無頓着で、庭にはいっそう無頓着だった。
and his sallow but well-featured face looked rather sullen than otherwise.	血色の悪いなかなか個性的な顔は、どちらかといえば不機嫌だ。
He was only one of those young men who cannot support the burden of consciousness unless they are doing something,	何かやらずには心の負担を支えきれないといった若者に過ぎない。
and whose conceptions of doing something are limited to a game of some kind.	そしてその「何か」とは、何かのゲームに限られていた。
He was dark and wel.l	無口で元気だった。
dressed in a light holiday fashion,	カジュアルな服を着ている。
and Fisher recognized him at once as a young man named James Bullen,	その若者がジェームズ・ブレンだとすぐにわかった。
called, for some unknown reason, Bunker.	なぜだかわからぬがバンカーと呼ばれている。
He was the nephew of Sir Isaac;	アイザック卿の甥だ。
but, what was much more important at the moment, he was also the private secretary of the Prime Minister.	だがさらに重要なことには、総理の秘書でもあったのだ。
"Hullo, Bunker!"	「やあ、バンカー！」
observed Horne Fisher.	ホーン・フィッシャーが声をかけた。
"You're the sort of man I wanted to see.	「会いたいと思ってました。
Has your chief come down yet?"	総理はもう来てますか？」
"He's only staying for dinner,"	「晩餐まではいますよ」
replied Bullen, with his eye on the yellow ball.	黄色いボールを見つめながらブレンは答えた。
"He's got a great speech to-morrow at Birmingham and he's going straight through to-night.	「明日バーミンガムで演説をするので、今夜直行します。
He's motoring himself there;	自動車で。
driving the car, I mean.	自分で運転してくってことですけど。
It's the one thing he's really proud of."	総理の自慢はそれくらいですからね」
"You mean you're staying here with your uncle, like a good boy?"	「君はおじさんとここに残るってことかな？」
replied Fisher.	フィッシャーは尋ねた。
"But what will the Chief do at Birmingham without the epigrams whispered to him by his brilliant secretary?"	「だけど警句をささやく優秀な秘書もいないのに、総理は何をするつもりなんです？」
"Don't you start ragging me,"	「からかわないでくださいよ」
said the young man called Bunker.	バンカーと呼ばれた若者が言った。
"I'm only too glad not to go trailing after him.	「残念だけど、喜んで後について行っているわけじゃないんだから。
He doesn't know a thing about maps or money or hotels or anything,	総理は地図もお金もホテルも何もかもわからないんです。
and I have to dance about like a courier.	ぼくはガイドみたいに飛び回らざるを得ない。
As for my uncle, as I'm supposed to come into the estate, it's only decent to be here sometimes."	おじさんのことなら、邸に来ようと思うのは、ときどきここに来るのが礼儀だってだけですよ」
"Very proper," replied the other.	「なるほどね。
"Well, I shall see you later on,"	では、またあとで」
and, crossing the lawn, he passed out through a gap in the hedge.	そう言ってフィッシャーは芝生を横切ると、生け垣の途切れ目から立ち去った。
He was walking across the lawn toward the landing stage on the river, and still felt all around him, under the dome of golden evening, an Old World savor and reverberation in that riverhaunted garden.	夜の天蓋は黄金色だった。
The next square of turf which he crossed seemed at first sight quite deserted,	次に歩いていった一画は、一見したところ誰ひとりいない。
till he saw in the twilight of trees in one corner of it a hammock and in the hammock a man,	だが夕闇の中、片隅の木々にハンモックが吊され、男が寝そべっているが見えた。
reading a newspaper and swinging one leg over the edge of the net.	新聞を読み、ネットの端から片足を揺らしている。
Him also he hailed by name, and the man slipped to the ground and strolled forward.	彼にもまた名指しで呼びかけると、男は地面に滑り降り、こちらに歩いてきた。
It seemed fated that he should feel something of the past in the accidents of that place,	そこで起こったことを、遠い昔のことだと感じても不思議はない。
for the figure might well have been an early-Victorian ghost	というのも、その人影は初期ヴィクトリア朝の幽霊みたいだった。
revisiting the ghosts of the croquet hoops and mallets.	今はないクロケーのリングと木づちを求めて舞い戻ってきたのだ。
It was the figure of an elderly man with long whiskers that looked almost fantastic,	ほとんどおとぎ話みたいな長い頬髯を生やした年配の男だった。
and a quaint and careful cut of collar and cravat.	ネクタイとカラーは古風できめ細かい。
Having been a fashionable dandy forty years ago,	四十年前ならおしゃれな男だったはずだ。
he had managed to preserve the dandyism while ignoring the fashions.	流行を無視してずっとおしゃれを貫いていたのか。
A white top-hat lay beside the Morning Post in the hammock behind him.	傍らのハンモックには、『モーニング・ポスト』紙と白いシルクハットがある。
This was the Duke of Westmoreland,	これがウェストモーランド公爵だった。
the relic of a family really some centuries old;	何世紀にもわたる名家で、
and the antiquity was not heraldry but history.	古いのは紋章ではなく、家系そのものだった。
Nobody knew better than Fisher how rare such noblemen are in fact, and how numerous in fiction.	本当の貴族というものがどれだけ貴重で、贋物がいかに多いか。
But whether the duke owed the general respect he enjoyed to the genuineness of his pedigree or to the fact that he owned a vast amount of very valuable property was a point	だが尊敬されていようがいまいが公爵は、家系が真実であることを満喫していたし、莫大で貴重な財産を所有しているという事実も満喫していた。
about which Mr. Fisher's opinion might have been more interesting to discover.	この点についてのフィッシャー氏の見解は興味深い。
"You were looking so comfortable,"	「気持ちよさそうでしたね」
said Fisher,	フィッシャーが言った。
"that I thought you must be one of the servants.	「誰かひとり使用人がいるでしょう。
I'm looking for somebody to take this bag of mine;	鞄を持ってくれる人を探していたところなんです。
I haven't brought a man down, as I came away in a hurry."	急いで来たので、誰もつかまらなくて」
"Nor have I, for that matter,"	「それを言うなら、ぼくもそうさ」
replied the duke, with some pride.	誇りを持って公爵が答えた。
"I never do.	「使用人なんて一度も使ったことがない。
If there's one animal alive I loathe it's a valet.	ぼくが憎んでいる生き物がいるとしたら、それは使用人だな。
I learned to dress myself at an early age and was supposed to do it decently.	ぼくは幼い頃にひとりで服を着ることができた、きちんとね。
I may be in my second childhood, but I've not go so far as being dressed like a child."	そりゃあもうろくして子供みたいになっちゃってからは、子供みたいに着こなすとまでいかないが」
"The Prime Minister hasn't brought a valet;	「総理は使用人ではなく、
he's brought a secretary instead," observed Fisher.	代りに秘書を連れて行く。
"Devilish inferior job.	たいしたものだ。
Didn't I hear that Harker was down here?"	ハーカーがここに来たとは聞いていませんか？」
"He's over there on the landing stage,"	「あの桟橋だよ」
replied the duke, indifferently, and resumed the study of the Morning Post.	公爵は素っ気なく言うと、『モーニング・ポスト』の耽読に戻った。
Fisher made his way beyond the last green wall of the garden on to a sort of towing path	フィッシャーは緑の垣根の向こうに進んだ。
looking on the river and a wooden island opposite.	川の向こうには緑の中島がある。
There, indeed, he saw a lean, dark figure	痩せた人影が見えた。
with a stoop almost like that of a vulture,	禿鷲みたいに体を丸めている。
a posture well known in the law courts as that of Sir John Harker, the Attorney-General.	法廷ではお馴染みの法務長官ジョン・ハーカー卿の姿だ。
His face was lined with headwork,	顔にはしわが刻まれている。
for alone among the three idlers in the garden he was a man who had made his own way;	庭でぶらぶらしている三人の中でただ独り苦労人なのだ。
and round his bald brow and hollow temples clung dull red hair, quite flat, like plates of copper.	薄い眉やはげたこめかみの辺りには、銅板みたいに薄っぺらなつやのない赤毛が貼りついている。
"I haven't seen my host yet,"	「まだ主人を見てないんですよ」
said Horne Fisher, in a slightly more serious tone than he had used to the others,	他の人によりも少し堅苦しくフィッシャーは言った。
"but I suppose I shall meet him at dinner."	「晩餐で会えるとは思うんですけどね」
"You can see him now;	「今すぐ見られるよ。
but you can't meet him,"	だが会えないな」
answered Harker.	ハーカーが答えた。
He nodded his head toward one end of the island opposite, and, looking steadily in the same direction,	向かいの中島に頭を振ると、じっと目をとめた。
the other guest could see the dome of a bald head and the top of a fishing rod,	禿頭のてっぺんや釣り竿の先が見えた。
both equally motionless, rising out of the tall undergrowth against the background of the stream beyond.	流れの中にある背の高い藪ごしに見えている。
The fisherman seemed to be seated against the stump of a tree and facing toward the other bank,	釣り人は切り株に腰掛け、向こう岸を向いているようだ。
so that his face could not be seen, but the shape of his head was unmistakable.	だから顔は見えなかったが、頭の形ははっきりとわかった。
"He doesn't like to be disturbed when he's fishing,"	「釣りの最中は邪魔しない方がいい」
continued Harker.	ハーカーが続けた。
"It's a sort of fad of his to eat nothing but fish,	「釣って食べるのに凝ってるのさ。
and he's very proud of catching his own.	自分で獲るのがご自慢でね。
Of course he's all for simplicity,	もちろんまったく簡単なんだ。
like so many of these millionaires.	百万長者にとってはね。
He likes to come in saying he's worked for his daily bread like a laborer."	労働者みたく日々の糧のために働いてると言われたいのさ」
"Does he explain	「あの人が言ったんですか？
how he blows all the glass and stuffs all the upholstery," asked Fisher,	どうやってガラスを吹いたり、家具を詰めたり、
"and makes all the silver forks, and grows all the grapes and peaches, and designs all the patterns on the carpets?	銀のフォークを作ったり、葡萄や桃を育てたり、絨毯の模様をデザインしたりするのかを？
I've always heard he was a busy man."	いつも忙しいと聞いてますよ」
"I don't think he mentioned it,"	「言ったとは思わないな」
answered the lawyer.	法律家は答えた。
"What is the meaning of this social satire?"	「そんな社会風刺になんの意味がある？」
"Well, I am a trifle tired," said Fisher,	「ああ、私は少し疲れてるんです。
"of the Simple Life and the Strenuous Life as lived by our little set.	こぢんまりとした単純な生活や、精力的な生活にね。
We're all really dependent in nearly everything,	我々はあらゆるものに頼っています。
and we all make a fuss about being independent in something.	何かから独立するとなると大騒ぎです。
The Prime Minister prides himself on doing without a chauffeur, but he can't do without a factotum and Jack-of-all-trades;	総理は運転手がいないのが自慢のようですが、雑用係がいなければ何もできない。
and poor old Bunker has to play the part of a universal genius,	あのバンカーは万能の才能の持ち主を演じなければならない。
which God knows he was never meant for.	そんな人物ではないことを神様は知っています。
The duke prides himself on doing without a valet,	公爵は使用人がいないことを自慢していました。
but, for all that, he must give a lot of people an infernal lot of trouble to collect such extraordinary old clothes as he wears.	けれどやはり、公爵が身につけるような変わった洋服を集めるには、たくさんの人がひどく苦労することになる。
He must have them looked up in the British Museum or excavated out of the tombs.	大英博物館を探したり、墓を掘り返したり。
That white hat alone must require a sort of expedition fitted out to find it,	白い帽子だけは遠征に繰り出して探さなければ。
like the North Pole.	まるで北極探検です。
And here we have old Hook pretending to produce his own fish	そしてフックは、魚を作り出してるつもりになってる。
when he couldn't produce his own fish knives or fish forks to eat it with.	それを食べるためのフィッシュナイフもフィッシュフォークも作れないのにね。
He may be simple about simple things like food, but you bet he's luxurious about luxurious things, especially little things.	たとえ食べ物みたいにあっさりしたものには簡素だとしても、贅沢なもの、特に貴重品には間違いなくどっぷりつかっている。
I don't include you;	あなたがそうだとは思いませんよ。
you've worked too hard to enjoy playing at work."	仕事を楽しめないほど一生懸命ですからね」
"I sometimes think,"	「ときどき思うよ」
said Harker,	ハーカーが言った。
"that you conceal a horrid secret of being useful sometimes.	「きみはときどき、おそろしい秘密を隠しているんじゃないかって。
Haven't you come down here to see Number One before he goes on to Birmingham?"	ここに来たのはボスがバーミンガムに行く前に会うためだろう？」
Horne Fisher answered, in a lower voice:	ホーン・フィッシャーは低い声で答えた。
"Yes;	「ええ。
and I hope to be lucky enough to catch him before dinner.	晩餐前にうまく捕まえたいんですけどね。
He's got to see Sir Isaac about something just afterward."	アイザック卿と相談しに行く前に」
"Hullo!"	「おや！」
exclaimed Harker.	ハーカーが声を挙げた。
"Sir Isaac's finished his fishing.	「アイザック卿の釣りが終わったぞ。
I know he prides himself on getting up at sunrise and going in at sunset."	日の出に起きて日没に家に入る、それがご自慢なんだ」
The old man on the island had indeed risen to his feet, facing round and showing a bush of gray beard	中島にいた老人は確かに立ち上がってこちらを向き、灰色の顎髭を見せていた。
with rather small, sunken features, but fierce eyebrows and keen, choleric eyes.	髭は小さく低かったが、眉は激しく目は厳しく気短かそうだった。
Carefully carrying his fishing tackle, he was already making his way back to the mainland	慎重に釣り道具を持ちながら、岸に戻ろうとしていた。
across a bridge of flat stepping-stones a little way down the shallow stream;	浅瀬に平らな飛び石があるのだ。
then he veered round, coming toward his guests and civilly saluting them.	それから招待客の方にやって来て挨拶しようとくるりと向きを変えた。
There were several fish in his basket and he was in a good tempe.r	籠には何匹か魚が入っており機嫌がよかった。
"Yes,"	「そうなんだよ」
he said, acknowledging Fisher's polite expression of surprise,	驚いたようなフィッシャーの恭しい表情を認めて口を開いた。
"I get up before anybody else in the house, I think.	「家中の誰よりも早く起きるんだ。
The early bird catches the worm."	早起きは三文の得だからな」
"Unfortunately,"	「あいにく」
said Harker,	ハーカーが言った。
"it is the early fish that catches the worm."	「得をするのは魚かな」
"But the early man catches the fish,"	「だがその魚を捕まえるのは早起きをした人間だ」
replied the old man, gruffly.	老人はぶっきらぼうに答えた。
"But from what I hear, Sir Isaac, you are the late man, too,"	「けれどアイザック卿、聞くところによれば、あなたは夜更かしでもあるとか」
interposed Fisher.	フィッシャーが口を挟んだ。
"You must do with very little sleep."	「ほんの少し眠るだけでいいんでしょう」
"I never had much time for sleeping,"	「眠る時間がなかったんだ」
answered Hook,	フックが答えた。
"and I shall have to be the late man to-night, anyhow.	「ともかく、今夜も徹夜だろうな。
The Prime Minister wants to have a talk,	総理が話したがるんだよ。
he tells me, and, all things considered, I think we'd better be dressing for dinner."	だがもうそろそろ晩餐のために着替えた方がいいんじゃないだろうかな」
Dinner passed off that evening without a word of politics and little enough but ceremonial trifles.	晩餐はやや格式張ってはいたものの、堅苦しい挨拶抜きで行われた。
The Prime Minister, Lord Merivale, who was a long, slim man	首相のメリヴェール卿はひょろ長くて痩せた男だった。
with curly gray hair,	灰色の癖っ毛だ。
was gravely complimentary to his host about his success as a fisherman and the skill and patience he displayed;	邸の主人に向かって、技術も忍耐もたいしたものだと釣りの成果を重々しくねぎらっていた。
the conversation flowed like the shallow stream through the stepping-stones.	会話は、飛び石を流れる浅瀬みたいに流れていった。
"It wants patience to wait for them, no doubt,"	「もちろん、我慢して待たなきゃいかん」
said Sir Isaac,	アイザック卿が言った。
"and skill to play them,	「テクニックもいる。
but I'm generally pretty lucky at it."	だがたいていは幸運だったんですとも」
"Does a big fish ever break the line and get away?"	「今までに糸が切れて大きな魚に逃げられたことは？」
inquired the politician, with respectful interest.	興味を持って恭しく政治家が尋ねた。
"Not the sort of line I use,"	「そんな糸は使っておりませんよ」
answered Hook, with satisfaction.	満足そうにフックが答えた。
"I rather specialize in tackle, as a matter of fact.	「はっきり申しますと、リール用の特殊なものなわけです。
If he were strong enough to do that, he'd be strong enough to pull me into the river."	そんな糸を切るほどの強い魚なら、川に引き込まれてしまうでしょうな」
"A great loss to the community,"	「社会にとって大きな損失だ」
said the Prime Minister, bowing.	頭を下げて首相が言った。
Fisher had listened to all these futilities with inward impatience,	フィッシャーは、こうした無駄話を内心イライラしながら聞いていた。
waiting for his own opportunity, and when the host rose he sprang to his feet with an alertness he rarely showed.	主人が席を立ちチャンスが訪れたとき、滅多にないほど慎重に立ち上がった。
He managed to catch Lord Merivale before Sir Isaac bore him off for the final interview.	アイザック卿がふたたび話しかける前に、メリヴェール卿を捕まえようとした。
He had only a few words to say, but he wanted to get them said.	ほんの二言三言でいいのだが、その数語を言わせたかった。
He said, in a low voice as he opened the door for the Premier,	首相にドアを開けてやるとき低い声でこういった。
"I have seen Montmirail;	「モンミレイユに会いました。
he says that unless we protest immediately on behalf of Denmark, Sweden will certainly seize the ports."	デンマークのために直ちに戦わない限り、確実にスウェーデンが港を押さえるだろうと言っています」
Lord Merivale nodded.	メリヴェール卿は頷いた。
"I'm just going to hear what Hook has to say about it," he said.	「フックが何と言うか聞いてみるところだ」
"I imagine,"	「おそらく」
said Fisher, with a faint smile,	かすかに微笑んでフィッシャーは言った。
"that there is very little doubt what he will say about it."	「何か言うとは思えません」
Merivale did not answer, but lounged gracefully toward the library,	メリヴェール卿は答えずに、図書室の方へ優雅に歩いていった。
whither his host had already preceded him.	主人はすでに先を歩いていた。
The rest drifted toward the billiard room,	残った人々はビリヤード場に向かった。
Fisher merely remarking to the lawyer:	フィッシャーは法律家に向かって、ただこう言った。
"They won't be long.	「長くはかからないでしょう。
We know they're practically in agreement."	事実上同意しているのだから」
"Hook entirely supports the Prime Minister,"	「フックは首相を支持してるからな」
assented Harker.	ハーカーも同意した。
"Or the Prime Minister entirely supports Hook,"	「じゃなきゃ首相がフックを支持してます」
said Horne Fisher, and began idly to knock the balls about on the billiard table.	ホーン・フィッシャーはそう言うと、ビリヤード台の上のボールを気だるげに打ち始めた。
Horne Fisher came down next morning in a late and leisurely fashion,	次の日の朝遅く、ホーン・フィッシャーはのんびりとやって来た。
as was his reprehensible habit;	それがよくないところだ。
he had evidently no appetite for catching worms.	三文の得にはまったく興味がないのだ。
But the other guests seemed to have felt a similar indifference,	だがほかの客たちも同様に無関心らしかった。
and they helped themselves to breakfast from the sideboard at intervals during the hours verging upon lunch.	昼近い時間にちらほらとサイドボードから朝食を取っていた。
So that it was not many hours later when the first sensation of that strange day came upon them.	そんなわけで、どこか変な日だと感じ出したのは、間もなくのことだった。
It came in the form of a young man with light hair and a candid expression,	それは明るい髪をした率直な物言いの若者の形を取りやって来た。
who came sculling down the river and disembarked at the landing stage.	若者は川を漕いでやって来ると、桟橋で船を下りた。
It was, in fact, no other than Mr. Harold March,	紛う方なきハロルド・マーチにほかならない。
whose journey had begun far away up the river in the earliest hours of that day.	朝早くに、川のずっと向こうから旅を始めたのだ。
He arrived late in the afternoon, having stopped for tea in a large riverside town,	川沿いの大きな町に一服するため立ち寄ったので、午後遅くに到着したのだ。
and he had a pink evening paper sticking out of his pocket.	ポケットからは左翼系の夕刊紙が覗いている。
He fell on the riverside garden	マーチは川岸の庭に、落ちるようにしてやって来た。
like a quiet and well-behaved thunderbolt,	静かで行儀正しい雷とはこういうふうに落ちるのだろう。
but he was a thunderbolt without knowing it.	だがマーチはそんなことも知るよしもない。
The first exchange of salutations and introductions was commonplace enough,	まず取り交わされた挨拶は月並みなものだった。
and consisted, indeed, of the inevitable repetition of excuses for the eccentric seclusion of the host.	繰り返し主人の不在をわびるおきまりのものである。
He had gone fishing again, of course,	もちろん主人は釣りに行っているのだ。
and must not be disturbed till the appointed hour,	決められた時間までは邪魔してはいけない。
though he sat within a stone's throw of where they stood.	そうは言っても目と鼻の先に腰を下ろしていたのだが。
"You see it's his only hobby,"	「たったひとつの趣味だから」
observed Harker, apologetically,	申し訳なさそうにハーカーが言った。
"and, after all, it's his own house;	「つまるところ彼の家なんだし、
and he's very hospitable in other ways."	何にしろよくもてなしてくれるからな」
"I'm rather afraid,"	「少し気にかかりますけどね」
said Fisher, in a lower voice,	フィッシャーが低い声で言った。
"that it's becoming more of a mania than a hobby.	「趣味というよりマニアになるんじゃないかって。
I know how it is when a man of that age begins to collect things,	あの年頃の男がコレクターになるとどうなるか。
if it's only collecting those rotten little river fish.	臭い川魚ばかり集めますよ。
You remember Talbot's uncle with his toothpicks, and poor old Buzzy and the waste of cigar ashes.	トールボットのおじさんの爪楊枝や、バジーが煙草の灰に費やしたことを覚えているでしょう。
Hook has done a lot of big things in his time	フックはこれまで大きなことをたくさんしてきました
--the great deal in the Swedish timber trade and the Peace Conference at Chicago	――スウェーデンの木材貿易やシカゴ平和会議
--but I doubt whether he cares now for any of those big things as he cares for those little fish."	――だけど今のフックが、小さな魚に気を遣うほどに、大きなことに気を遣っているとは思えません」
"Oh, come, come,"	「おいおい」
protested the Attorney-General.	法務長官が異を唱えた。
"You'll make Mr. March think he has come to call on a lunatic.	「精神異常者を訪問しに来たんだとマーチ君に思わせるつもりかい。
Believe me, Hook only does it for fun,	いいかい、フックはただの気晴らしでやっているんだ。
like any other sport,	スポーツみたいに。
only he's of the kind that takes his fun sadly.	不幸にも気晴らしが奪われない限りはね。
But I bet if there were big news about timber or shipping, he would drop his fun and his fish all right."	だが賭けてもいいが、貿易や海運関係のニュースがあれば、フックは気晴らしも釣りもすっかり投げ捨てるね」
"Well, I wonder,"	「う〜ん、どうでしょうね」
said Horne Fisher, looking sleepily at the island in the river.	中島を見ながらホーン・フィッシャーは言った。
"By the way, is there any news of anything?"	「ところで、何かニュースはありますか？」
asked Harker of Harold March.	ハーカーはハロルド・マーチに尋ねた。
"I see you've got an evening paper;	「夕刊が見えたので。
one of those enterprising evening papers that come out in the morning."	朝のうちに出た新聞でしょう」
"The beginning of Lord Merivale's Birmingham speech,"	「バーミンガムで行ったメリヴェール卿の演説の冒頭が」
replied March, handing him the paper.	新聞を手渡してマーチは言った。
"It's only a paragraph,	「ちっちゃな記事です。
but it seems to me rather good."	でもかなりいいんじゃないかと思います」
Harker took the paper, flapped and refolded it, and looked at the "Stop Press" news.	ハーカーは新聞を受け取ると、ぱたぱたと折りたたみ『最新ニュース』の記事に目を通した。
It was, as March had said, only a paragraph.	マーチが言ったように小さな記事だった。
But it was a paragraph that had a peculiar effect on Sir John Harker.	だがその記事はジョン・ハーカー卿に不思議な効果をもたらした。
His lowering brows lifted with a flicker and his eyes blinked, and for a moment his leathery jaw was loosened.	ひそめた眉をぴくぴくと上げ、目を瞬かせると、堅く閉まった顎がしばしの間ゆるんだ。
He looked in some odd fashion like a very old man.	どこか変わった様子で、老人のようだ。
Then, hardening his voice and handing the paper to Fisher without a tremor, he simply said:	それからしっかりした様子でフィッシャーに新聞を手渡すと、しっかりした声でただこういった。
"Well, here's a chance for the bet.	「ほら、賭けのチャンスだぞ。
You've got your big news to disturb the old man's fishing."	釣りをやめさせる大きなニュースだ」
Horne Fisher was looking at the paper, and over his more languid and less expressive features a change also seemed to pass.	ホーン・フィッシャーが新聞を見ると、気だるく無表情な表情にも変化が訪れた。
Even that little paragraph had two or three large headlines, and his eye encountered,	小さな記事なのに二つも三つも見出しがあるのを目にした。
"Sensational Warning to Sweden," and, "We Shall Protest."	「スウェーデンに警告」とか「断固抗議」とかだ。
"What the devil--"	「これは――」
he said, and his words softened first to a whisper and then a whistle.	フィッシャーの声は、まずささやきに、次いで風の音へと和らいでいった。
"We must tell old Hook at once,	「すぐにフックに知らせよう。
or he'll never forgive us,"	それとも我々のことを絶対に許さないかな」
said Harker.	ハーカーが言った。
"He'll probably want to see Number One instantly,	「おそらくすぐにボスに会いたがるだろう。
though it may be too late now.	だが遅すぎる。
I'm going across to him at once.	今すぐフックのところに行きたいな。
I bet I'll make him forget his fish, anyhow."	魚のことを忘れる方に賭けるぞ」
And, turning his back, he made his way hurriedly along the riverside to the causeway of flat stones.	そうして背を向けると、川岸に沿って平たい飛び石に急いだ。
March was staring at Fisher, in amazement at the effect his pink paper had produced.	マーチは、新聞がもたらした結果に驚きながら、フィッシャーを見ていた。
"What does it all mean?"	「何なんです？」
he cried.	マーチは叫んだ。
"I always supposed we should protest in defense of the Danish ports,	「ぼくは常々、デンマークの港を守るために戦うべきだと思ってましたけどね。
for their sakes and our own.	デンマークのためにも、ぼくらのためにも。
What is all this botheration about Sir Isaac and the rest of you?	アイザック卿や、あなたの休暇を煩わすことなんですか？
Do you think it bad news?"	悪いニュースだとでも？」
"Bad news!"	「悪いニュース！」
repeated Fisher, with a sort of soft emphasis beyond expression.	柔らかく強調しながらフィッシャーは繰り返した。
"Is it as bad as all that?"	「そんなに悪いんですか？」
asked his friend, at last.	とうとう友人が尋ねた。
"As bad as all that?"	「そんなに悪いかですって？」
repeated Fisher.	とフィッシャーは繰り返す。
"Why of course it's as good as it can be.	「もちろん、あり得る限りいいものですよ。
It's great news.	大ニュースです。
It's glorious news!	素晴らしいニュースです！
That's where the devil of it comes in, to knock us all silly.	驚くべき参入。
It's admirable.	見事で、
It's inestimable.	計り知れない、
It is also quite incredible."	まったく途方もないことです」
He gazed again at the gray and green colors of the island and the river, and his rather dreary eye traveled slowly round to the hedges and the lawns.	ふたたびくすんだ緑の中島と川の方を見ると、物憂げな目つきで草むらをゆっくりと見回した。
"I felt this garden was a sort of dream," he said,	「この庭は夢みたいですね。
"and I suppose I must be dreaming.	いや、きっと夢を見ているんです。
But there is grass growing and water moving;	でも草は茂り水は流れている。
and something impossible has happened."	あり得ないことが起こりましたよ」
Even as he spoke the dark figure with a stoop like a vulture appeared in the gap of the hedge just above him.	ちょうど真上の藪の切れ目から現れた、禿鷲みたいに体を丸めた人影に話しかけた。
"You have won your bet,"	「君の勝ちだったな」
said Harker, in a harsh and almost croaking voice.	ハーカーがしわがれ声で言い捨てた。
"The old fool cares for nothing but fishing.	「ご老体は釣り以外気にならないんだ。
He cursed me and told me he would talk no politics."	政治の話はしないとさ」
"I thought it might be so,"	「そうかもしれないと思いました」
said Fisher, modestly.	フィッシャーは控えめに言った。
"What are you going to do next?"	「次に何をします？」
"I shall use the old idiot's telephone, anyhow,"	「電話を使わせてもらうよ、どっちみち」
replied the lawyer.	法律家は答えた。
"I must find out exactly what has happened.	「何が起こったのか見極めないと。
I've got to speak for the Government myself to-morrow."	明日政府と話をするよ」
And he hurried away toward the house.	そう言って家に急いだ。
In the silence that followed,	続く静寂のなかで
a very bewildeing silence so far as March was concerned,	――マーチにとってはわけのわからない静寂だった
they saw the quaint figure of the Duke of Westmoreland,	――ウェストモーランド公爵の姿が見えた。
with his white hat and whiskers, approaching them across the garden.	白い帽子とひげ面が庭の向こうから近づいてくる。
Fisher instantly stepped toward him with the pink paper in his hand, and, with a few words, pointed out the apocalyptic paragraph.	フィッシャーは新聞を手に、すぐに歩み寄ると、記事を指さし話しかけた。
The duke, who had been walking slowly, stood quite still,	ゆっくりと歩いていた公爵は、静かに立ち止まった。
and for some seconds he looked like a tailor's dummy standing and staring outside some antiquated shop.	古びた店から見つめているマネキンみたいだった。
Then March heard his voice, and it was high and almost hysterical:	それから、マーチのところにも高くヒステリックな声が聞こえた。
"But he must see it;	「フックに見せなきゃ。
he must be made to understand.	わかってるに決まってる。
It cannot have been put to him properly."	正確に伝わってないのかもしれない」
Then, with a certain recovery of fullness and even pomposity in the voice,	落ち着きを取り戻すと、尊大とも言える調子で言った。
"I shall go and tell him myself."	「ぼくが自分で伝えてくる」
Among the queer incidents of that afternoon, March always remembered something almost comical about the clear picture	昼下がりの珍事のことを思い出すと、マーチはいつも滑稽な気持ちになる。
of the old gentleman in his wonderful white hat carefully stepping from stone to stone across the river, like a figure crossing the traffic in Piccadilly.	華麗な白帽子の紳士が、ピカデリー大通りを渡るみたいに、石から石に飛び跳ねて川を渡っていたのだ。
Then he disappeared behind the trees of the island, and March and Fisher turned to meet the Attorney-General,	公爵の姿が中島の木々に紛れると、マーチとフィッシャーは法務長官に会いに戻った。
who was coming out of the house with a visage of grim assurance.	ハーカーは安心した顔つきで家の外に出ていた。
"Everybody is saying," he said,	「みんなが言うとおり、
"that the Prime Minister has made the greatest speech of his life.	総理は生涯一の演説をした。
Peroration and loud and prolonged cheers.	大喝采だ。
Corrupt financiers and heroic peasants.	腐敗した資本家と偉大な労働者。
We will not desert Denmark again."	もうデンマークを見捨てることはないだろう」
Fisher nodded and turned away toward the towing path, where he saw the duke returning with a rather dazed expression.	フィッシャーは頷くと曳舟道の方を振り返り、まごついた表情をして戻ってきた公爵を見た。
In answer to question, he said, in a husky and confidential voice:	公爵は気楽にしわがれ声で質問に答えた。
"I really think our poor friend cannot be himself.	「とんちきは夢中のまんまだ。
He refused to listen;	聞きたくないとさ。
he--ah--suggested that I might frighten the fish."	ええと――魚が驚くじゃないか、だとさ」
A keen ear might have detected a murmur from Mr. Fisher on the subject of a white hat,	公爵の話を聞いてフィッシャー氏が漏らしたつぶやきに、鋭い耳なら気づいていたかもしれない。
but Sir John Harker struck it more decisively:	だがジョン・ハーカー卿は断固として追い打ちをかけた。
"Fisher was quite right.	「フィッシャーは正しかった。
I didn't believe it myself, but it's quite clear that the old fellow is fixed on this fishing notion by now.	信じてなかったんだが、でもあいつが今現在釣りに夢中ってのははっきりしてる。
If the house caught fire behind him he would hardly move till sunset."	後ろで家が燃えてたって、日が沈むまで動かないかもな」
Fisher had continued his stroll toward the higher embanked ground of the towing path,	フィッシャーは高い土手に囲まれた曳舟道の方へ歩き続けた。
and he now swept a long and searching gaze, not toward the island, but toward the distant wooded heights that were the walls of the valley.	長いこと鋭い目つきで見回していたが、中島ではなく壁に挟まれた遠くの高台の方を見ていた。
An evening sky as clear as that of the previous day was settling down all over the dim landscape,	前日のように澄んだ夜空が暗がりの上に広がっている。
but toward the west it was now red rather than gold;	だが西の方は黄金色というより赤い色をしていた。
there was scarcely any sound but the monotonous music of the river.	川の流れる単調な音以外、何の音もしない。
Then came the sound of a half-stifled exclamation from Horne Fisher, and Harold March looked up at him in wonder.	だがホーン・フィッシャーが苦しげな叫びをあげたので、ハロルド・マーチは不思議そうにフィッシャーを見た。
"You spoke of bad news," said Fisher.	「悪いニュースですって。
"Well, there is really bad news now.	まさに今となっては悪いニュースです。
I am afraid this is a bad business."	悪いことじゃなければいいのですが」
"What bad news do you mean?"	「悪いニュースって何です？」
asked his friend,	友人が尋ねた。
conscious of something strange and sinister in his voice.	不愉快で不吉な響きに気づいたのだ。
"The sun has set,"	「日が沈みました」
answered Fisher.	フィッシャーが答えた。
He went on with the air of one conscious of having said something fatal.	何か決定的なことを言ったと自覚しているふうにフィッシャーは続けた。
"We must get somebody to go across whom he will really listen to.	「フックが耳を貸す人を行かせなければ。
He may be mad,	狂ってしまったのかも。
but there's method in his madness.	ですが狂気には論理があります。
There nearly always is method in madness.	たいていの場合、狂気にも論理があるのです。
It's what drives men mad, being methodical.	人を狂気に走らせるものには、きちんとしたわけがあります。
And he never goes on sitting there after sunset, with the whole place getting dark.	フックは日が沈んだあとも暗闇に座り続けていることはありませんでした。
Where's his nephew?	甥御さんはどこです？
I believe he's really fond of his nephew."	甥っ子のことは心から愛してるでしょう」
"Look!"	「ほら！」
cried March, abruptly.	突然マーチが叫んだ。
"Why, he's been across already.	「もう行ってきたんだ。
There he is coming back."	戻ってくるところです」
And, looking up the river once more, they saw, dark against the sunset reflections,	ふたたび川を見ると、暗闇に日暮れの太陽が反射していた。
the figure of James Bullen stepping hastily and rather clumsily from stone to stone.	急いでぎこちなく石を飛び越えるジェームズ・ブレンの姿があった。
Once he slipped on a stone with a slight splash.	飛沫で足を滑らせている。
When he rejoined the group on the bank his olive face was unnaturally pale.	岸の一行に合流したとき、ブレンの黄色い顔は不自然なほど青ざめていた。
"Nothing.	「何も。
He says--nothing."	何も――言わないんです」
Fisher looked at the young man steadily for a moment;	フィッシャーは若者をキッと見つめてから、
then he started from his immobility.	動き出した。
and, making a motion to March to follow him, himself strode down to the river crossing.	マーチについてくるように合図すると、大またで川を渡った。
In a few moments they were on the little beaten track that ran round the wooded island,	中島を歩き回ってできた道がある。
to the other side of it where the fisherman sat.	向こうに釣り人が座っていた。
Then they stood and looked at him, without a word.	みなは立ち止まり無言で釣り人を見た。
Sir Isaac Hook was still sitting propped up against the stump of the tree,	アイザック・フック卿は切り株に寄りかかって座ったままだった。
and that for the best of reasons.	それも当然だ。
A length of his own infallible fishing line was twisted and tightened twice round his throat and then twice round the wooden prop behind him.	自慢の釣り糸が卿の喉に二重にきつく巻き付き、後ろの切り株にも二重に巻き付いている。
The leading investigator ran forward and touched the fisherman's hand,	探偵は真っ先に駆け寄ると、釣り人の手に触れた。
and it was as cold as a fish.	魚みたいに冷たかった。
"The sun has set,"	「日が沈んだ」
said Horne Fisher, in the same terrible tones,	ホーン・フィッシャーは恐ろしそうに変わらぬ調子で言った。
"and he will never see it rise again."	「日の出を見ることは二度とないでしょう」
Ten minutes afterward the five men, shaken by such a shock, were again together in the garden,	十分後、五人の男はショックで震えながら庭に戻った。
looking at one another with white but watchful faces.	青ざめてはいたが油断ならない面持ちでお互いを見回した。
The lawyer seemed the most alert of the group;	法律家が一番警戒していた。
he was articulate if somewhat abrupt.	どこか無愛想だがきっぱりと言った。
"We must leave the body as it is and telephone for the police," he said.	「警察に電話するまで死体はあのままにしとかないと。
"I think my own authority will stretch to examining the servants and the poor fellow's papers,	職権を拡大して使用人と仏さんの書類を調べようかな。
to see if there is anything that concerns them.	関係あるかどうか確認しないと。
Of course, none of you gentlemen must leave this place."	もちろん、諸君はここから離れてはならないぞ」
Perhaps there was something in his rapid and rigorous legality that suggested the closing of a net or trap.	素早く厳しい法的手段には、ことによると網だか罠だかをせばめようという響きがあったのかもしれない。
Anyhow, young Bullen suddenly broke down, or perhaps blew up, for his voice was like an explosion in the silent garden.	とにかく、若いブレンは突然取り乱したのか怒り出したのか、静かな庭に声が響いた。
"I never touched him,"	「僕はあの人に触ってない」
he cried.	ブレンは叫んだ。
"I swear I had nothing to do with it!"	「誓って僕は関係ない！」
"Who said you had?"	「誰のことだ？」
demanded Harker, with a hard eye.	ハーカーが厳しい目つきで尋ねた。
"Why do you cry out before you're hurt?"	「どうして非難されてもいないのに叫んだんだ？」
"Because you all look at me like that",	「こんなふうに僕を見るからさ」
cried the young man, angrily.	怒って叫んだ。
"Do you think I don't know you're always talking about my damned debts and expectations?"	「いつもあなたがたが借金と遺産のことを話しているのを知らないと思ってるのか？」
Rather to March's surprise, Fisher had drawn away from this first collision, leading the duke with him to another part of the garden.	マーチは驚き、フィッシャーは当初の衝撃から立ち直って、庭の端に公爵を連れて行った。
When he was out of earshot of the others he said, with a curious simplicity of manner:	ほかの人には声が聞こえない距離になってから、不思議なくらいあっさりとこう言った。
"Westmoreland, I am going straight to the point."	「ウェストモーランド、単刀直入に言います」
"Well?"	「うん？」
said the other, staring at him stolidly.	ぼんやりと見つめて相手は言った。
"You have a motive for killing him," said Fisher.	「あなたには殺す動機があります」
The duke continued to stare, but he seemed unable to speak.	公爵は見つめ続けていたが、何も言えないようだった。
"I hope you had a motive for killing him,"	「あなたには動機があると思いますが」
continued Fisher, mildly.	フィッシャーは穏やかに続けた。
"You see, it's rather a curious situation.	「ちょっと奇妙な状況ですよね。
If you have a motive for murdering, you probably didn't murder.	動機があったら、おそらく殺さない。
But if you hadn't any motive, why, then perhaps, you did."	だけど動機がなかったとしたら、ええ、おそらく殺したんでしょう」
"What on earth are you talking about?"	「何のことだい？」
demanded the duke, violently.	乱暴に公爵が尋ねた。
"It's quite simple," said Fisher.	「簡単なことです。
"When you went across he was either alive or dead.	あなたが川を渡ったとき、フックは生きていたか死んでいたかどちらかです。
If he was alive, it might be you who killed him,	生きていたなら、殺したのはあなたです。
or why should you have held your tongue about his death?	でなけりゃどうして死んでいたのを黙っていたのか？
But if he was dead,	だけど、死んでいたとします。
and you had a reason for killing him,	あなたには動機がある。
you might have held your tongue for fear of being accused."	疑われることを恐れて黙っていたのです」
Then after  a silence he added, abstractedly:	口を閉じてから、ぼんやりと付け足した。
"Cyprus is a beautiful place, I believe.	「キプロスは美しいところです。
Romantic scenery and romantic people.	ロマンティックな景色にロマンティックな人々。
Very intoxicating for a young man."	若い男には刺激的です」
The duke suddenly clenched his hands and said, thickly,	公爵は突然手を握りしめごもごもと口を開いた。
"Well, I had a motive."	「ああ、ぼくには動機がある」
"Then you're all right,"	「大丈夫ですよ」
said Fisher, holding out his hand with an air of huge relief.	安心させるように手を握ってフィッシャーは言った。
"I was pretty sure you wouldn't really do it;	「あなたが殺してないことはわかっています。
you had a fright when you saw it done,	殺されているのを見て驚いていましたから。
as was only natural.	不自然ではなかった。
Like a bad dream come true, wasn't it?"	悪夢が現実のものになったみたいでしたね？」
While this curious conversation was passing, Harker had gone into the house, disregarding the demonstrations of the sulky nephew,	奇妙な会話が行われているあいだ、不機嫌な甥の反論を無視してハーカーは家に戻っていた。
and came back presently with a new air of animation and a sheaf of papers in his hand.	やがて元気も新たに戻ってきたが、手には書類の束を持っている。
"I've telephoned for the police,"	「警察に電話したよ」
he said, stopping to speak to Fisher,	立ち止まってフィッシャーに言った。
"but I think I've done most of their work for them.	「だけど警察の仕事をほとんどやってしまったんじゃないかな。
I believe I've found out the truth.	真相がわかったんだ。
There's a paper here--"	ここに書類がある――」
He stopped,	話をやめた。
for Fisher was looking at him with a singular expression;	フィッシャーが独特の顔つきでじっと見ていたからだ。
and it was Fisher who spoke next:	次に話したのはフィッシャーだった。
"Are there any papers that are not there, I wonder?	「そこにない書類がありませんか？
I mean that are not there now?"	今現在そこにないってことですが？」
After a pause he added:	少しして付け加えた。
"Let us have the cards on the table.	「テーブルに書類を広げてください。
When you went through his papers in such a hurry, Harker, weren't you looking for something to	こんなに急いで書類を探したのは、ハーカー、何かを探していたんでしょう？
--to make sure it shouldn't be found?"	――見つけられたくないものを確認しようと」
Harker did not turn a red hair on his hard head,	ハーカーの赤髪は振り向かなかった。
but he looked at the other out of the corners of his eyes.	目の片隅で別のものを見ている。
"And I suppose,"	「要するに」
went on Fisher, smoothly,	フィッシャーは流暢に続けた。
"that is why you, too, told us lies about having found Hook alive.	「そうしたわけで、生きているフックを見たという嘘もついた。
You knew there was something to show that you might have killed him,	殺したと疑われる証拠があるのを知っていたからです。
and you didn't dare tell us he was kille.	だから殺されていることを教えなかった。
But, believe me,	だけど信じてください。
it's much better to be honest now."	今は正直になるのが一番ですよ」
Harker's haggard face suddenly lit up as if with infernal flames.	ハーカーは突然、やつれた顔を地獄の炎のように真っ赤にして叫んだ。
"Honest," he cried,	「正直。
"it's not so damned fine of you fellows to be honest.	正直ってのがあんたらのくだらないところだ。
You're all born with silver spoons in your mouths,	あんたは金持ちの生まれだ。
and then you swagger about with everlasting virtue because you haven't got other people's spoons in your pockets.	他人の金を盗まないのがご自慢の美徳なんだろう。
But I was born in a Pimlico lodging house	だが私はピムリコの下宿で生まれた。
and I had to make my spoon,	金は自分で作るんだ。
and there'd be plenty to say I only spoiled a horn or an honest man.	酔っぱらいや正直者から騙し取ったと言えば十分だろう。
And if a struggling man staggers a bit over the line in his youth,	若い頃苦労した男が一線を越えてしまったとする。
in the lower parts of the law which are pretty dingy,	法律の暗部に抵触したんだ。
anyhow, there's always some old vampire to hang on to him all his life for it."	ともかく、そこには一生とらえて放さない吸血鬼がいた」
"Guatemalan Golcondas, wasn't it?"	「ガテマラの鉱山ですね？」
said Fisher, sympathetically.	同情して言った。
Harker suddenly shuddered.	ハーカーは突然身震いした。
Then he said, "I believe you must know everything, like God Almighty."	「君は何でも知ってるんだな、全能の神のようだ」
"I know too much," said Horne Fisher,	「知りすぎています。
"and all the wrong things."	悪いことに」
The other three men were drawing nearer to them, but before they came too near, Harker said, in a voice that had recovered all its firmness:	ほかの三人が近づいていったが、すぐそばまで寄る前に、断固とした調子を取り戻してハーカーが言った。
"Yes, I did destroy a paper,	「ああ、書類を破棄したとも。
but I really did find a paper, too;	だが本当に証拠の書類も見つけたんだ。
and I believe that it clears us all."	それで何もかもはっきりする」
"Very well,"	「結構です」
said Fisher, in a louder and more cheerful tone;	フィッシャーは大きく明るい声を出した。
"let us all have the benefit of it."	「その助けを貸してください」
"On the very top of Sir Isaac's papers,"	「アイザック卿の書類の一番上には」
explained Harker,	ハーカーが説明した。
"there was a threatening letter from a man named Hugo.	「ヒューゴーという男から来た脅迫状があったんだ。
It threatens to kill our unfortunate friend	不運な友人を殺すと脅していた。
very much in the way that he was actually killed.	実際に殺されたのと同じやり方でだ。
It is a wild letter,	荒っぽい手紙だよ。
full of taunts;	ののしりだらけだ。
you can see it for yourselves;	自分で見るといい。
but it makes a particular point of poor Hook's habit of fishing from the island.	だが大事なのは中島で釣りをするというフックの習慣のことだ。
Above all, the man professes to be writing from a boat.	しかも、その男はボートで書いたと公言している。
And, since we alone went across to him,"	我々がフックに会いに行ってから」
and he smiled in a rather ugly fashion,	不機嫌そうに笑みを作った
"the crime must have been committed by a man passing in a boat."	「ボートで来た男によって犯罪はなされたのだ」
"Why, dear me!"	「へえ、何だって！」
cried the duke, with something almost amounting to animation.	元気を取り戻した公爵が叫んだ。
"Why, I remember the man called Hugo quite well!	「ヒューゴーってやつならよく覚えてる！
He was a sort of body servant and bodyguard of Sir Isaac.	アイザック卿の使用人兼護衛だった。
You see, Sir Isaac was in some fear of assault.	アイザック卿は襲撃を恐れていたからね。
He was--he was not very popular with several people.	卿は――卿のことをよく思ってない人も何人かいた。
Hugo was discharged after some row or other;	ヒューゴーは喧嘩か何かで馘首になったんだ。
but I remember him well.	だけどよく覚えているよ。
He was a great big Hungarian fellow	大きなハンガリー人でね。
with great mustaches that stood out on each side of his face."	大きな口髭が顔の両側から飛び出していたよ」
A door opened in the darkness of Harold March's memory, or, rather, oblivion,	闇に沈んだハロルド・マーチの記憶の――というか、忘却の――扉が開いた。
and showed a shining landscape, like that of a lost dream.	夢で見る風景のように輝いていた。
It was rather a waterscape than a landscape,	水辺の風景だ。
a thing of flooded meadows and low trees and the dark archway of a bridge.	水浸しの草むら、低い木、橋のアーチの暗がり。
And for one instant he saw again the man with mustaches like dark horns	マーチは束の間、黒い角みたいな髭を生やした男を脳裏に描いた。
leap up on to the bridge and disappear.	橋にぶら下がり消えた男だ。
"Good heavens!"	「畜生！」
he cried.	叫びをあげた。
"Why, I met the murderer this morning!"	「今朝、殺人犯に会ったんだ！」
Horne Fisher and Harold March had their day on the river,	ホーン・フィッシャーとハロルド・マーチは川にいた。
after all, for the little group broke up when the police arrived.	結局、警察が到着すると、集まりはお開きになったのだ。
They declared that the coincidence of March's evidence had cleared the whole company, and clinched the case against the flying Hugo.	警察はマーチが偶然目撃した証拠により、全員を潔白と考え、逃亡中のヒューゴーを容疑者と断定した。
Whether that Hungarian fugitive would ever be caught appeared to Horne Fisher to be highly doubtful;	逃亡中のハンガリー人がつかまるかどうかについて、ホーン・フィッシャーはかなり疑わしそうだった。
nor can it be pretended that he displayed any very demoniac detective energy in the matter as he leaned back in the boat cushions, smoking, and watching the swaying reeds slide past.	恐るべき探偵の力を見せようともせずに、ボートに寄りかかってタバコをくゆらし、目の前で揺れる葦を見ていた。
"It was a very good notion to hop up on to the bridge,"	「橋に飛び移るのはたいへんな能力です」
he said.	フィッシャーが口を開いた。
"An empty boat means very little;	「空のボートはどうでもいい。
he hasn't been seen to land on either bank,	ヒューゴーは岸には上がらなかった。
and he's walked off the bridge without walking on to it, so to speak.	橋の上を歩かず、言ってみれば下を歩きました。
He's got twenty-four hours' start;	出発してから二十四時間です。
his mustaches will disappear, and then he will disappear.	口髭が消え、そして本人が消えました。
I think there is every hope of his escape."	逃げ切ってほしいですね」
"Hope?"	「逃げてほしい？」
repeated March, and stopped sculling for an instant.	一瞬漕ぐのをやめてマーチは繰り返した。
"Yes, hope,"	「ええ、逃げてほしいんです」
repeated the other.	フィッシャーも繰り返す。
"To begin with, I'm not going to be exactly consumed with Corsican revenge because somebody has killed Hook.	「そもそも、誰かがフックを殺したからと言って、復讐に駆られたりはしません。
Perhaps you may guess by this time what Hook was.	おそらくあなたは、フックが何をしていたのかずっと想像していたでしょう。
A damned blood-sucking blackmailer was	忌むべき吸血鬼、脅迫者。
that simple, strenuous, self-made captain of industry.	それがあのお人好しで、努力家で、たたき上げの実業家です。
He had secrets against nearly everybody;	誰もが秘密を握られていた。
one against poor old Westmoreland about an early marriage in Cyprus	ウェストモーランドは、キプロスで早婚していました。
that might have put the duchess in a queer position;	ことによると、奥さんの立場は奇妙なものになる。
and one against Harker about some flutter with his client's money when he was a young solicitor.	ハーカーは弁護士だった若い頃、依頼人のお金をいくらか賭けに使ってしまった。
That's why they went to pieces when they found him murdered, of course.	もちろんそれが、殺人が発見される前に、ばらばらにフックに会いに行った理由です。
They felt as if they'd done it in a dream.	自分が夢遊状態でやったように思えたでしょう。
But I admit	だが白状しましょう。
I have another reason for not wanting our Hungarian friend actually hanged for the murder."	我らがハンガリーくんを殺人で絞首刑にさせたくないのには、別の理由があるんです」
"And what is that?" asked his friend.	「何です？」
"Only that he didn't commit the murder," answered Fisher.	「殺人を犯してなどないからです」
Harold March laid down the oars and let the boat drift for a moment.	ハロルド・マーチは漕ぐ手を休めて、ボートを漂うがままに任せておいた。
"Do you know, I was half expecting something like that," he said.	「そんなだろうと思ってました。
"It was quite irrational, but it was hanging about in the atmosphere, like thunder in the air."	まったくわけがわかりませんが、そんな雰囲気が漂ってましたからね、大気中の雷みたいに」
"On the contrary, it's finding Hugo guilty that's irrational," replied Fisher.	「それどころか、ヒューゴーが有罪だなんてわけがわかりません。
"Don't you see that they're condemning him for the very reason	みんながある理由でヒューゴーを非難していました。
for which they acquit everybody else?	その理由がほかのみんなを無罪にするのもおわかりでしょう？
Harker and Westmoreland were silent because they found him murdered,	ハーカーとウェストモーランドは死体を発見したので黙っていました。
and knew there were papers that made them look like the murderers.	殺人者だとみなされる書類があることを知っていたから。
Well, so did Hugo find him murdered,	それから、ヒューゴーも死体を発見しました。
and so did Hugo know there was a paper that would make him look like the murderer.	ヒューゴーも自分が殺人者だとみなされる書類があるのを知っていた。
He had written it himself the day before."	前日自分で書いたんですから」
"But in that case,"	「だけどその場合」
said March, frowning,	マーチが眉をひそめた。
"at what sort of unearthly hour in the morning was the murder really committed?	「殺人が行われたのは、朝の何時頃なんです？
It was barely daylight when I met him at the bridge,	橋で見たときはまだ朝も早かった。
and that's some way above the island."	中島からかなり離れています」
"The answer is very simple," replied Fisher.	「答えは簡単です。
"The crime was not committed in the morning.	犯罪は朝に行われたのではない。
The crime was not committed on the island."	中島で行われたのではないのです」
March stared at the shining water without replying, but Fisher resumed like one who had been asked a question:	マーチは無言できらめく水面を見つめていたが、フィッシャーは質問されたかのように先を続けた。
"Every intelligent murder involves taking advantage of some one uncommon feature in a common situation.	「知的な殺人というものは総じて、奇異な特徴を利用してありきたりな状況を複雑にします。
The feature here was the fancy of old Hook for being the first man up every morning,	ここで言う特徴とは、フックが毎朝一番に出かけるのが好きだったこと。
his fixed routine as an angler,	釣りが日課だったことです。
and his annoyance at being disturbed.	それに邪魔されるのを嫌がった。
The murderer strangled him in his own house after dinner on the night before, carried his corpse, with all his fishing tackle,	殺人者は昨夜晩餐のあとでフックを絞め殺し、真夜中に釣り道具と一緒に死体を運びました。
across the stream in the dead of night, tied him to the tree, and left him there under the stars.	川の向こうに運ぶと、木に縛り付け、星空の下に残してきたのです。
It was a dead man who sat fishing there all day.	一日中釣りをしていたのは死者だったわけです。
Then the murderer went back to the house, or, rather, to the garage,	殺人者は家に戻ると、いえ、車庫に戻ると言った方がいいでしょう。
and went off in his motor car.	自動車で立ち去りました。
The murderer drove his own motor car."	自分の車を走らせて」
Fisher glanced at his friend's face and went on.	フィッシャーは友人の顔を一瞥して続けた。
"You look horrified,	「怖がってますね。
and the thing is horrible.	恐ろしいことです。
But other things are horrible, too.	だけどほかにも恐ろしいことはある。
If some obscure man had been hag-ridden by a blackmailer and had his family life ruined,	とある人が脅迫者に苦しめられ、家庭を崩壊させられたとします。
you wouldn't think the murder of his persecutor the most inexcusable of murders.	その脅迫者を殺すことが、あらゆる犯罪の中で最も許しがたい殺人だとは思わないでしょう。
Is it any worse when a whole great nation is set free as well as a family?	全国民が家族みたいにくつろぐのは悪いことですか？
By this warning to Sweden we shall probably prevent war and not precipitate it,	スウェーデンに警告したことにより、戦争を防ぎ抑制することができる。
and save many thousand lives rather more valuable than the life of that viper.	毒蛇の命よりも貴重な何千もの命を救うことができるんです。
Oh, I'm not talking sophistry or seriously justifying the thing,	違いますよ、詭弁でも大仰な弁解でもありません。
but the slavery that held him and his country was a thousand times less justifiable.	だけどね、フックを支えていた恐喝行為は、千に一つも弁解できない。
If I'd really been sharp I should have guessed it from his smooth, deadly smiling at dinner that night.	私が本当に鋭かったならば、晩餐の席で見せた上品で退屈そうな微笑みから推測できたでしょうに。
Do you remember that silly talk about how old Isaac could always play his fish?	アイザック卿がいかに魚に凝っているかって無駄話を覚えているでしょう？
In a pretty hellish sense	悪魔みたいなセンスです。
he was a fisher of men."	彼こそが人を釣り上げていたのですから」
Harold March took the oars and began to row again.	ハロルド・マーチはオールを取ってふたたび漕ぎ始めた。
"I remember," he said,	「忘れません。
"and about how a big fish might break the line and get away."	大きな魚がどのように糸を切って、逃げたかをね」
