Homesteading the Noosphere	ノウアスフィアの開墾
After observing a contradiction between the official ideology defined by open-source licenses and the actual behavior of hackers,	オープンソースのライセンスで定義された「公式」イデオロギーとハッカーたちの実際の行動には矛盾が観察される。
I examine the actual customs that regulate the ownership and control of open-source software.	これをふまえて、ぼくたちはオープンソースソフトの所有権とコントロールをめぐる実際の慣習を検討する。
I show that they imply an underlying theory of property rights homologous to the Lockean theory of land tenure.	そこで明らかになったのは、そうした慣習の根底にあるのが、ロックの土地保有に関する理論と類似した、所有権の理論であるということだ。
I then relate that to an analysis of the hacker culture as a `gift culture'	これと関連づけるかたちで、ハッカー文化を「贈与文化」として分析する。
in which participants compete for prestige by giving time, energy, and creativity away.	つまりそこの参加者たちは時間とエネルギーと創造性をあげてしまうことで、名声を競うわけだ。
Finally, I examine the consequences of this analysis for conflict resolution in the culture, and develop some prescriptive implications.	さらにこの分析が、ハッカー文化における紛争解決にとってどのような意味を持つかを検討し、いくつかの処方箋的な示唆を得るものとする。
An Introductory Contradiction	1　そもそもの矛盾
The Varieties of Hacker Ideology	2　ハッカーイデオロギーのさまざま
Promiscuous Theory, Puritan Practice	3　放縦な理論と純潔な実践
Ownership and Open Source	4　所有権とオープンソース
Locke and Land Title	5　ロックと土地所有権
The Hacker Milieu as Gift Culture	6　贈与経済としてのハッカー文化
The Joy of Hacking	7　ハッキングのよろこび
The Many Faces of Reputation	8　評判のさまざまな相貌
Ownership Rights and Reputation Incentives	9　所有権と評判によるインセンティブ
The Problem of Ego	10　エゴの問題
The Value of Humility	11　謙虚さの美徳
Global Implications of the Reputation-Game Model	12　評判ゲームモデルが持つ分野全体としての意義
How Fine a Gift?	13　どれほどすばらしい贈り物？
Noospheric Property and the Ethology of Territory	14　ノウアスフィア的所有権となわばりの動物行動学
Causes of Conflict	15　紛争の原因
Project Structures and Ownership	16　プロジェクト構造と所有権
Conflict and Conflict Resolution	17　紛争とその解決
Acculturation Mechanisms and the Link to Academia	18　文化への順応過程とアカデミズムとの関連
Conclusion: From Custom to Customary Law	19　結論：慣習から慣習法へ
Questions for Further Research	20　これからの研究の課題
Notes Bibliography	21　書誌、注
Acknowledgements	22　謝辞
An Introductory Contradiction	1　そもそもの矛盾
Anyone who watches the busy, tremendously productive world of Internet open-source software for a while is bound to notice an interesting contradiction between what open-source hackers say they believe and the way they actually behave;	インターネットのオープンソースソフトの、活発でものすごく生産的な世界をしばらくでもながめていれば、だれでもオープンソースハッカーが信念として語る内容と、かれらの実際の行動との間におもしろい矛盾があることに気がついてしまうだろう。
between the official ideology of the open-source culture and its actual practice.	つまり、オープンソース文化の公式イデオロギーと、その実際の活動は一致していないわけだ。
Cultures are adaptive machines.	文化は適応力のある機械だ。
The open-source culture is a response to an identifiable set of drives and pressures.	オープンソース文化は、はっきりした動きや圧力への反応として生まれてきている。
As usual, the culture's adaptation to its circumstances manifests both as conscious ideology and as implicit, unconscious or semi-conscious knowledge.	いつもながら、ある文化の状況への対応方法は、意識的なイデオロギーとしての部分と、無意識的またはあまりはっきり意識されない暗黙の知識としての部分との両方の形であらわれてくる。
And, as is not uncommon, the unconscious adaptations are partly at odds with the conscious ideology.	そしてよくあることだが、無意識的な適応は、意識されたイデオロギーと部分的に矛盾するところがある。
In this essay, I will dig around the roots of that contradiction, and use it to discover those drives and pressures.	この論文では、この矛盾の根っこのまわりを掘り下げてみて、それをもとにこの文化を動かす動きや圧力を明らかにする。
I will deduce some interesting things about the hacker culture and its customs.	そしてハッカー文化とその習慣について、おもしろい事実を導き出す。
I will conclude by suggesting ways in which the culture's implicit knowledge can be leveraged better.	そして結論として、この文化が内に持った知識をもっといいほうに活用するための方法をいくつか示唆してみる。
The Varieties of Hacker Ideology	2　ハッカーイデオロギーのさまざま
The ideology of the Internet open-source culture (what hackers say they believe) is a fairly complex topic in itself.	インターネットのオープンソース文化のイデオロギー（ハッカーが信念として口にするもの）は、それ自体がなかなかややこしい代物ではある。
All members agree that open source (that is, software that is freely redistributable and can readily evolved and be modified to fit changing needs) is a good thing and worthy of significant and collective effort.	メンバーはみんな、オープンソース（つまり自由に再配布ができて、ニーズの変化に対応して自由に発展・変更可能なソフト）がいいものであって、大がかりに力をあわせる価値のあるものだということには合意している。
This agreement effectively defines membership in the culture.	この合意がこの文化への参加を実質的に定義つけるものだ。
However, the reasons individuals and various subcultures give for this belief vary considerably.	でも、この信念の理由として各個人やさまざまな下位の小文化群が挙げるものは、かなりちがっている。
One degree of variation is zealotry;	大きな差がみられるのは熱狂性だ。
whether open source development is regarded merely as a convenient means to an end (good tools and fun toys and an interesting game to play) or as an end in itself.	オープンソースがある目的（よいツールやおもしろいおもちゃや楽しいゲーム）を実現するための、ただの便利な手法としてとらえられているか、それともそれ自体が目的として考えられているか。
A person of great zeal might say	すごく熱狂的な人間なら、こんなことをいうだろう。
``Free software is my life!	「フリーソフト命！
I exist to create useful, beautiful programs and information resources, and then give them away.''	ぼくが存在しているのは、便利で美しいソフトや情報リソースをつくってそれをあげてしまうためなんだ！」
A person of moderate zeal might say	そこそこの熱狂性をもった人間なら
``Open source is a good thing, which I am willing to spend significant time helping happen''.	「オープンソースはいいことだし、だからその実現のために相当量の時間を喜んで割きますよ」
A person of little zeal might say	そんなに熱狂的でない人間なら、こういうかもしれない。
``Yes, open source is okay sometimes.	「うん、オープンソースはいいときもあるわよね。
I play with it and respect people who build it''.	たまにいじってみたりもするし、それをつくった人たちには敬意を払ってるわ」
Another degree of variation is in hostility to commercial software and/or the companies perceived to dominate the commercial software market.	ほかに差があるところは、商用ソフトへの敵意と、商用ソフト市場を支配しているとみられる企業への敵意だ。
A very anticommercial person might say	すごく反商業主義的な人間はこういうだろう。
``Commercial software is theft and hoarding.	「商用ソフトは窃盗行為で秘匿行為だ。
I write free software to end this evil.''	ぼくがフリーソフトを書くのはこの悪行を止めさせるためだ」。
A moderately anticommercial person might say	そこそこ反商業主義的な人間はこういう。
``Commercial software in general is OK	「商業ソフトそのものはおおむねOKよ。
because programmers deserve to get paid,	だってプログラマには対価が支払われるべきだもん。
but companies that coast on shoddy products and throw their weight around are evil.''	でも、いい加減な製品にあぐらをかいて、数をたのみにごりおししてまわる企業はろくでもないわね」
An un-anticommercial person might say	そして反商業主義でない人間ならこういう。
``Commercial software is okay,	「商用ソフトだってよいではないの。
I just use and/or write open-source software because I like it better''.	ぼくがオープンソースソフトを書く／使うのは、そっちが好きだからってだけよ」
All nine of the attitudes implied by the cross-product of the categories mentioned earlier are represented in the open-source culture.	以上のカテゴリーをかけあわせて出てくる9つの態度すべてがオープンソース文化の中には登場している。
It is worthwhile to point out the distinctions because they imply different agendas, and different adaptive and cooperative behaviors.	こういうちがいを指摘しておくことが大事なのは、それが異なった目的を意味するからで、したがって適応行動や協調行動もちがってくるからだ。
Historically, the most visible and best-organized part of the hacker culture has been both very zealous and very anticommercial.	歴史的にいうと、もっとも目に見えて、いちばんよく組織化されていたハッカー文化の部分は、きわめて熱狂的で、非常に反商業的だった。
The Free Software Foundation founded by Richard M. Stallman (RMS) supported a great deal of open-source development from the early 1980s forward,	リチャード・M・ストールマン（Richard M. Stallman, RMS）の創設したフリーソフトウェア財団（Free Software Foundation, FSF）は 1980 年代初期以来、大量のオープンソース開発を支援してきた。
including tools like Emacs and GCC which are still basic to the Internet open-source world, and seem likely to remain so for the forseeable future.	そのなかには、Emacs や GCC のような、インターネット・オープンソース界にとって、いまでも、そしてこの先当分の間も、基本となるツールであり続けるようなものも含まれている。
For many years the FSF was the single most important focus of open-source hacking, producing a huge number of tools still critical to the culture.	何年ものあいだ、FSF はオープンソース・ハッキングに唯一最大の焦点だったし、いまだにこの文化にとってきわめて重要なツールを生み出し続けてきている。
The FSF was also long the only sponsor of open source with an institutional identity visible to outside observers of the hacker culture.	FSF はまた、ハッカー文化を外から見ている者にとっては、ながいことオープンソースを支援している組織的な身分をもった唯一のスポンサーだった。
They effectively defined the term `free software', deliberately giving it a confrontational weight	かれらこそ実質的に「フリーソフト」という用語を定義し、このことばに意図的に挑戦的な含みを持たせるようになった。
(which the newer label `open source' just as deliberately avoids).	（新しいラベルの「オープンソース」は同じくらい意図的にそういう含みをさけるようにしている。）
Thus, perceptions of the hacker culture from both within and without it tended to identify the culture with the FSF's zealous attitude and perceived anticommercial aims.	だからハッカー文化に対する認識は、内からも外からも、FSF の熱狂的な態度と反商業主義的な目標と同一視されがちだった
RMS himself denies he is anticommercial,	（RMS 自身は、自分が反商業主義であることを否定している。
but his program has been so read by most people, including many of his most vocal partisans.	でもかれの活動は、そのもっとも活発な支持者たちを含め、ほとんどの人からそのように受け取られている）。
The FSF's vigorous and explicit drive to ``Stamp Out Software Hoarding!'' became the closest thing to a hacker ideology, and RMS the closest thing to a leader of the hacker culture.	FSF の「ソフトウェアの隠匿をつぶせ！」という精力的ではっきりした運動は、ハッカー・イデオロギーにいちばん近いものとなったし、RMSはハッカー文化のリーダーにいちばん近い存在となった。
The FSF's license terms, the ``General Public License'' (GPL), expresses the FSF's attitudes.	FSF のライセンス条項「General Public License (GPL)」は FSF の熱狂的で反商業主義的な態度を表現している。
It is very widely used in the open-source world.	これはオープンソース界では広く使われているライセンス方式だ。
North Carolina's Metalab (formerly Sunsite) is the largest and most popular software archive in the Linux world.	ノースカロライナ大の Sunsiteは、Linux 界で最大かついちばん人気のあるソフトアーカイブだけれど、
In July 1997 about half the Sunsite software packages with explicit license terms used GPL.	1997年7月にはSunsiteのソフトパッケージではっきりしたライセンス条項を持つもののうち、半数がGPLを使っている。
But the FSF was never the only game in town.	でも、FSF はいつの時点でも決してこの世界唯一の団体なんかじゃなかった。
There was always a quieter, less confrontational and more market-friendly strain in the hacker culture.	ハッカー文化にはつねに、もっと静かで挑戦性の低い、もっと市場を敵視しない流れがあった。
The pragmatists were loyal not so much to an ideology as to a group of engineering traditions founded on early open-source efforts which predated the FSF.	このプラグマティストたちは、イデオロギーよりはむしろ、 FSF に先立つ初期のオープンソース的な動きに基づいた工学的な伝統に対して忠誠を感じていた。
These traditions included, most importantly, the intertwined technical cultures of Unix and the pre-commercial Internet.	この伝統でいちばん重要なものとしては、Unix と商業主義以前のインターネットの、相互にからみあった技術文化が含まれる。
The typical pragmatist attitude is only moderately anticommercial, and its major grievance against the corporate world is not `hoarding' per se.	典型的なプラグマティスト的態度は、ごく穏健な反商業主義で、それが企業世界に対して持っている不満の大部分は「秘匿」そのものじゃあない。
Rather it is that world's perverse refusal to adopt superior approaches incorporating Unix and open standards and open-source software.	むしろそれは、企業世界がUnixやオープン規格やオープンソースなんかが採用している優れたアプローチをなぜか拒むという点だ。
If the pragmatist hates anything, it is less likely to be `hoarders' in general than the current King Log of the software establishment;	プラグマティストたちが嫌うのは何かといえば、それは「隠匿者たち」一般よりはむしろ、ソフトウェア主流派の目下の帝王だろう。
formerly IBM, now Microsoft.	これはかつては IBM だったし、いまはマイクロソフト だ。
To pragmatists the GPL is important as a tool, rather than as an end in itself.	プラグマティストたちにとって、GPL はそれ自体が目的なんじゃなくて、ツールとして重要だ。
Its main value is not as a weapon against `hoarding',	その主な価値は「秘匿」に対する武器としてのものじゃない。
but as a tool for encouraging software sharing and the growth of bazaar-modebazaar-mode development communities.	むしろソフトの共有とバザール様式の開発コミュニティ成長を奨励するためのツールとして大事になる。
The pragmatist values having good tools and toys more than he dislikes commercialism, and may use high-quality commercial software without ideological discomfort.	プラグマティストは、商業主義を嫌うよりはいいツールやおもちゃを手に入れるほうを重視するし、商業製品を使う場合でも、それが高品質なら別にイデオロギー上の不快感は感じない。
At the same time, his open-source experience has taught him standards of technical quality that very little closed software can meet.	同時に、オープンソース界での経験でおぼえた技術的な品質は、閉鎖的なソフトではほとんど実現困難なほど高い。
For many years, the pragmatist point of view expressed itself within the hacker culture mainly as a stubborn current of refusal to completely buy into the GPL in particular or the FSF's agenda in general.	何年にもわたって、ハッカー文化の中のプラグマティスト的な視点は、特に GPL を完全に受け入れたり、あるいはFSFの目標一般を受け入れることを頑固に拒否する流れとして己を主張しつづけていた。
Through the 1980s and early 1990s, this attitude tended to be associated with fans of Berkeley Unix, users of the BSD license, and the early efforts to build open-source Unixes from the BSD source base.	1980 年代と1990 年代初期には、この態度はバークレー Unix のファンや BSD ライセンスの使用者、そして BSD ソースをもとにオープンソースの各種 Unix をつくろうという初期の努力と結びつけられていた。
These efforts, however, failed to build bazaar communities of significant size, and became seriously fragmented and ineffective.	でもこうした試みは、しかるべき規模のバザール・コミュニティ形成に失敗し、きわめて断片化されて力の弱いものとなってしまった。
Not until the Linux explosion of early 1993?1994 did pragmatism find a real power base.	プラグマティストたちが本物の勢力基盤を見つけるには、1993 年初期から 1994 年にかけての Linux の爆発を待たなくてはならなかった。
Although Linus Torvalds never made a point of opposing RMS, he set an example by looking benignly on the growth of a commercial Linux industry, by publicly endorsing the use of high-quality commercial software for specific tasks, and by gently deriding the more purist and fanatical elements in the culture.	Linus Torvalds は決してあえて RMS に反対したりはしなかったけれど、でも商業 Linux 産業が成長するのをだまって見過ごし、特定の仕事には高品質な商業ソフトの利用を推奨し、そしてハッカー文化のもっと純粋主義で狂信的な部分を軽く嘲笑することで、先例を確立したわけだ。
A side effect of the rapid growth of Linux was the induction of a large number of new hackers	Linux 急成長の副作用として、新しいハッカーたちが多数登場したことが挙げられる。
for which Linux was their primary loyalty and the FSF's agenda primarily of historical interest.	かれらにとって、主な忠誠は Linux に対してのものであって、FSF の目標はもっぱら歴史的興味でしかなかった。
Though the newer wave of Linux hackers might describe the system as ``the choice of a GNU generation'', most tended to emulate Torvalds more than Stallman.	Linux ハッカーのもっと新しい波は、Linux システムを「GNU 世代の選択」と表現はするけれど、でもその多くはストールマンよりはトーヴァルズをまねがちだ。
Increasingly it was the anticommercial purists who found themselves in a minority.	しだいに、むしろ反商業的な純潔主義者たちのほうが少数派においやられていった。
How much things had changed would not become apparent until the Netscape announcement in February 1998 that it would distribute Navigator 5.0 in source.	事態がどれだけ変わったかがはっきりしたのは、1998年2月に Netscape 社が Navigator 5.0 をソースコードで配布すると発表したときだった。
This excited more interest in `free software' within the corporate world.	これは企業世界での「フリーソフト」に対する興味をかきたてることになった。
The subsequent call to the hacker culture to exploit this unprecedented opportunity and to re-label its product from `free software' to `open source' was met with a level of instant approval that surprised everybody involved.	これに続いてハッカー文化に対し、このかつてない機会を利用しつくすとともに、その成果を「フリーソフト」から「オープンソース」と命名しなおそうという呼びかけが行われたけれど、これに対しては即座にものすごい支持が得られたので、関係者はだれしもびっくりしたほどだ。
In a reinforcing development, the pragmatist part of the culture was itself becoming polycentric by the mid-1990s.	これをさらに補強する展開として、ハッカー文化のプラグマティスト部分そのものも、1990年代半ばにはだんだん多心型になっていった。
Other semi-independent communities with their own self-consciousness and charismatic leaders began to bud from the Unix/Internet root stock.	Unix/インターネットの根っこの株からは、ほかにも半独立のコミュニティが生まれるようになり、それぞれが独自の自意識とカリスマ的なリーダーを持っている。
Of these, the most important after Linux was the Perl culture under Larry Wall.	なかでも Linux 以降でいちばん重要なのは、Larry Wall 率いる Perl 文化だ。
Smaller, but still significant, were the traditions building up around John Osterhout's Tcl and Guido van Rossum's Python languages.	もっと小さいながらも重要なものとしては、 John Osterhoutの Tcl や Guido Van Rossum の Python 言語を取り巻く伝統が挙げられる。
All three of these communities expressed their ideological independence by devising their own, non-GPL licensing schemes.	この三つとも独自の GPL でないライセンス方式を編み出すことで、イデオロギー的な独立性を主張している。
Promiscuous Theory, Puritan Practice	3　放縦な理論と純潔な実践
Through all these changes, nevertheless, there remained a broad consensus theory of what `free software' or `open source' is.	とはいえこうした変化すべてを通じて、「フリーソフト」や「オープンソース」がなんであるかについては、おおまかな合意を得た理論が維持され続けていた。
The clearest expression of this common theory can be found in the various open-source licenses,	この共通理論のいちばんはっきりした表現は、いろんなオープンソース・ライセンスにみることができる。
all of which have crucial common elements.	そのすべてにはきわめて重要な共通要素があるんだ。
In 1997 these common elements were distilled into the Debian Free Software Guidelines, which became the Open Source Definition.	1997年に、こういう共通要素が蒸留されて Debian フリーソフトウェア・ガイドラインとなり、これがOpen Source Definitionになった。
Under the guidelines defined by the OSD, an open-source license must protect an unconditional right of any party to modify (and redistribute modified versions of) open-source software.	OSD の定義したガイドラインのもとでは、オープンソースのライセンスはオープンソース・ソフトを変更（そしてその変更版を再配布）する権利をだれにでも無条件に認めなくてはならない。
Thus, the implicit theory of the OSD (and OSD-conformant licenses such as the GPL, the BSD license, and Perl's Artistic License) is that anyone can hack anything.	だから OSD（そして GPL、BSD ライセンス、Perl の Artisitic License など OSD 対応のライセンス群）の暗黙の理論というのは、だれもがなんでもハックできるというものだ。
Nothing prevents half a dozen different people from taking any given open-source product (such as, say the Free Software Foundations's gcc C compiler), duplicating the sources, running off with them in different evolutionary directions, but all claiming to be the product.	どんなオープンソース製品（たとえば FSFの gcc C コンパイラとか）でも、6人くらいがソースを複製してそれを勝手にちがった発展方向に向けて変えてしまい、しかもみんなが「これぞ本家本元」と主張する、といったことは十分可能だし、それを止めるものはなにもない。
This kind of divergence is called a fork.	でも実際には、こんな「分裂」はほとんど絶対に起きないといっていい。
The most important characteristic of a fork is that it spawns competing projects that cannot later exchange code, splitting the potential developer community.	大プロジェクトの分裂はすごくまれだし、いつも名前が変わるうえ、世間的にもなぜそれが正当かについて、大量の説明が行われる。
In fact (and in contradiction to the anyone-can-hack-anything consensus theory) the open-source culture has an elaborate but largely unadmitted set of ownership customs.	実際問題として（そして「だれでもなんでもハックできる」という合意があるという理屈とは正反対に）、オープンソース文化は入念ながらほとんど認識されていない所有権の慣習を持っている。
These customs regulate who can modify software, the circumstances under which it can be modified, and (especially) who has the right to redistribute modified versions back to the community.	この慣習によって、だれがソフトを変更できるか、どういう状況でそれが変更できるか、そして（特に）だれが変更バージョンを再配布してコミュニティに戻せるか、が規定されているんだ。
The taboos of a culture throw its norms into sharp relief.	ある文化の禁忌（タブー）は、そこでの規範をシャープに浮かび上がらせる。
Therefore, it will be useful later on if we summarize some important ones here:	だから、だいじなタブーをここでまとめておくと、あとあと役にたつだろう。
There is strong social pressure against forking projects.	プロジェクトの分岐に対してはすごく強い社会的な圧力がある。
It does not happen except under plea of dire necessity, with much public self-justification, and requires a renaming.	どうしてもこれが必要なんだという請願のもとで、世間に対してもその行為を正当化する訴えがたくさん行われ、そしてプロジェクトの名前も変えない限り、それは起こらない。
Distributing changes to a project without the cooperation of the moderators is frowned upon,	プロジェクトへの変更を、モデレータたちの協力なしに行うといい顔をされない。
except in special cases like essentially trivial porting fixes.	ただし、基本的に些末な移植上のフィックスなどはのぞく。
Removing a person's name from a project history, credits, or maintainer list is absolutely not done without the person's explicit consent.	ある人の名前をプロジェクトの歴史やクレジットや管理者リストからのぞくのは、当人のはっきりした合意なしには絶対に行われない。
In the remainder of this essay, we shall examine these taboos and ownership customs in detail.	この論文ではこれから、こうしたタブーと所有についての慣習を検討する。
We shall inquire not only into how they function but what they reveal about the underlying social dynamics and incentive structures of the open-source community.	それらがどう機能するかというだけでなく、それが明らかにしているオープンソース・コミュニティの根底にある社会的な力学やインセンティブ構造についても見ていこう。
Ownership and Open Source	4　所有権とオープンソース
What does `ownership' mean when property is infinitely reduplicable, highly malleable, and the surrounding culture has neither coercive power relationships nor material scarcity economics?	ある物件が無限に複製可能で、いくらでも変えられて、そしてそれをとりまく文化が脅せるような権力関係や財の希少性に基づく経済に基づいていないとき、なにかの「所有権」を持つっていうのはどういうことだろうか。
Actually, in the case of the open-source culture this is an easy question to answer.	実はオープンソース文化に関するかぎり、この質問には簡単に答えられる。
The owner of a software project is the person who has the exclusive right, recognized by the community at large, to distribute modified versions.	ソフトウェア・プロジェクトの所有者というのは、変更したバージョンを公式に再配布する独占的な権利をコミュニティ全般から認められている人物である。
(In discussing `ownership' in this section I will use the singular,	（この章で「所有権」を論じるときには、その所有者については単数形を使う。
as though all projects are owned by some one person.	これだとまるですべてのプロジェクトは一人の人物が所有しているかのようだけれど、
It should be understood, however, that projects may be owned by groups.	プロジェクトをグループで所有している場合もあるということは承知してほしい。
We shall examine the internal dynamics of such groups later on.)	こういうグループ内の力学についても、この論文で見ていくことにする。）
According to the standard open-source licenses, all parties are equals in the evolutionary game.	標準的なオープンソースのライセンスのもとなら、ソフト進化のゲームではみんなが平等なはずだ。
But in practice there is a very well-recognized distinction between `official' patches, approved and integrated into the evolving software by the publicly recognized maintainers, and `rogue' patches by third parties.	でも現実には、公認の管理者が承認して進化するソフトに統合した「公式」パッチと、第三者による「非公式」パッチとははっきり区別して認識されている。
Rogue patches are unusual, and generally not trusted [RP].	非公式パッチはあまりないし、一般には信用のおけないものとされる[RP]。
That public redistribution is the fundamental issue is easy to establish.	公式な再配布こそが根本的な問題なんだというのは、簡単に示せる。
Custom encourages people to patch software for personal use when necessary.	ハッカー文化の慣習は、みんなが自分だけのためにソフトをパッチするのは推奨している。
Custom is indifferent to people who redistribute modified versions within a closed user or development group.	この習慣は、閉じたユーザグループや開発グループ内で変更バージョンを再配布する人々も問題にはしない。
It is only when modifications are posted to the open-source community in general, to compete with the original, that ownership becomes an issue.	そういう変更がオープンソース・コミュニティ一般に対してポストされ、オリジナル版と競合するようになったときにだけ、所有権が問題になってくる。
There are, in general, three ways to acquire ownership of an open-source project.	一般的にいって、オープンソース・プロジェクトの所有権を獲得するには3つの方法がある。
One, the most obvious, is to found the project.	第一の方法はいちばん自明だろうけれど、プロジェクトを創始することだ。
When a project has had only one maintainer since its inception and the maintainer is still active, custom does not even permit a question as to who owns the project.	プロジェクトの開始以来、管理者が一人しかいなくて、その管理者が活動を続けているなら、ハッカー慣習はそのプロジェクトをだれが所有しているのかについて疑問視することすら許さない。
The second way is to have ownership of the project handed to you by the previous owner (this is sometimes known as `passing the baton').	プロジェクトの所有権を獲得する第二の方法は、前の所有者からそれを引き継ぐことだ（いわゆる「バトンタッチ」）。
It is well understood in the community that project owners have a duty to pass projects to competent successors when they are no longer willing or able to invest needed time in development or maintenance work.	プロジェクトの所有者は開発や保守作業に必要な時間を割けなかったり割く気がなかったりするときには、有能な後継者にプロジェクトを引き継ぐ義務がある。
It is significant that in the case of major projects, such transfers of control are generally announced with some fanfare.	大きなプロジェクトの場合、こういうコントロールの引き継ぎは一般に派手なファンファーレつきでアナウンスされていることはだいじだ。
While it is unheard of for the open-source community at large to actually interfere in the owner's choice of succession, customary practice clearly incorporates a premise that public legitimacy is important.	オープンソースコミュニティ全体として、所有者の後継者選びに実際に文句がついた例はまったくないけれど、慣習的な行為は明らかに、世間的に見た正当性がだいじなんだという認識を含んでいる。
For minor projects, it is generally sufficient for a change history included with the project distribution to note the change of ownership.	小規模なプロジェクトでは、プロジェクトの配布パッケージの中に変更履歴を含めておいて、そこで所有者の変化を明記しておけばふつうは十分だ。
The clear presumption is that if the former owner has not in fact voluntarily transferred control, he or she may reassert control with community backing by objecting publicly within a reasonable period of time.	ここでの明らかな過程は、もし前の所有者が自発的にコントロールをゆずったのでなければ、その人はそれなりの期間内に公開の場で抗議することで、コミュニティの支援のもとでコントロールを奪回できる、というものだ。
The third way to acquire ownership of a project is to observe that it needs work and the owner has disappeared or lost interest.	所有権を獲得する第三の方法は、そのソフトに作業が必要だとみてとって、しかももとの所有者が消えたか興味を失ったかしたときだ。
If you want to do this, it is your responsibility to make the effort to find the owner.	もしこれをやるなら、所有者を見つけようとするのがきみの責任だ。
If you don't succeed, then you may announce in a relevant place (such as a Usenet newsgroup dedicated to the application area) that the project appears to be orphaned, and that you are considering taking responsibility for it.	それがうまくいかなければ、しかるべき関係した場所（たとえばそのアプリケーション分野専門の Usenet ニュースグループなんか）でそのプロジェクトがどうも放棄されたらしくて、だから引き継ごうと思うんだけど、と宣言することになる。
Custom demands that you allow some time to pass before following up with an announcement that you have declared yourself the new owner.	慣習は、自分が新しい所有者だと宣言するまえに、しばらく様子を見ろと要求している。
In this interval, if someone else announces that they have been actually working on the project, their claim trumps yours.	このあいだに、だれかが実は自分はそのプロジェクトで作業を続けるんだけど、と申し出れば、その人たちの申し立てが優先されることになる。
It is considered good form to give public notice of your intentions more than once.	プロジェクトを引き継ぎたいという意志発表は、何回かやるのがいいとされる。
You get more points for good form if you announce in many relevant forums (related newsgroups, mailing lists),	それも、複数の場でやったほうがポイントは高い（関連ニュースグループ、メーリングリストなど）。
and still more if you show patience in waiting for replies.	そして返事を待つのに辛抱強ければもっといい。
In general, the more visible effort you make to allow the previous owner or other claimants to respond, the better your claim if no response is forthcoming.	一般に、前の所有者やほかの権利保持者が反応できるようになるべく努力をしたほうが、反応がないときの自分の権利主張が通りやすい。
If you have gone through this process in sight of the project's user community, and there are no objections, then you may claim ownership of the orphaned project and so note in its history file.	このプロセスを、プロジェクトのユーザコミュニティにも見えるところでやって、反対がなければ、その捨て子プロジェクトの所有権を主張して、その旨を履歴ファイルに記入できる。
This, however, is less secure than being passed the baton, and you cannot expect to be considered fully legitimate until you have made substantial improvements in the sight of the user community.	でもこの方法は、バトンタッチされるよりも危ういもので、ユーザコミュニティから見て相当な改良を加えない限り、正式に認められたと思っちゃいけない。
I have observed these customs in action for 20 years, going back to the pre-FSF ancient history of open-source software.	ぼくはこういう慣習が実際に働くのを、FSF 以前のオープンソースの古代にさかのぼる 20 年前から見てきている。
They have several very interesting features.	これにはいくつかとてもおもしろい性質がある。
One of the most interesting is that most hackers have followed them without being fully aware of doing so.	なによりもおもしろいことの一つは、ほとんどのハッカーたちは、実際に自分がそうしていると完全に意識していないのに、これにしたがってきたということだ。
Indeed, this may be the first conscious and reasonably complete summary ever to have been written down.	この文章は、実際に文になった意識的でそれなりに網羅的なまとめとしては、史上初のものかもしれない。
Another is that, for unconscious customs, they have been followed with remarkable (even astonishing) consistency.	もう一つ挙げられるのは、無意識の慣習だというのに、それはきわめて（それどころか驚異的なほど）一貫して守られてきている、ということだ。
I have observed the evolution of literally hundreds of open-source projects,	ぼくは文字通り何百ものオープンソースプロジェクトの進化を見てきた。
and I can still count the number of significant violations I have observed or heard about on my fingers.	それなのに、見聞きした大きな逸脱行為はまだ両手の指で数えられるほどしかない。
Yet a third interesting feature is that as these customs have evolved over time, they have done so in a consistent direction.	でも、第三のおもしろい性質というのは、こういう慣習が時を追って発展してくるとき、それは一貫した方向性を持っていたということだ。
That direction has been to encourage more public accountability, more public notice, and more care about preserving the credits and change histories of projects in ways that (among other things) establish the legitimacy of the present owners.	この方向性というのは、もっと公共的なアカウンタビリティや通達を奨励し、プロジェクトのクレジットや変更履歴の保存についてもっと配慮を増やして（なににもまして）いまの所有者の正当性を確立しようというものだった。
These features suggest that the customs are not accidental, but are products of some kind of implicit agenda or generative pattern in the open-source culture that is utterly fundamental to the way it operates.	こういう性質が示唆しているのは、こうした慣習が偶然の産物ではなくて、オープンソース文化でのなにか暗黙の目的や生成パターンの産物で、その機能方法にとってきわめて根本的なものなんだということだ。
An early respondent pointed out that contrasting the Internet hacker culture with the cracker/pirate culture (the ``warez d00dz'' centered around game-cracking and pirate bulletin-board systems) illuminates the generative patterns of both rather well.	この論文に早い時期にコメントをよせたある人は、インターネット・ハッカー文化とクラッカー・海賊文化（ゲームのクラッキングと海賊ソフト BBS を中心に活動する、「Warez D00dz」）を対比させると双方の生成パターンがなかなかはっきりすることを指摘してくれた。
We'll return to the d00dz for contrast later in this essay.	d00dz との対比は後出。
Locke and Land Title	5　ロックと土地所有権
To understand this generative pattern, it helps to notice a historical analogy for these customs that is far outside the domain of hackers' usual concerns.	この生成パターンを理解するには、ハッカーの通常の関心領域をはるかに離れて、こうした慣習と歴史的に類似した例を見るのが役に立つ。
As students of legal history and political philosophy may recognize, the theory of property they imply is virtually identical to the Anglo-American common-law theory of land tenure!	法制度史や政治哲学を学んだ人ならお気づきのように、ハッカーたちが暗に主張している所有理論は、英米慣習法における土地所有権の理論とほとんどまったく同じなんだ！
In this theory, there are three ways to acquire ownership of land:	この理論では、土地の所有権を獲得する方法は3つある。
On a frontier, where land exists that has never had an owner,	未開の地（フロンティア）には、これまで所有者のいなかった土地がある。
one can acquire ownership by homesteading,	そこでは人は、開墾（homesteading）することで所有権を獲得できる。
mixing one's labor with the unowned land, fencing it, and defending one's title.	つまり、自分の労働を所有されていない土地に混ぜ込み、囲いをつけて自分の地権を守ることによって。
The usual means of transfer in settled areas is transfer of title	入植済みの地域での土地移譲は、ふつうは土地所有権の移転によって行われる。
?that is, receiving the deed from the previous owner.	これはつまり、前の所有者から証書を受け取ることだ。
In this theory, the concept of `chain of title' is important.	この理論に基づけば、所有権の連鎖という概念が重要になる。
The ideal proof of ownership is a chain of deeds and transfers extending back to when the land was originally homesteaded.	所有権の証明として理想的なのは、証書とその移転の連鎖が、その土地のそもそもの開墾時点にまでさかのぼれることだ。
Finally, the common-law theory recognizes that land title may be lost or abandoned	最後に、慣習法理論は土地の所有権が失われたり放棄されたりすることがあるのを認識している
(for example, if the owner dies without heirs, or the records needed to establish chain of title to vacant land are gone).	（たとえば所有者が相続人なしに死んだり、空き地に対する所有権の連鎖を確立するための記録が失われていたりする場合）。
A piece of land that has become derelict in this way may be claimed by adverse possession	このようにして遺棄された土地は、占拠によって所有権の主張を行える
?one moves in, improves it, and defends title as if homesteading.	――だれかがそこに入居して、整備を行い、そして開墾時と同じようにそこの所有権を防衛するわけだ。
This theory, like hacker customs, evolved organically in a context where central authority was weak or nonexistent.	この理論はハッカーの慣習と同じように、中央権力が弱いか存在しないような場面で有機的に発達してきた。
It developed over a period of a thousand years from Norse and Germanic tribal law.	それは千年以上もかけて、ノルウェイやドイツの部族法から発展してきたものだ。
Because it was systematized and rationalized in the early modern era by the English political philosopher John Locke, it is sometimes referred to as the Lockean theory of property.	それを近代の初期に体系化して合理化したのがイギリスの政治哲学者ジョン・ロックだったので、これはよく所有物の「ロック」理論と呼ばれる。
Logically similar theories have tended to evolve wherever property has high economic or survival value and no single authority is powerful enough to force central allocation of scarce goods.	論理的によく似た理論は、ある物件が経済的または生存上で高い価値を持っていて、しかも稀少財の配分について、中央集権的に強制するだけの力を持った単一の権威が存在しないところでは必ず生じるようだ。
This is true even in the hunter-gatherer cultures that are sometimes romantically thought to have no concept of `property'.	これは、ときどきロマンチックに「所有」の概念がないと考えられたりもする狩猟採集文化でも成り立つ。
For example, in the traditions of the !Kung San bushmen of the Kgalagadi (formerly `Kalahari') Desert, there is no ownership of hunting grounds.	たとえば Kgalagadi (カラハリ) 砂漠のクンサン・ブッシュマンの伝統では、狩猟場には所有権は存在しない。
But there is ownership of waterholes and springs under a theory recognizably akin to Locke's.	でも、井戸や泉については所有権が存在して、その理論は明らかにロックの理論と似ている。
The !Kung San example is instructive,	クンサン・ブッシュマンの例は示唆的だろう。
because it shows that Lockean property customs arise only where the expected return from the resource exceeds the expected cost of defending it.	というのも、これはロック式の所有権慣習が、その資源からの期待リターンがそれを独占して守る期待コストよりも大きい場合にのみ生じることを示してくれるからだ。
Hunting grounds are not property because the return from hunting is highly unpredictable and variable, and (although highly prized) not a necessity for day-to-day survival.	狩猟場が所有権の対象にならないのは、狩猟のリターンがすごく予想しにくくて変動しやすく、さらに（すごく高く評価はされるけれど）日々の生存にとって絶対的に必要なものではないからだ。
Waterholes, on the other hand, are vital to survival and small enough to defend.	一方の井戸は、生存にとって不可欠だし、守りきれるくらい小さい。
The `noosphere' of this essay's title is the territory of ideas, the space of all possible thoughts [N].	この論文の題名に出てくる「ノウアスフィア（noosphere）」というのはアイデア（観念）の領域であり、あらゆる可能な思考の空間だ[N]。
What we see implied in hacker ownership customs is a Lockean theory of property rights in one subset of the noosphere, the space of all programs.	ハッカーの所有権慣習に暗黙に含まれているのは、ノウアスフィアの部分集合の一つであるすべてのプログラムを包含する空間での、所有権に関するロック理論なんだ。
Hence `homesteading the noosphere',	だからこの論文は「ノウアスフィアの開墾」と名付けた。
which is what every founder of a new open-source project does.	新しいオープンソース・プロジェクトの創始者がみんなやっているのがそれだからだ。
He asserts that what hackers own is programming projects	かれの主張だと、ハッカーが所有しているのはプログラミング・プロジェクトなんだ
?intensional focus points of material labor (development, service, etc), to which are associated things like reputation, trustworthiness, etc.	―― これはつまり、物質的な労働（開発、整備など）の意図的な焦点で、ここに評判、信用性なんかが結びついている。
He therefore asserts that the space spanned by hacker projects, is not the noosphere but a sort of dual of it, the space of noosphere-exploring program projects.	ここからかれは、ハッカーのプロジェクトが覆っている空間はノウアスフィアではなく、むしろその分身のような、ノウアスフィアを探索するプログラム・プロジェクトだと主張する
(With an apologetic nod to the astrophysicists out there, it would be etymologically correct to call this dual space the `ergosphere' or `sphere of work'.)	（読者のなかの天文物理学者たちに敬意を表しつつも、語源的にいえばこの分身空間を「エルゴスフィア」または「作業のスフィア」と呼んでまちがいない）。
In practice, the distinction between noosphere and ergosphere is not important for the purposes of our present argument.	現実問題としては、ノウアスフィアとエルゴスフィアとの区別はこの論文の目的からいえばだいじじゃない。
one would almost have to be a Platonic philosopher to believe in it.	そんなものを信じるには、プラトン主義哲学者にでもなるしかないだろう。
And the distinction between noosphere and ergosphere is only of practical importance if one wishes to assert that ideas (the elements of the noosphere) cannot be owned, but their instantiations as projects can.	そしてノウアスフィアとエルゴスフィアとの区別が実際的な重要性を持つのは、アイデア・観念（ノウアスフィアの要素）は所有できずそれをプロジェクトとして実体化したものだけが所有できると考えたい場合だけだ。
This question leads to issues in the theory of intellectual property which are beyond the scope of this essay (but see [DF]).	この問題から出てくる課題は、知的所有権の理論的な問題につながるもので、この論文の範囲を超える。[DF]
To avoid confusion, however, it is important to note that neither the noosphere nor the ergosphere is the same as the totality of virtual locations in electronic media that is sometimes (to the disgust of most hackers) called `cyberspace'.	でも混乱を避けるために言っておくと、ノウアスフィアもエルゴスフィアも、時に（多くのハッカーたちは顔をしかめるけれど）「サイバースペース」と呼ばれる電子メディア内での仮想位置全体とはちがう。
Property there is regulated by completely different rules	サイバースペースでの所有権はまったくちがった規則にしたがって統制されている。
that are closer to those of the material substratum	その規則は物質的な世界での規則のほうに、むしろ似ている
?essentially, he who owns the media and machines on which a part of `cyberspace' is hosted owns that piece of cyberspace as a result.	――基本的には、その「サイバースペース」の一部を宿しているメディアやマシンを所有している人物が、そのサイバースペースを結果的に所有していることになる。
The Lockean logic of custom suggests strongly that open-source hackers observe the customs they do in order to defend some kind of expected return from their effort.	ロック的な構造は、オープンソースのハッカーたちがその慣習をまもるのは、なにか自分たちの努力からの、一種の期待収益を守ろうとしているからだろうと強く示唆している。
The return must be more significant than the effort of homesteading projects, the cost of maintaining version histories that document `chain of title', and the time cost of making public notifications and waiting before taking adverse possession of an orphaned project.	この収益は、プロジェクト開墾の努力や「所有権の連鎖」を記録したバージョン履歴を維持するコスト、そして捨て子になったプロジェクトを占拠するまでに公的な通達を出してしばらく待つという時間コストよりもずっと大きなものでなくてはならない。
Furthermore, the `yield' from open source must be something more than simply the use of the software,	さらに、オープンソースからの「収益」は単なるソフトの利用価値以上のものでなきゃならない。
something else that would be compromised or diluted by forking.	プロジェクトの分裂によってダメになったり減ったりしてしまうようなものでなければ。
If use were the only issue, there would be no taboo against forking, and open-source ownership would not resemble land tenure at all.	もし利用価値だけが問題なら、分裂に対するタブーはないし、オープンソースの所有権も土地所有権とは似てもにつかないはずだ。
In fact, this alternate world (where use is the only yield, and forking is unproblematic) is the one implied by existing open-source licenses.	事実、既存のオープンソース・ライセンスから導かれるのは、こういう（利用価値だけが唯一の収益となる）別世界だ。
We can eliminate some candidate kinds of yield right away.	いくつか候補としてあがる収益はすぐに却下できる。
Because you can't coerce effectively over a network connection, seeking power is right out.	ネット接続上では有効な脅しがかけられないので、権力追求はまったく成り立たない。
Likewise, the open-source culture doesn't have anything much resembling money or an internal scarcity economy, so hackers cannot be pursuing anything very closely analogous to material wealth (e.g. the accumulation of scarcity tokens).	同じく、オープンソース文化はお金や内的な稀少性経済に類するものは持っていないから、ハッカーたちも物質的な富とあまり似たものを追求していることはあり得ない。
There is one way that open-source activity can help people become wealthier, however	ただし、オープンソース活動で人々がもっと金持ちになれる方法が一つなくはない
?a way that provides a valuable clue to what actually motivates it.	――そしてそれは、その実際に動機に貴重なヒントを与えてくれるものではある。
Occasionally, the reputation one gains in the hacker culture can spill over into the real world in economically significant ways.	しばしば、ハッカー文化で人が獲得した評判は実世界でも反映されて、それが経済的に意味をもってくることがある。
It can get you a better job offer, or a consulting contract, or a book deal.	もっといい仕事が得られるとか、コンサルタント契約が手に入るとか、あるいは本の執筆依頼がくるとか。
This kind of side effect, however, is at best rare and marginal for most hackers;	でもこの種の副作用は、よくいってもまれだし、ほとんどのハッカーにとっては副次的なものでしかない。
far too much so to make it convincing as a sole explanation,	唯一の説明として説得力を持つには、多くのハッカーにはあまりに縁遠いものだ。
even if we ignore the repeated protestations by hackers that they're doing what they do not for money but out of idealism or love.	それにハッカーたちはなんども、自分たちは金のためにやってるんじゃない、理想と愛のためにやってるんだ、と主張している。
However, the way such economic side effects are mediated is worth examination.	でも、こういう経済的な副作用が処理されるやり方は検討する価値がある。
Next we'll see that an understanding of the dynamics of reputation within the open-source culture itself has considerable explanatory power.	これから、オープンソース文化そのもののなかでの評判の力学だけでも、かなりの説明力があることを見てみよう。
The Hacker Milieu as Gift Culture	6　贈与経済としてのハッカー文化
To understand the role of reputation in the open-source culture, it is helpful to move from history further into anthropology and economics, and examine the difference between exchange cultures and gift cultures.	オープンソース文化での評判の役割を理解するには、歴史から離れて文化人類学と経済学に深入りし、交換の文化と贈与の文化のちがいを検討してみると役に立つ。
Human beings have an innate drive to compete for social status;	人間は、社会的地位のために競争しようという生まれながらの衝動がある。
it's wired in by our evolutionary history.	それはヒトの進化の歴史のなかでからだに刻み込まれているんだ。
For the 90% of hominid history that ran before the invention of agriculture, our ancestors lived in small nomadic hunter-gatherer bands.	その歴史のうち、農業の発明に先立つ 90％ を通じて、ぼくたちの先祖は小さな遊牧式狩猟採集集団をつくって暮らしていた。
High-status individuals (those most effective at informing coalitions and persuading others to cooperate with them) got the healthiest mates and access to the best food.	地位の高い個人は、一番健康な伴侶と最高の食料へのアクセスを手に入れた。
This drive for status expresses itself in different ways, depending largely on the degree of scarcity of survival goods.	この地位への衝動は、おもに生存に必要な財の稀少性の度合いに応じて、いろいろな形であらわれてくる。
Most ways humans have of organizing are adaptations to scarcity and want.	人間が持つ組織化のほとんどの方法は、希少性と欲求に対する適応行動だ。
Each way carries with it different ways of gaining social status.	それぞれの方法は、社会的地位を獲得する別々の手段を持っている。
The simplest way is the command hierarchy.	一番簡単な方法は 上意下達方式（command hierarchy）だ。
In command hierarchies, scarce goods are allocated by one central authority and backed up by force.	上意下達方式では、稀少な財の配分は一つの中央権力が行って、それが軍事力でバックアップされる。
Command hierarchies scale very poorly [Mal];	上意下達方式は、規模の変化への適応力（スケーラビリティ）がものすごくとぼしい[Mal]。
they become increasingly brutal and inefficient as they get larger.	大きくなるにつれて、ますます横暴で非効率になってゆく。
For this reason, command hierarchies above the size of an extended family are almost always parasites on a larger economy of a different type.	このため、大家族以上の上意下達方式はほぼかならずといっていいほど、別のかたちのもっと大きな経済に寄生する存在でしかない。
In command hierarchies, social status is primarily determined by access to coercive power.	上意下達方式では、社会的地位はおもに恐喝力へのアクセス能力によって決まってくる。
Our society is predominantly an exchange economy.	ぼくたちの社会はもっぱら交換経済だ。
This is a sophisticated adaptation to scarcity that, unlike the command model, scales quite well.	これは財の希少性に対する洗練された適応方式で、規模の変化にもよく適応する。
Allocation of scarce goods is done in a decentralized way through trade and voluntary cooperation	稀少な財の配分は、交換と自発的な協力によって非中心的に行われる
(and in fact, the dominating effect of competitive desire is to produce cooperative behavior).	（そして実は、競争の欲望がもたらす最大の効果は協力行動を生み出すことだ）。
In an exchange economy, social status is primarily determined by having control of things (not necessarily material things) to use or trade.	交換経済では、社会的地位はおもにもの（必ずしも物質的なものとは限らない）のコントロールの大小で決まる。
Most people have implicit mental models for both of the above, and how they interact with each other.	ほとんどの人は、この二つについては説明されるまでもなく精神的なモデルを持っているし、それらがどう相互に機能するかもわかっている。
Government, the military, and organized crime (for example) are command hierarchies parasitic on the broader exchange economy we call `the free market'.	政府や軍、ギャング集団などは、ぼくたちが「自由市場」とよぶもっと大きな交換経済に寄生している上意下達システムだ。
There's a third model, however, that is radically different from either and not generally recognized except by anthropologists;	しかしながら、このどちらともまったくちがっていて、人類学者たち以外はあまり認知されていない第三のモデルがあるんだ。
the gift culture.	これが贈与の文化だ。
Gift cultures are adaptations not to scarcity but to abundance.	贈与文化は、希少性ではなく過剰への適応だ。
They arise in populations that do not have significant material-scarcity problems with survival goods.	それは生存に不可欠な財について、物質的な欠乏があまり起きない社会で生じる。
We can observe gift cultures in action among aboriginal cultures living in ecozones with mild climates and abundant food.	穏和な気候と豊富な食料を持った経済圏の原住民の間には、贈与経済が見られる。
We can also observe them in certain strata of our own society,	ぼくたち自身の社会でも、一部の層では観察される。
especially in show business and among the very wealthy.	たとえばショービジネスや大金持ちの間でだ。
Abundance makes command relationships difficult to sustain and exchange relationships an almost pointless game.	過剰は上意下達関係を維持困難にして、交換による関係をほとんど無意味なゲームにしてしまう。
In gift cultures, social status is determined not by what you control but by what you give away.	贈与の文化では、社会的なステータスはその人がなにをコントロールしているかではなく、その人がなにをあげてしまうかで決まる。
Thus the Kwakiutl chieftain's potlach party.	だからクワキトルの酋長はポトラッチ・パーティーを開く。
Thus the multi-millionaire's elaborate and usually public acts of philanthropy.	億万長者は派手にフィランソロフィー活動をして、しかもそれをひけらかすのが通例だ。
And thus the hacker's long hours of effort to produce high-quality open-source code.	そしてハッカーたちは、長時間の労力をそそいで、高品質のオープンソース・ソフトをつくる。
For examined in this way, it is quite clear that the society of open-source hackers is in fact a gift culture.	というのも、こうして検討すると、オープンソース・ハッカーたちの社会がまさに贈与文化であるのは明らかだからだ。
Within it, there is no serious shortage of the `survival necessities'?disk space, network bandwidth, computing power.	そのなかでは「生存に関わる必需品」――つまりディスク領域、ネットワーク帯域、計算能力など――が深刻に不足するようなことはない。
Software is freely shared.	ソフトは自由に共有される。
This abundance creates a situation in which the only available measure of competitive success is reputation among one's peers.	この豊富さが産み出すのは、競争的な成功の尺度として唯一ありえるのが仲間内の評判だという状況だ。
This observation is not in itself entirely sufficient to explain the observed features of hacker culture, however.	でもこの観察は、それだけではハッカー文化に見られる特徴を説明するのに十分とはいえない。
The crackers and warez d00dz have a gift culture that thrives in the same (electronic) media as that of the hackers, but their behavior is very different.	クラッカー d00dz は、ハッカーと同じ（電子）メディア上に息づく贈与文化を持っているけれど、その行動は大きくちがっている。
The group mentality in their culture is much stronger and more exclusive than among hackers.	このグループの性行は、ハッカーよりもずっと強くて排外的だ。
They hoard secrets rather than sharing them;	共有するよりは秘密を隠匿したがる。
one is much more likely to find cracker groups distributing sourceless executables that crack software than tips that give away how they did it.	クラッカーグループでは、ソフトクラック用のソースのない実行ファイルが出回ることのほうが、そのやりかたを教えるヒントが出回ることより多い。
(For an inside perspective on this behavior, see [LW]).	（この行動についての、d00dz集団内部からの観点については [LW] を参照。）
What this shows, in case it wasn't obvious, is that there is more than one way to run a gift culture.	これが示しているのは、もちろん言うまでもなく自明だろうけれど、贈与文化の運用方法は一つじゃないってことだ。
History and values matter. I have summarized the history of the hacker culture in A Brief History of Hackerdom[HH];	ぼくはハッカー文化の歴史について、別のところでまとめたことがある[HH]。
the ways in which it shaped present behavior are not mysterious.	それがいまの行動を形成していった方法は、謎なんかじゃない。
Hackers have defined their culture by a set of choices about the form that their competition will take.	ハッカーたちは、自分たちの文化を規定するにあたり、自分たちの競合が行われる形式の集合を利用したわけだ。
It is that form that we will examine in the remainder of this essay.	この論文ではこの先、その形式を検討することにしよう。
The Joy of Hacking	7　ハッキングのよろこび
In making this `reputation game' analysis, by the way, I do not mean to devalue or ignore the pure artistic satisfaction of designing beautiful software and making it work.	ついでに言っておくと、この「評判ゲーム」の分析をするからといって、別に美しいソフトを設計してそれをうまく動かすことの芸術的な満足を軽んじたり、無視したりするつもりはない。
Hackers all experience this kind of satisfaction and thrive on it.	ぼくたちみんな、こういう満足は経験しているし、そのために生きているようなとこさえある。
People for whom it is not a significant motivation never become hackers in the first place,	そういうのがだいじな動機になっていないような人間は、そもそもハッカーになったりはしない。
just as people who don't love music never become composers.	ちょうど、音楽を好きでない人間が作曲家になったりしないのと同じことだ。
So perhaps we should consider another model of hacker behavior in which the pure joy of craftsmanship is the primary motivation.	だったら、職人気質の純粋なよろこびが主な動機となっているハッカー行動のモデルを考えたほうがいいのかな？
This `craftsmanship' model would have to explain hacker custom as a way of maximizing both the opportunities for craftsmanship and the quality of the results.	この「職人気質」モデルは、職人気質発揮機会最大化とその結果の最大化を達成する手段としてハッカー慣習を説明できなくてはならない。
Does this conflict with or suggest different results than the reputation game model?	これは、「評判ゲーム」モデルと対立したり、別の結果を示唆したりしているだろうか？
Not really.	そうでもない。
In examining the craftsmanship model, we come back to the same problems that constrain hackerdom to operate like a gift culture.	「職人気質」モデルを検討すると、結局はハッカー社会を贈与文化のように動かしている制約条件と同じ問題に戻ってくることになる。
How can one maximize quality if there is no metric for quality?	品質をはかる尺度がなければ、品質を最大化なんかできないだろう。
If scarcity economics doesn't operate, what metrics are available besides peer evaluation?	希少性の経済が働かないなら、仲間内の評価以外の尺度なんかありえないだろう。
It appears that any craftsmanship culture ultimately must structure itself through a reputation game	どうも、職人気質文化はけっきょくのところ、評判ゲームを通じて組織されるしかないんじゃないか
?and, in fact, we can observe exactly this dynamic in many historical craftsmanship cultures from the medieval guilds onwards.	――そして中世ギルド以来の多くの職人文化では、まさにこの力学が機能しているのがうかがえるんだ。
In one important respect, the craftsmanship model is weaker than the `gift culture' model;	ある重要な一点で、「職人気質」モデルは「贈与文化」モデルより弱い。
by itself, it doesn't help explain the contradiction we began this essay with.	それだけでは、この論文のきっかけとなったそもそもの矛盾は説明できない。
Finally, the craftsmanship motivation itself may not be psychologically as far removed from the reputation game as we might like to assume.	最後に、「職人気質」的な動機はそれ自体として、ぼくたちが考えたがるほどは評判ゲームからかけ離れたものじゃないかもしれない。
Imagine your beautiful program locked up in a drawer and never used again.	自分の書いたみごとなプログラムが引き出しに鍵をかけてしまいこまれていたらどうだろう。
Now imagine it being used effectively and with pleasure by many people.	一方、それがうまく使われてみんなに喜ばれていたらどうだろう。
Which dream gives you satisfaction?	どっちのほうがきみとしては満足だろうか？
Nevertheless, we'll keep an eye on the craftsmanship model.	とはいっても、職人気質モデルは捨てないでおこう。
It is intuitively appealing to many hackers, and explains some aspects of individual behavior well enough [HT].	それは多くのハッカーにとって直感的にわかりやすいし、個人行動のある面はすごくうまく説明してくれるから。[HT]
After I published the first version of this essay on the Internet, an anonymous respondent commented:	この論文の初版を公開してから、匿名の評者がこう述べた。
``You may not work to get reputation, but the reputation is a real payment with consequences if you do the job well.''	「意図的に評判を得ようとして作業はしないかもしれないけれど、でも評判というのは仕事をちゃんとしていれば、本当に利益をもたらす真の見返りなんだよ」。
This is a subtle and important point.	これは細かいが重要なポイントだ。
The reputation incentives continue to operate whether or not a craftsman is aware of them;	評判インセンティブは、職人がそれを認識しているかどうかによらず、機能し続ける。
thus, ultimately, whether or not a hacker understands his own behavior as part of the reputation game, his behavior will be shaped by that game.	だから究極的には、ハッカーが自分の行動を評判ゲームの一部として理解しているかどうかによらず、かれの行動はそのゲームに左右されることになる。
Other respondents related peer-esteem rewards and the joy of hacking to the levels above subsistence needs in Abraham Maslow's well-known `hierarchy of values' model of human motivation [MH].	ほかの反応としては、同業者の中での名誉という報酬とハッキングの喜びが、生活維持に必要な水準以上になっているということを、人間の動機づけに関するアイブラハム・マズローの有名な「価値のヒエラルキー」モデルと関連づけている（[MH]）。
On this view, the joy of hacking fulfills a self-actualization or transcendence need, which will not be consistently expressed until lower-level needs (including those for physical security and for `belongingness' or peer esteem) have been at least minimally satisfied.	この観点からすると、ハッキングの喜びというのは自己実現ないし高次ニーズであって、低次のニーズ（たとえば肉体的な安定性や「帰属感」や同業者の中の名誉など）が最低限は満たされない限り、一貫性を持った形で表明されることはないのだ、ということになる。
Thus, the reputation game may be critical in providing a social context within which the joy of hacking can in fact become the individual's primary motive.	だから評判ゲームは、ハッキングの喜びがまさに個人の主要動機となれるような社会的文脈を提供するにあたって、とても重要なものとなるかもしれない。
The Many Faces of Reputation	8　評判のさまざまな相貌
There are reasons general to every gift culture why peer repute (prestige) is worth playing for:	なぜ仲間内の評判（名声）が勝ち取るに足るものなのかについては、あらゆる贈与文化に共通する理由がある。
First and most obviously, good reputation among one's peers is a primary reward.	まず第一にいちばん明らかな点だけれど、仲間内のよい評判はそれ自体が重要な報酬だからだ。
We're wired to experience it that way for evolutionary reasons touched on earlier.	ぼくたちは、まえにふれた進化上の理由から、そう感じるようにつくられている
(Many people learn to redirect their drive for prestige into various sublimations that have no obvious connection to a visible peer group, such as ``honor'', ``ethical integrity'', ``piety'' etc.;	（多くの人々は、名声に対する欲求をいろいろ昇華させて、はっきりした仲間グループと結びつかない「名誉」「倫理的誠実さ」「慈悲」などにリダイレクトすることを学ぶ。
this does not change the underlying mechanism.)	でもだからといって、根っこのメカニズムは変わらない）。
Secondly, prestige is a good way (and in a pure gift economy, the only way) to attract attention and cooperation from others.	第二に、名声は他人の注目を集めて協力を得るのにすごく有効な方法だ
If one is well known for generosity, intelligence, fair dealing, leadership ability, or other good qualities, it becomes much easier to persuade other people that they will gain by association with you.	もしある人が、気前よく、知的で、公正で、指導力があるとかいったよい資質で有名だったら、その人と関わりを持つことでメリットがあると他人に説得するのはずっと簡単になる。
Thirdly, if your gift economy is in contact with or intertwined with an exchange economy or a command hierarchy, your reputation may spill over and earn you higher status there.	第三に、もし贈与経済が交換経済や上意下達方式と接触していたり混じり合ったりしていた場合にも、評判がそっちに持ち越されて、もっと高い地位を得る役にたつかもしれない。
Beyond these general reasons, the peculiar conditions of the hacker culture make prestige even more valuable than it would be in a `real world' gift culture.	こうした一般的な理由に加えて、ハッカー文化ではその特殊な条件のおかげで「現実世界」の贈与文化にくらべて名声がもっと価値の高いものになっている。
The main `peculiar condition' is that the artifacts one gives away (or, interpreted another way, are the visible sign of one's gift of energy and time) are very complex.	「特殊な条件」の最大のものは、ある人があげる成果物（あるいは別の解釈をするなら、その人の贈る労力と時間の目に見えるしるし）がとても複雑であることだ。
Their value is nowhere near as obvious as that of material gifts or exchange-economy money.	その価値は、物質的な贈り物や交換経済のお金とはくらべものにならないほど不明確だ。
It is much harder to objectively distinguish a fine gift from a poor one.	よい贈り物とろくでもない贈り物を客観的に区別するのはずっとむずかしい。
Accordingly, the success of a giver's bid for status is delicately dependent on the critical judgement of peers.	したがって、何かを贈る人が地位を求めて成功するかどうかは、仲間うちの批評的な判断に繊細に関わってくる。
Another peculiarity is the relative purity of the open-source culture.	もう一つ特異なのは、オープンソース文化が比較的純粋であることだ。
Most gift cultures are compromised	ほとんどの贈与文化はまざりものが入っている
?either by exchange-economy relationships such as trade in luxury goods, or by command-economy relationships such as family or clan groupings.	――奢侈品の交易などで交換経済が入り込んでいたり、家族や部族集団みたいな上意下達関係が入っていたりする。
No significant analogues of these exist in the open-source culture;	オープンソースはこれに類するものはほとんどないと言っていい。
thus, ways of gaining status other than by peer repute are virtually absent.	だから、仲間内の評判以外に地位を獲得する方法は、まずない。
Ownership Rights and Reputation Incentives	9　所有権と評判によるインセンティブ
We are now in a position to pull together the previous analyses into a coherent account of hacker ownership customs.	さてここまできたら、これまでの分析をひとまとめにして、ハッカーの所有権慣習をもっと統一的にとらえてみよう。
We understand the yield from homesteading the noosphere now;	ノウアスフィアの開墾からの収益はわかった。
it is peer repute in the gift culture of hackers,	それはハッカーの贈与文化における仲間内の評判だ。
with all the secondary gains and side effects that implies.	そしてそれにともなう二次的なメリットや副作用もついてくる。
From this understanding, we can analyze the Lockean property customs of hackerdom as a means of maximizing reputation incentives;	この理解にもとづいて、ぼくたちはハッカー社会のロック流の所有権慣習が評判上のインセンティブを最大化する手段なんだと分析できる。
of ensuring that peer credit goes where it is due and does not go where it is not due.	つまり、仲間内のクレジットがしかるべき人物に帰属して、それ以外のところには行かないようにするわけだ。
The three taboos we observed above make perfect sense under this analysis.	これまで検討した3つのタブーは、この分析に基づけば完全に筋が通ってくる。
One's reputation can suffer unfairly if someone else misappropriates or mangles one's work;	他人が自分の作業を不当に横取りしたり、変な加工をしたりすれば、自分の評判が不当に落ちることになる。
these taboos (and related customs) attempt to prevent this from happening.	こういうタブー（そして関連した慣習）は、そういう事態を避けようとするものだ。
Forking projects is bad because it exposes pre-fork contributors to a reputation risk	プロジェクトの分裂がよくないのは、分裂以前に貢献していた人たちが評価上のリスクにさらされることになるからだ。
they can only control by being active in both child projects simultaneously after the fork.	このリスクをなくすには、かれらは分裂後の両方のプロジェクトで同時に活動しなくてはならない
(This would generally be too confusing or difficult to be practical.)	（これは一般にややこしすぎたり、実践するのがむずかしすぎたりする）。
Distributing rogue patches (or, much worse, rogue binaries) exposes the owners to an unfair reputation risk.	非公式パッチを配布する（あるいはもっとひどい場合には非公式バイナリを配布する）と、所有者たちは不公正な評判上のリスクにさらされる。
Even if the official code is perfect, the owners will catch flak from bugs in the patches (but see [RP]).	公式コードが完璧であっても、所有者たちはパッチのバグのおかげで不評をかうはめになりかねない（とはいえ、[RP]を参照のこと）。
Surreptitiously filing someone's name off a project is, in cultural context, one of the ultimate crimes.	こっそりだれかの名前をプロジェクトからはずすことは、文化的な文脈では究極の犯罪だ。
Doing this steals the victim's gift to be presented as the thief's own.	それは犠牲者の贈り物を盗み取って、泥棒のものとして提示するということだからだ。
Of course, forking a project or distributing rogue patches for it also directly attacks the reputation of the original developer's group.	もちろん、プロジェクトをフォークさせたり非公式パッチを配布させたりするのは、もとの開発者グループの評判を直接攻撃することにもなる。
If I fork or rogue-patch your project, I am saying:	もしぼくがきみのプロジェクトをフォークさせたり非公式パッチを配布したりすると、ぼくはつまりこう言っていることになる：
"you made a wrong decision	「きみはまちがった決定を下した。
by failing to take the project where I am taking it";	（プロジェクトを、ぼくが導いているような方向に導いていない）」
and anyone who uses my forked variation is endorsing this challenge.	そしてぼくのフォーク版を使う人間はみんな、ぼくのきみに対する挑戦を支持していることになる。
But this in itself would be a fair challenge,	でもこれ自体は、フェアな挑戦だ。
albeit extreme;	極端ではあるにしても。
it's the sharpest end of peer review.	これは同業者（ピア）レビューの究極の形だ。
It's therefore not sufficient in itself to account for the taboos,	だからこれは、これだけではタブーの説明としては不十分だ。
though it doubtless contributes force to them.	それを強化するものであるのは確かだけれど。
All three taboo behaviors inflict global harm on the open-source community as well as local harm on the victim(s).	このタブーの３つとも、被害者個人のレベルで害をもたらすとともに、オープンソースコミュニティに全体として害を及ぼすものだ。
Implicitly they damage the entire community by decreasing each potential contributor's perceived likelihood that gift/productive behavior will be rewarded.	これらは、各潜在貢献者たちが、自分の贈り物・生産的行動に報酬が与えられるという可能性の認識を減らすことで、暗黙のうちに全コミュニティに害をなすことになる。
It's important to note that there are alternate candidate explanations for two of these three taboos.	この三つのタブーのうち２つに対しては、別の説明候補があることは理解する必要がある。
First, hackers often explain their antipathy to forking projects by bemoaning the wasteful duplication of work it would imply as the child products evolve on more-or-less parallel courses into the future.	まず、ハッカーはプロジェクト分裂に対する反感について、そんなことになったら子プロジェクトは当分はある程度似たような道をたどるから、作業が二重化して無駄だろ、と説明する。
They may also observe that forking tends to split the co-developer community, leaving both child projects with fewer brains to use than the parent.	また分裂は共同開発者コミュニティを分裂させることが多く、だからどちらの子プロジェクトも、親より脳味噌が少なくなる点を指摘する人もいるだろう。
A respondent has pointed out that it is unusual for more than one offspring of a fork to survive with significant `market share' into the long term.	ある人のコメントだけれど、分裂の結果の子プロジェクトが、長期的にそれなりの「市場シェア」をもって一つ以上生き延びることは滅多にない。
This strengthens the incentives for all parties to cooperate and avoid forking,	これはあらゆる関係者が協力して分裂を避けるインセンティブを強化する。
because it's hard to know in advance who will be on the losing side and see a lot of their work either disappear entirely or languish in obscurity.	だれが負け組に入るかを知るのはむずかしいし、負け組では自分たちの仕事の大半があっさり消えたり、無名なままで放置されたりすることになるからだ。
Dislike of rogue patches is often explained by the objection that they can create compatibility problems between the daughter versions, complicate bug-tracking enormously, and inflict work on maintainers who have quite enough to do catching their own mistakes.	非公式パッチへの批判は、それがバグ追跡をものすごく難しくすることや、自前のバグを処理するだけでも手いっぱいな管理者の作業を、さらに増やす点などを観察したうえで説明されることが多い。
There is considerable truth to these explanations,	こうした説明には、かなりの真実が含まれている。
and they certainly do their bit to reinforce the Lockean logic of ownership.	そしていずれも、ロック式所有権の論理を強化するためにそれなりの働きをしてくれる。
But while intellectually attractive, they fail to explain why so much emotion and territoriality gets displayed on the infrequent occasions that the taboos get bent or broken	でも知的にはおもしろいけれど、これはタブーが曲げられたり破られたりするきわめてまれな状況で、なぜこれほどの感情となわばり性が発揮されるのかという説明にはならない。
?not just by the injured parties, but by bystanders and observers who often react quite harshly.	しかもこれは、被害を受けた人々だけでなく、傍観者や見物人にもあてはまり、こういう人たちもかなり厳しい反応を示す。
Cold-blooded concerns about duplication of work and maintainance hassles simply do not sufficiently explain the observed behavior.	作業の二重化に関する冷たい計算や、管理の面倒の話などでは、こういう観察される行動はどうしても説明できない。
Then, too, there is the third taboo.	そしてさらに、第三のタブーがある。
It's hard to see how anything but the reputation-game analysis can explain this.	これを説明するのに、評判ゲーム分析以外にはなにも想像がつかない。
The fact that this taboo is seldom analyzed much more deeply than ``It wouldn't be fair'' is revealing in its own way,	このタブーが「そんなのフェアじゃないじゃん」という以上にはほとんど分析されないということは、それ自体が示唆的だ。
as we shall see in the next section.	これについては次の章で見る。
The Problem of Ego	10　エゴの問題
At the beginning of this essay I mentioned that the unconscious adaptive knowledge of a culture is often at odds with its conscious ideology.	この論文の冒頭で、ある文化の適応結果としての知識は、その意識的なイデオロギーと相反することも多い、と書いた。
We've seen one major example of this already in the fact that Lockean ownership customs have been widely followed despite the fact that they violate the stated intent of the standard licenses.	この大きな実例として、ロック式所有権慣習が、標準ライセンスに記載された意図に違反しているにもかかわらず、広く遵守されていることを見てきた。
I have observed another interesting example of this phenomenon when discussing the reputation-game analysis with hackers.	この現象のおもしろい例が、評判ゲーム分析をハッカーたちと議論しているときにも観察できた。
This is that many hackers resisted the analysis and showed a strong reluctance to admit that their behavior was motivated by a desire for peer repute or, as I incautiously labeled it at the time, `ego satisfaction'.	多くのハッカーたちはこの分析に難色を示し、自分たちの行動が仲間内の評判への欲望、あるいはその頃ぼくが浅い考えで使っていた名称では「エゴの満足」に動機づけられていると認めたがらなかった。
This illustrates an interesting point about the hacker culture.	これは、ハッカー文化についておもしろい点を示している。
It consciously distrusts and despises egotism and ego-based motivations;	ハッカー文化は意識的にエゴ中心主義と、エゴに基づく動機づけを信用せずに軽蔑する。
self-promotion tends to be mercilessly criticized, even when the community might appear to have something to gain from it.	自己宣伝は、コミュニティがそこから何か得るものがあるように見えるときでさえ、容赦なく批判されることが多い。
So much so, in fact, that the culture's `big men' and tribal elders are required to talk softly and humorously deprecate themselves at every turn in order to maintain their status.	これがあまりに極端になっていて、ハッカー文化の「大物」や部族長老たちは自分の地位を保つためには話し方を穏やかにして、あらゆる機会をとらえてユーモアをこめて自己卑下することが要求されるようになってしまっている。
How this attitude meshes with an incentive structure that apparently runs almost entirely on ego cries out for explanation.	この態度がいかにして、明らかにほぼ完全にエゴに依存して機能するインセンティブ構造とからみあっているのかは、どうしても説明が必要となるところだ。
A large part of it, certainly, stems from the generally negative Europo-American attitude towards `ego'.	もちろんその大きな部分は、欧米の「エゴ」に対する一般的に否定的な態度からきている。
The cultural matrix of most hackers teaches them that desiring ego satisfaction is a bad (or at least immature) motivation;	多くのハッカーの文化マトリックスは、エゴの満足を求めるのは悪い（あるいは少なくとも大人げない）と教えている。
that ego is at best an eccentricity tolerable only in prima donnas and often an actual sign of mental pathology.	そしてエゴはせいぜいがプリマドンナのみに許される奇矯な代物で、精神的な病理の兆候であることすら多い、と教わっている。
Only sublimated and disguised forms like ``peer repute'', ``self-esteem'', ``professionalism'' or ``pride of accomplishment'' are generally acceptable.	これを「仲間内の評判」や「自尊心」「プロ意識」「達成感」というふうに昇華して、はじめてうけいれられるものになるんだ、と。
I could write an entire other essay on the unhealthy roots of this part of our cultural inheritance,	ぼくたちの文化的伝承のこの部分の不健全な根っこについては、全く別のエッセイを書くことだってできる。
and the astonishing amount of self-deceptive harm we do by believing (against all the evidence of psychology and behavior) that we ever have truly `selfless' motives.	あるいは、ぼくたちが真に「無私の」動機を持っている（心理と行動面でのあらゆる証拠にもかかわらず）と信じ込むことによる、自己欺瞞の害についてだって別の文章が書けるだろう。
Perhaps I would, if Friedrich Wilhelm Nietzsche and Ayn Rand had not already done an entirely competent job (whatever their other failings) of deconstructing `altruism' into unacknowledged kinds of self-interest.	書いてもいいんだが、ぼくがやるまでもなく、「愛他主義」を破壊して、はっきり意識されない自己利益に還元することについては（その他のいろんな欠点はさておき）フリードリッヒ・ヴィルヘルム・ニーチェとエイン・ランドが、きわめて立派な作業をすでに残している。
But I am not doing moral philosophy or psychology here, so I will simply observe one minor kind of harm done by the belief that ego is evil,	でもここでやってるのは道徳哲学でもなければ心理学でもないので、エゴが悪いものだという信仰から生じるちょっとした害を検討するにとどめよう。
which is this:	その害とはつまり、
it has made it emotionally difficult for many hackers to consciously understand the social dynamics of their own culture!	そのおかげで多くのハッカーたちは自分の文化の社会力学を意識的に理解することが、感情的にむずかしくなってしまったという点だ。
But we are not quite done with this line of investigation.	でも、この線での検討はまだ終わったわけじゃない。
The surrounding culture's taboo against visibly ego-driven behavior is so much intensified in the hacker (sub)culture that one must suspect it of having some sort of special adaptive function for hackers.	目に見えてエゴだけからくる行動に対するタブーは、われわれを取り巻く文化にもあるけれど、それはハッカー（サブ）カルチャーでは極端に強化されていて、だからそれがハッカーたちにとっては、なにか一種の特殊な適応上の機能があるにちがいないとしか考えられない。
Certainly the taboo is weaker (or nonexistent) among many other gift cultures, such as the peer cultures of theater people or the very wealthy.	その他多くの贈与文化、たとえば演劇人たちの同業者仲間や大金持ちの間では、このタブーはもっと弱いんだから！
The Value of Humility	11　謙虚さの美徳
Having established that prestige is central to the hacker culture's reward mechanisms, we now need to understand why it has seemed so important that this fact remain semi-covert and largely unadmitted.	ハッカー文化の報酬メカニズムにおいて名声が中心的なものだということがはっきりしたので、今度はなぜこの事実が半ば隠されて、ほとんど公認されないのが重要と思われていたのかを理解しなけりゃならない。
The contrast with the pirate culture is instructive.	海賊ソフト文化との対比は示唆的だ。
In that culture, status-seeking behavior is overt and even blatant.	この文化では、地位を求めての行動は臆面なしで、これ見よがしですらある。
These crackers seek acclaim for releasing ``zero-day warez'' (cracked software redistributed on the day of the original uncracked version's release) but are closemouthed about how they do it.	この手のクラッカーたちは、「ゼロ・デイ・warez」（クラックされていないオリジナルバージョンがリリースされたその日に、クラックされたソフトを配布すること）をリリースして評判を勝ち取ろうとするけれど、でもそのやり方については口をつぐむ。
These magicians don't like to give away their tricks.	この種の魔法使いどもは自分の小技を公開するのを嫌う。
And, as a result, the knowledge base of the cracker culture as a whole increases only slowly.	だから結果として、クラッカー文化の知識ベースはごくゆっくりとしか成長しない。
In the hacker community, by contrast, one's work is one's statement.	ハッカーコミュニティでは、それとは対照的に、ある人の成果こそがその人の主張でもある。
There's a very strict meritocracy (the best craftsmanship wins) and there's a strong ethos that quality should (indeed must) be left to speak for itself.	ここには非常に厳格な能力主義（いちばんすぐれた職人性が勝つ）があって、そして品質は自ら語るべきだ（いや、語らなくてはいけない）という倫理が強く存在している。
The best brag is code that ``just works'', and that any competent programmer can see is good stuff.	いちばんすてきな自慢は、「とにかく動く」コードであり、そして有能なプログラマならだれでもこれがいいのがわかるだろうというものだ。
Thus, the hacker culture's knowledge base increases rapidly.	だからハッカー文化の知識ベースは急速に拡大する。
The taboo against ego-driven posturing therefore increases productivity.	エゴだけに基づく態度に対するタブーは、したがって生産性を増す。
But that's a second-order effect;	でも、これは副次的な効果にすぎない。
what is being directly protected here is the quality of the information in the community's peer-evaluation system.	ここで直接守られているのは、コミュニティの同業者評価システムの中での情報の品質だ。
That is, boasting or self-importance is suppressed because it behaves like noise tending to corrupt the vital signals from experiments in creative and cooperative behavior.	つまり、大仰な自慢や夜郎自大ぶりが抑圧されているのは、それが創造的、協調的な行動におけるだいじな信号をゆがめてしまうノイズのように作用しがちだからだ。
For very similar reasons, attacking the author rather than the code is not done.	これととてもよく似た理由のために、コードではなくその著者を攻撃するということは行われない。
There is an interesting subtlety here that reinforces the point;	ここには、小さいながら大事な点があって、ぼくの論点を補強してくれる。
hackers feel very free to flame each other over ideological and personal differences,	ハッカーたちは、イデオロギー上のちがいや個人的なちがいでおたがいをフレームしあうのは、ぜんぜんかまわないと思っている。
but it is unheard of for any hacker to publicly attack another's competence at technical work	でも、どんなハッカーでも、技術的な仕事について、ほかのハッカーの有能ぶりをおおっぴらに罵倒するのは、前例がない
(even private criticism is unusual and tends to be muted in tone).	（私的な批判でさえ、あまり見られないし、あってもかなり口ごもった感じで行われる）。
Bug-hunting and criticism are always project-labeled, not person-labeled.	バグの追跡と批判は必ずプロジェクトの名前で行われ、個人の名前では行われない。
Furthermore, past bugs are not automatically held against a developer;	さらに、開発者は過去のバグのことで自動的に責められたりはしない。
the fact that a bug has been fixed is generally considered more important than the fact that one used to be there.	バグが修正されたということのほうが、そのバグがかつて存在したということよりも重要だと一般には考えられている。
As one respondent observed, one can gain status by fixing `Emacs bugs', but not by fixing `Richard Stallman's bugs'	ある評者が述べたように、「Emacsのバグ」を直すことで自分の評判をあげる人はいるけれど「リチャード・ストールマンのバグ」をなおして評判を上げる人はいない
?and it would be considered extremely bad form to criticize Stallman for old Emacs bugs that have since been fixed.	――そしてストールマンを批判するのに、修正済みの古いバグを根拠にするのは、とてもよくないこととされるだろう。
This makes an interesting contrast with many parts of academia,	これは、アカデミズムの多くの部分ととてもおもしろい対照ぶりを示している。
in which trashing putatively defective work by others is an important mode of gaining reputation.	アカデミズムでは、欠陥があると思われる他人の成果をボロクソにするのは、評判を勝ち取る重要な方法の一つだ。
In the hacker culture, such behavior is rather heavily tabooed	ハッカー文化では、こうした行動はいささか強力にタブー視されている
?so heavily, in fact, that the absence of such behavior did not present itself to me as a datum	――それが強力すぎるために、そういう行動が存在しないということを、ぼく自身が思いつかなかったほどだ。
until that one respondent with an unusual perspective pointed it out nearly a full year after this essay was first published!	ちょっと変わった視点を持つ評者が、本論文発表から1年以上たって指摘してくれて、やっとはっきり気がついたほどだ！
The taboo against attacks on competence (not shared with academia) is even more revealing than the (shared) taboo on posturing,	能力に対する攻撃に関するタブー（アカデミズムとは異なる）は、威張ることについての（アカデミズムと共有された）タブーよりさらに多くを物語ってくれる。
because we can relate it to a difference between academia and hackerdom in their communications and support structures.	ハッカー世界とアカデミズム世界での、コミュニケーションのあり方のちがいや支持構造のちがいについて考えるとき、これが足がかりになるからだ。
The hacker culture's medium of gifting is intangible, its communications channels are poor at expressing emotional nuance,	ハッカー文化の贈与メディアは実体がなく、そこで使われるコミュニケーションの回線は感情的なニュアンスを表現するには乏しい。
and face-to-face contact among its members is the exception rather than the rule.	メンバー間のフェイス・トゥ・フェイスの接触は、例外的な現象であるほうが多い。
This gives it a lower tolerance of noise than most other gift cultures, and goes a long way to explain both the taboo against posturing and the taboo against attacks on competence.	このため、ノイズに対する許容度はほかの贈与文化よりかなり低いし、これで能力に関する攻撃についてのタブー、かなりよく説明できるだろう。
Any significant incidence of flames over hackers' competence would intolerably disrupt the culture's reputation scoreboard.	ハッカーたちの能力についてのフレーム事例は、この文化の評判スコアボードを許容できないくらい乱すものなんだ。
The same vulnerability to noise explains the model of public humility required of the hacker community's tribal elders.	同じようなノイズに対する脆弱さは、ハッカーコミュニティの部族の長老たちに要求される、公的な場での謙虚さも説明してくれる。
They must be seen to be free of boast and posturing	長老たちは、傲慢さや尊大さに冒されていないと見られなくてはならない。
so the taboo against dangerous noise will hold. [DC]	そうしないと、危険なノイズに対するタブーが維持されないからだ。[DC]
Talking softly is also functional if one aspires to be a maintainer of a successful project;	あたりが柔らかいのは、うまくいくプロジェクトの管理者になりたいときにも役に立つ。
one must convince the community that one has good judgement,	その人は、自分がよい判断力を持っているとコミュニティに納得させなくてはならない。
because most of the maintainer's job is going to be judging other people's code.	管理者の仕事のほとんどは、ほかの人のコードを判断する作業だからだ。
Who would be inclined to contribute work to someone who clearly can't judge the quality of their own code,	自分たちのコードの質が明らかに理解できないような人物に、自分の作業を貢献しようと思うやつはいない。
or whose behavior suggests they will attempt to unfairly hog the reputation return from the project?	あるいは、プロジェクトの評判という収益を不公平に着服しようとしそうな行動がうかがえるようなヤツに？
Potential contributors want project leaders with enough humility and class	潜在的な貢献者たちとしては、プロジェクトリーダに十分な謙虚さと気高さを求める。
to be able to to say, when objectively appropriate,	そして客観的にみて正しいときにはこういえる人物であってほしい：
``Yes, that does work better than my version,	「うん、たしかにそれは、ぼくのバージョンよりうまく動く。
I'll use it''	そっちを使おう」
?and to give credit where credit is due.	そしてその際には、しかるべきところにクレジットを与えてくれる人物であってほしいんだ。
Yet another reason for humble behavior is that in the open source world, you seldom want to give the impression that a project is `done'.	オープンソース界での謙虚な行動の理由としてもう一つあるのは、プロジェクトが「終わった」という印象をなるべく与えたくない、ということがある。
This might lead a potential contributor not to feel needed.	そんな印象ができたら、潜在的な貢献者は、自分が必要とされていないような気分になるかもしれない。
The way to maximize your leverage is to be humble about the state of the program.	自分の力を最大化しておくには、プログラムの現状について慎ましい態度をとることだ。
If one does one's bragging through the code, and then says	自慢はコード自身にさせておいて、口では
``Well shucks, it doesn't do x, y, and z, so it can't be that good'',	「ああちくしょう、このソフトはまだ x も y も z もできない、まだぜんぜんダメだ」と言えば、
patches for x, y, and z will often swiftly follow.	x、y、z 用のパッチはすぐに出てくることが多い。
Finally, I have personally observed that the self-deprecating behavior of some leading hackers reflects a real (and not unjustified) fear of becoming the object of a personality cult.	最後にぼくは個人的に、一部の代表的ハッカーたちの自己卑下行動は、個人崇拝の対象となることに対する本物の（そして正当でなくはない）おそれからきているのを観察してきた。
Linus Torvalds and Larry Wall both provide clear and numerous examples of such avoidance behavior.	リーヌス・トーヴァルズとラリー・ウォールはどちらも、こうした忌避のはっきりした例をたくさん提供してくれる。
Once, on a dinner expedition with Larry Wall, I joked	まえにラリー・ウォールと夕食にでかけたとき、ぼくはこう冗談をたたいた。
``You're the alpha hacker here	「ここで最高のハッカーはきみだ
?you get to pick the restaurant''.	――だからきみがレストランを選んでくれ」
He flinched noticeably.	するとかれは、はっきりとたじろいだ。
And rightly so;	もっともな話だ。
failing to distinguish their shared values from the personalities of their leaders has ruined a good many voluntary communities,	共有した価値と、リーダの価値観とを区別できなくなったことで、ダメになってしまったコミュニティは多い。
a pattern of which Larry and Linus cannot fail to be fully aware.	このパターンについて、かれもリーヌスも思い知っているはずだ。
On the other hand, most hackers would love to have Larry's problem,	一方で、多くのハッカーはラリーの問題を自分も抱えてみたいものだと思うだろう。
if they could but bring themselves to admit it.	それを自分で認める勇気があればだけれど。
Global Implications of the Reputation-Game Model	12　評判ゲームモデルが持つ分野全体としての意義
The reputation-game analysis has some more implications that may not be immediately obvious.	評判ゲーム分析は、一見するとわかりにくいかもしれない含蓄をもっと持っている。
Many of these derive from the fact that one gains more prestige from founding a successful project than from cooperating in an existing one.	その多くは、既存のプロジェクトに協力するより成功プロジェクトを創始するほうが名声が高まるという事実から派生するものだ。
One also gains more from projects that are strikingly innovative, as opposed to being `me, too' incremental improvements on software that already exists.	また、既存のプロジェクトをだんだん改善させるような、「おれもおれも」式改良よりは、感動するほど独創的なプロジェクトのほうがポイントを稼ぎやすい。
On the other hand, software that nobody but the author understands or has a need for is a non-starter in the reputation game, and it's often easier to attract good notice by contributing to an existing project than it is to get people to notice a new one.	一方で作者以外のだれにも理解できない、あるいは作者にしかニーズのないソフトは、評判ゲームでは何の役にもたたないし、みんなに新しいプロジェクトを認識してもらうよりは、既存プロジェクトに貢献したほうが、高いポイントを稼ぎやすい。
Finally, it's much harder to compete with an already successful project than it is to fill an empty niche.	最後に、空っぽのニッチを埋めるよりは、すでに成功しているプロジェクトと競合するほうがずっとむずかしい。
Thus, there's an optimum distance from one's neighbors (the most similar competing projects).	したがって、ご近所（いちばん近い競合プロジェクト）からの最適な距離ってものがある。
Too close and one's product will be a ``me, too!'' of limited value, a poor gift	近すぎればその成果物は「おれもおれも！」式の価値の低いものとなり、贈り物としては弱い
(one would be better off contributing to an existing project).	（それなら既存プロジェクトに貢献する方がいい）。
Too far away, and nobody will be able to use, understand, or perceive the relevance of one's effort	あまりに離れすぎていたら、だれもその努力を利用できず、理解できず、そして重要性を理解することもできなくなる
(again, a poor gift).	（これまた贈り物としては弱い）。
This creates a pattern of homesteading in the noosphere that rather resembles that of settlers spreading into a physical frontier	これは、ノウアスフィアの開墾パターンの面で、物理的なフロンティアに散らばって入植する入植者たちといささか似たような光景をつくりだす
?not random, but like a diffusion-limited fractal.	――ランダムではないが、散らばりかたの限られたフラクタルの波のようなパターンだ。
Projects tend to get started to fill functional gaps near the frontier	プロジェクトは、フロンティア近くの機能的ギャップを埋めようとして創始される傾向が強い
(see [NO] for further discussion of the lure of novelty).	（目新しさの誘惑に関する追加の議論については[NO]を見てほしい）。
Some very successful projects become `category killers';	一部のすごく成功したプロジェクトは「カテゴリーキラー」となる。
nobody wants to homestead anywhere near them	だれもその近くを開墾したいとは思わない。
because competing against the established base for the attention of hackers would be too hard.	確立された基盤とはりあって、ハッカーたちの関心を求めるのはむずかしすぎるからだ。
People who might otherwise found their own distinct efforts end up, instead, adding extensions for these big, successful projects.	そうでなければ独自のプロジェクトを創始するような人たちは、かわりに大きな成功したプロジェクトに拡張を加えるにとどまる。
The classic `category killer' example is GNU Emacs;	古典的な「カテゴリーキラー」の例は GNU Emacs だ。
its variants fill the ecological niche for a fully-programmable editor so completely that no competitor has gotten much beyond the one-man project stage since the early 1980s.	その変種は、完全にプログラム可能なエディタの生態ニッチをあまりに完璧に埋めてしまったので、だれも 1980 年代初期以来、まったく異なるデザインなど試してみようとすらしない。
Instead, people write Emacs modes.	かわりにそういう人は、Emacs のモードを書くんだ。
Globally, these two tendencies (gap-filling and category-killers) have driven a broadly predictable trend in project starts over time.	全体的にみて、この二つの傾向（ギャップ埋めとカテゴリーキラー）のおかげで、時代を追うにつれてのプロジェクト開始傾向、おおむね予想がつく。
In the 1970s most of the open source that existed was toys and demos.	1970 年代に出回っていたほとんどのオープンソースはおもちゃとデモだった。
In the 1980s the push was in development and Internet tools.	1980 年代には、開発ツールとインターネットツールが主流。
In the 1990s the action shifted to operating systems.	そして 1990 年代になると、中心は OS に移った。
In each case, a new and more difficult level of problems was attacked when the possibilities of the previous one had been nearly exhausted.	いずれの場合にも、それ以前の分野の可能性がほとんど尽きてしまって、新しいもっと難しいレベルの問題に矛先が移っている。
This trend has interesting implications for the near future.	このトレンドは、近未来にとっておもしろい意味を持っている。
In early 1998, Linux looks very much like a category-killer for the niche `open-source operating systems'	1998 年頭には、Linux はどうやら「フリー OS」というニッチにとってカテゴリーキラーとなったような感じだ
?people who might otherwise write competing operating systems are now writing Linux device drivers and extensions instead.	――かつてなら競合 OS を書いたかもしれない人たちは、いまでは Linux のデバイスドライバや拡張を書いている。
And most of the lower-level tools the culture ever imagined having as open source already exist.	そしてこの文化がこれまで想像してきたようなローレベルのツールは、ほとんどすべてオープンソースで存在している。
What's left?	あとはなにが残っているだろう？
Applications.	アプリケーションだ。
As the third millenium begins, it seems safe to predict that open-source development effort will increasingly shift towards the last virgin territory	2000 年が近づくにつれて、オープンソース開発がますます最後の処女地に向かってシフトすると予言してもよさそうだ。
?programs for non-techies.	その処女地とはすなわち、技術オンチのためのプログラムだ。
A clear early indicator was the development of GIMP,	はっきりした最初のしるしとしては、GIMPの開発がある。
the Photoshop-like image workshop that is open source's first major application with the kind of end-user?friendly GUI interface considered de rigueur in commercial applications for the last decade.	これはフォトショップに似た画像処理ソフトで、過去 10 年には商業アプリケーションの独壇場と思われていた、エンドユーザにやさしい GUI を持っている。
Another is the amount of buzz surrounding application-toolkit projects	別の示唆としては、アプリケーション用ツールキットのプロジェクトを取り巻いているにぎやかさが指摘できるだろう。
like KDE and GNOME.	KDE や GNOME なんかだ。
A respondent to this essay has pointed out that the homesteading analogy also explains why hackers react with such visceral anger to Microsoft's ``embrace and extend'' policy of complexifying and then closing up Internet protocols.	この論文の評者の一人は、開墾のアナロジーを使うことで、ハッカーたちがなぜマイクロソフトの「抱き込んで拡張」方針、つまりインターネットプロトコルを複雑化して閉じたものにしてしまおうという方針に対し、なぜあれほど露骨な怒りをもって反応するのか、ということが説明できることを指摘している。
The hacker culture can coexist with most closed software;	ハッカー文化はほとんどのクローズドなソフトと共存できる。
the existence of Adobe Photoshop, for example, does not make the territory near GIMP (its open-source equivalent) significantly less attractive.	たとえば Adobe Photoshop があっても、そのオープンソース版とも言うべき GIMP 周辺の領域が極端に魅力がなくなるわけではない。
But when Microsoft succeeds at de-commoditizing [HD] a protocol so that only Microsoft's own programmers can write software for it, they do not merely harm customers by extending their monopoly;	でも、マイクロソフトがプロトコルを「脱・共有化」[HD]してしまって、マイクロソフト自身のプログラマしかそれを使うソフトが書けないようにしてしまったら、マイクロソフトは単に独占を拡大して顧客に害を与えるだけではすまない。
they also reduce the amount and quality of noosphere available for hackers to homestead and cultivate.	ハッカーたちが開墾して耕作すべきノウアスフィアの量と質を低下させることにもなる。
No wonder hackers often refer to Microsoft's strategy as ``protocol pollution'';	ハッカーたちがマイクロソフトの戦略を「プロトコル汚染」と呼ぶのも当然だろう。
they are reacting exactly like farmers watching someone poison the river they water their crops with!	かれらは、自分の農業用水に毒を入れようとしている人を見つけた農夫たちとまったく同じ反応を示しているわけだ！
Finally, the reputation-game analysis explains the oft-cited dictum that you do not	最後に、評判ゲーム分析はよく挙げられる格言を説明してくれる。
become a hacker by calling yourself a hacker	人はハッカーを名乗ればハッカーになれるわけじゃない
?you become a hacker when other hackers call you a hacker [KN].	――ほかのハッカーにハッカーと呼ばれた時点で、人はハッカーになるんだ。
A `hacker', considered in this light, is somebody who has shown (by contributing gifts) that he or she both has technical ability and understands how the reputation game works.	この観点から見た「ハッカー」というのは、技術的な能力を持っていて、しかも評判ゲームがどう機能するかわかっているということを（贈り物を提供することで）実証した人間だ。
This judgement is mostly one of awareness and acculturation, and can be delivered only by those already well inside the culture.	この判断は、おもに認知と文化順応に基づくもので、すでにこの文化の中にしっかり入った人々からしか与えられない。
How Fine a Gift?	13　どれほどすばらしい贈り物？
There are consistent patterns in the way the hacker culture values contributions and returns peer esteem for them.	ハッカー文化が貢献を評価して、それに対する仲間内の評判を戻すやり方には、一貫したパターンがある。
It's not hard to observe the following rules:	以下のような規則はすぐに見分けられる：
1. If it doesn't work as well as I have been led to expect it will, it's no good	1. 期待させられたほどきちんと機能しないなら、それはダメ
?no matter how clever and original it is.	――どんなに巧妙でオリジナリティ豊かなものであっても。
Note the phrase `led to expect'.	「期待させられたほど」という部分に注意。
This rule is not a demand for perfection;	このルールは、完全無欠を求めるものではない。
beta and experimental software is allowed to have bugs.	ベータ版や実験ソフトには、もちろんバグがあってもいい。
It's a demand that the user be able to accurately estimate risks from the stage of the project and the developers' representations about it.	これは、プロジェクトの段階や開発者の主張をもとに、リスクを正確に評価できるようにしろ、と求めているわけだ。
This rule underlies the fact that open-source software tends to stay in beta for a long time, and not get even a 1.0 version number until the developers are very sure it will not hand out a lot of nasty surprises.	このルールのおかげで、オープンソースソフトはずいぶん長い間ベータ版のままになっていて、とんでもないバグがぼろぼろ出てきたりしない、というのを開発者が革新するまで、バージョン 1.0 を名乗ったりしない、という現象が見られる。
In the closed-source world, Version 1.0 means ``Don't touch this if you're prudent.'';	クローズドソースの世界では、バージョン 1.0 というのは、「慎重な人は手を出しちゃダメよ」という意味だ。
in the open-source world it reads something more like ``The developers are willing to bet their reputations on this.''	オープンソースの世界では、むしろ「開発者たちはこいつに自分の評判を賭けてもいいと思っています」というのに近い。
2. Work that extends the noosphere is better than work that duplicates an existing piece of functional territory.	2. 既存の機能する領域を複製する作業よりは、ノウアスフィアを拡張する仕事のほうがいい。
The naive way to put this would have been:	こいつをもっと素朴に表現するなら、
Original work is better than mere duplication of the functions of existing software.	「独創的な作業は、既存ソフトの機能を複製するよりもいい」ということになるだろう。
But it's not actually quite that simple.	でも、実はこんなに単純ではない。
Duplicating the functions of existing closed software counts as highly as original work	既存のクローズドなソフトの機能を複製するのは、オリジナルなソフトの開発作業と同じくらい高い評価が得られる
if by doing so you break open a closed protocol or format and make that territory newly available.	――それによって、クローズドなプロトコルやフォーマットをこじあけたりして、その領土を新たに提供できるのであれば。
Thus, for example, one of the highest-prestige projects in the present open-source world is Samba	だからたとえば、いまのオープンソース世界でいちばんプレステージの高いプロジェクトは、Samba だ
?the code that allows Unix machines to act as clients or servers for Microsoft's proprietary SMB file-sharing protocol.	―― Unix マシンがマイクロソフトの独占ファイル共有プロトコル SMB のクライアントまたはサーバとして使えるようにするコード。
There is very little creative work to be done here;	創造的な仕事はほとんどない。
it's mostly an issue of getting the reverse-engineered details right.	むしろ細かいリバースエンジニアリングの細部をうまくやるのが一番の問題だ。
Nevertheless, the members of the Samba group are perceived as heroes	それでも、Samba グループは英雄視されている。
because they neutralize a Microsoft effort to lock in whole user populations and cordon off a big section of the noosphere.	ユーザ集団をまるごと囲い込んで、ノウアスフィアの大きな部分に縄を張ってしまおうというマイクロソフトの努力を無化するものだからだ。
3. Work that makes it into a major distribution is better than work that doesn't.	3. 主要ディストリビューションに含まれるものは、そうでないものよりもいい。
Work carried in all major distributions is most prestigious.	主要ディストリビューションすべてに含まれるものがいちばんえらい。
The major distributions include not just the big Linux distributions like Red Hat, Debian, Caldera, and SuSE., but other collections that are understood to have reputations of their own to maintain and thus implicitly certify quality	ここでの主要ディストリビューションというのは、Red Hat、Debian、Caldera、S.u.S.E. など Linux の大手ディストリビューションのみならず、独自の評判を持っていて、したがって品質を裏書きできると思われているその他のコレクションすべてを含んでいる
?like BSD distributions or the Free Software Foundation source collection.	――たとえば BSD ディストリビューションや、FSF のソースコレクションなど。
4. Utilization is the sincerest form of flattery	4. 利用は最大の賛辞
?and category killers are better than also-rans.	――そしてカテゴリーキラーは追随ソフトよりもよい。
Trusting the judgment of others is basic to the peer-review process.	他人の判断を信用するというのは、同業者（ピア）レビューのプロセスの基本だ。
It's necessary because nobody has time to review all possible alternatives.	これが必要なのは、だれもあらゆる代替ソフトをすべてレビューするだけの暇はないからだ。
So work used by lots of people is considered better than work used by a few,	だから、多くの人が使っているソフトは、少数の人しか使っていないソフトよりもいいとされる。
To have done work so good that nobody cares to use the alternatives any more is therefore to have earned huge prestige.	あまりにできがよくて、ほかの代替品をだれも使おうとしなくなるような仕事をするというのは、だからすさまじいプレステージを獲得することになる。
The most possible peer esteem comes from having done widely popular, category-killing original work that is carried by all major distributions.	最大の同業者評価を獲得するには、非常に人気のあるカテゴリーキラーとなった独創的な作業が、すべての主要ディストリビューションに含まれるようになることだ。
People who have pulled this off more than once are half-seriously referred to as `demigods'.	これを一度ならず行った人間は、半ば冗談まじりで「半神半人」（demigods）と呼ばれる。
5. Continued devotion to hard, boring work (like debugging, or writing documentation) is more praiseworthy than cherrypicking the fun and easy hacks.	5. むずかしくて退屈な作業（たとえばデバッグやドキュメンテーション書き）に継続的に貢献するのは、おもしろくて簡単なハックをいいとこ取りするよりも賞賛すべきことである。
This norm is how the community rewards necessary tasks that hackers would not naturally incline towards.	この規範によって、ハッカーたちが通常はやりたがらないけれど必要な仕事について、コミュニティは見返りを支払うわけだ。
It is to some extent contradicted by:	でもこれは、次のルールとはちょっと矛盾している：
6. Nontrivial extensions of function are better than low-level patches and debugging.	6. 機能の大幅な（non-trivialな）拡張は、低レベルのパッチやデバッグよりもいい。
The way this seems to work is	これがどう機能するかというと、こういうことらしい：
that on a one-shot basis, adding a feature is likely to get more reward than fixing a bug	一発だけで見た場合、機能を追加するほうがバグ取りよりも見返りが大きい
?unless the bug is exceptionally nasty or obscure, such that nailing it is itself a demonstration of unusual skill and cleverness.	――ただしバグが極端にてごわかったり見つけにくかったりして、それを仕留めること自体が非凡なスキルや賢さを示すのでない限り。
But when these behaviors are extended over time, a person with a long history of paying attention to and nailing even ordinary bugs may well out-rank someone who has spent a similar amount of effort adding easy features.	でも、こうした行動が長い期間にまたがると、長いこと注意を払って、ごくつまらないバグでもつぶしていく人は、同じ努力をかけて簡単な機能の追加をしてきた人よりも高い地位につけるわけだ。
A respondent has pointed out that these rules interact in interesting ways and do not necessarily reward highest possible utility all the time.	ある評者が指摘したことだけれど、こうしたルールはおもしろい形で相互作用して、いつの時点でも最大の効用が報われるようには必ずしもなっていない。
Ask a hacker whether he's likely to become better known for a brand new tool of his own or for extensions to someone else's and the answer ``new tool'' will not be in doubt.	ハッカーに、独自の新しいツールを開発するのと、だれか別の人のツールの拡張と、どっちで有名になる見込みが高いかときいたら、答えはまちがいなく「新しいツール」になるだろう。
But ask about	でも、次の二つならどうだろう。
(a) a brand new tool which is only used a few times a day invisibly by the OS but which rapidly becomes a category killer, versus	一日ほんの数回、だれにもわからない形で OS から呼び出されるだけの真新しいツールだけれど、急速にカテゴリーキラーになるもの
(b) several extensions to an existing tool which are neither especially novel nor category-killers,	ことさら新しくもないしカテゴリーキラーでもない既存ツールに対する拡張をいくつか。
but are daily used and daily visible to a huge number of users	ただしそのツールは、毎日使われて、毎日多くの人の目に直接触れる
and you are likely to get some hesitation before the hacker settles on (a).	この場合、ハッカーは最終的に前者に落ち着くにしても、かなりためらうはずだ。
These alternatives are about evenly stacked.	この両者は、だいたい同じくらいの地位を持っている。
Said respondent gave this question point for me by adding	これを指摘した評者は、以下のような一言を付け加えて、ぼくに対して論点を強調した。
``Case (a) is fetchmail;	「前者の例は、fetchmail で、
case (b) is your many Emacs extensions, like vc.el and gud.el.''	後者の例はあなたの場合、vc.el や gud.el など各種のEmacs拡張です」
And indeed he is correct;	たしかにかれの言うとおり。
I am more likely to be tagged ``the author of fetchmail'' than ``author of a boatload of Emacs modes'',	ぼくは「各種のEmacsモードの著者」と言われるよりは、「fetchmail 作者」と言われるほうが多い。
even though the latter probably have had higher total utility over time.	長期的に見れば、Emacs モードのほうが効用の合計では大きいにちがいないのだけれど。
What may be going on here is simply that work with a novel `brand identity' gets more notice than work aggregated to an existing `brand'.	ここで起きているのは、真新しい「ブランドアイデンティティ」を持つ仕事は、既存「ブランド」に集積する仕事よりも認知度が高い、ということにすぎないのかもしれない。
Elucidation of these rules, and what they tell us about the hacker culture's scoreboarding system, would make a good topic for further investigation.	こうしたルールのさらなる解明と、それがハッカー文化の得点集計システムについてどんなことを物語るのかは、今後の研究課題として有望だろう。
Noospheric Property and the Ethology of Territory	14　ノウアスフィア的所有権となわばりの動物行動学
To understand the causes and consequences of Lockean property customs, it will help us to look at them from yet another angle;	土地所有権の慣習がなにをもたらすか理解するには、もう一つ別の角度から見てみると役にたつ。
that of animal ethology, specifically the ethology of territory.	動物行動学、とくになわばりの行動学だ。
Property is an abstraction of animal territoriality, which evolved as a way of reducing intraspecies violence.	所有地は、動物のなわばりの抽象化で、なわばりは種の内部の暴力を減らすための手段としてうまれた。
By marking his bounds, and respecting the bounds of others, a wolf diminishes his chances of being in a fight	境界をしるし、ほかの仲間の境界を尊重することで、オオカミは争いを始める機会を減らす。
that could weaken or kill him and make him less reproductively successful.	そういう争いで自分がけがをしたり殺されたりするかもしれず、そうなったら自分が再生産面で成功する可能性が低下するからだ。
Similarly, the function of property in human societies is to prevent inter-human conflict by setting bounds that clearly separate peaceful behavior from aggression.	同じように、人間社会における「所有物」の概念は、平和な行動と抗争とをはっきりわけるような境界をもうけることで、人間同士の紛争を予防するのが機能だ。
It is fashionable in some circles to describe human property as an arbitrary social convention, but this is dead wrong.	人間の所有物なんて、ただの恣意的な社会的因襲にすぎないと表現するのはファッショナブルだったりするけれど、でもこれはとことんまちがっている。
Anybody who has ever owned a dog who barked when strangers came near its owner's property	犬を飼ったことがある人で、知らない人が飼い主の所有物に近づいたときに犬が吠えたのを経験した人は多いだろう。
has experienced the essential continuity between animal territoriality and human property.	そういう人ならみんな、動物のなわばり性と人間の所有物との本質的な連続性を経験しているはずだ。
Our domesticated cousins of the wolf know, instinctively, that property is no mere social convention or game,	ぼくたちが家畜化した狼のいとこ分たちは、この点について人間の政治理論家たちの多くより本能的に賢いんだ。
but a critically important evolved mechanism for the avoidance of violence.	所有権を主張すること（なわばりをマーキングするように）は、それを演じてみせることが重要で、
Claiming property (like marking territory) is a performative act, a way of declaring what boundaries will be defended.	その境界を守るぞという宣言だ。
Community support of property claims is a way to minimize friction and maximize cooperative behavior.	所有権主張に対するコミュニティの支援は、摩擦をへらして協力行動を最大化するための方法だ。
These things remain true even when the ``property claim'' is much more abstract than a fence or a dog's bark, even when it's just the statement of the project maintainer's name in a README file.	これは「所有権主張」が README ファイルのプロジェクト管理者の名前記述のように、柵や吠える犬よりずっと抽象的な場合でも成立する。
It's still an abstraction of territoriality, and (like other forms of property) based in territorial instincts evolved to assist conflict resolution.	それはやっぱりなわばりを抽象化したもので、（その他所有権の形態と同じく）ぼくたちの本能に基づく所有権モデルは、なわばりが発達して紛争解決に役立つようになったものなんだ。
This ethological analysis may at first seem very abstract and difficult to relate to actual hacker behavior.	この動物行動学的な分析は、一見するとすごく抽象的で、実際のハッカー行動と結びつけるのは難しそうだ。
But it has some important consequences.	でもこれはすごく大事な意味を持っている。
One is in explaining the popularity of World Wide Web sites,	一つは World Wide Web のサイトの普及ぶりを説明することだ。
and especially why open-source projects with websites seem so much more `real' and substantial than those without them.	特に、なぜ web サイトを持ったオープンソース・プロジェクトが、ないものよりずっと「本物」らしくて重要に見えるのか、という点。
Considered objectively, this seems hard to explain.	客観的に見れば、これは説明がむずかしい。
Compared to the effort involved in originating and maintaining even a small program, a web page is easy,	ほんの小さなプログラムであっても、それを創始して管理するための努力に比べれば、web ページなんかばかみたいに簡単だ。
so it's hard to consider a web page evidence of substance or unusual effort.	だから web ページが内容の高さや非凡な努力の証拠だとは考えにくい。
Nor are the functional characteristics of the Web itself sufficient explanation.	Web そのものの機能的な特徴だけでも、説明としては不十分だ。
The communication functions of a web page can be as well or better served by a combination of an FTP site, a mailing list, and Usenet postings.	web ページのコミュニケーション機能は、FTP とメーリングリストと Usenet ポストとの組み合わせでも同じくらい、あるいはもっとうまく提供できるものだ。
In fact it's quite unusual for a project's routine communications to be done over the Web rather than via a mailing list or newsgroup.	実際問題として、プロジェクトの日々の連絡が、メーリングリストや Usenet のポストではなく Web で行われるというのはあまり例がない。
Why, then, the popularity of websites as project homes?	それなら、なぜプロジェクトのホームとして web サイトに人気があるんだろう。
The metaphor implicit in the term `home page' provides an important clue.	「ホームページ」という用語に含まれたメタファーがだいじなヒントを提供してくれる。
While founding an open-source project is a territorial claim in the noosphere (and customarily recognized as such) it is not a terribly compelling one on the psychological level.	オープンソースプロジェクトの創始は、ノウアスフィアにおける領土を宣言することだけれど（そしてふつうはそのように認識されてはいるけれど）、でも心理的なレベルからいえば、それだけではあまり説得力はない。
Software, after all, has no natural location and is instantly reduplicable.	ソフトウェアは結局のところ自然の場所もないし、すぐに複製可能だからだ。
It's assimilable to our instinctive notions of `territory' and `property', but only after some effort.	「領土」や「所有物」という本能的な考えに適合しないわけではないけれど、でもそれにはしかるべき努力が必要になる。
A project home page concretizes an abstract homesteading in the space of possible programs by expressing it as `home' territory in the more spatially-organized realm of the World Wide Web.	プロジェクトのホームページは、比較的空間的に組織された World Wide Web の世界で「故郷」領土として宣言を行うことにより、可能なプログラムの空間の抽象的な開墾を具体化するものなんだ。
Descending from the noosphere to `cyberspace' doesn't get us all the way to the real world of fences and barking dogs yet, but it does hook the abstract property claim more securely to our instinctive wiring about territory.	ノウアスフィアから「サイバースペース」におりてきても、柵や吠える番犬の現実世界まではまだ距離があるけれど、でも抽象的な領土主張をもっと直感的ななわばり理解に結びつけてはくれる。
And this is why projects with web pages seem more `real'.	だからこそ、Web ページを持ったプロジェクトはもっと「本物」に感じられるんだ。
This point is much strengthened by hyperlinks and the existence of good search engines.	この論点は、ハイパーリンクや高性能サーチエンジンの存在で一層強化される。
A project with a web page is much more likely to be noticed by somebody exploring its neighborhood in the noosphere;	Web ページを持つプロジェクトは、ノウアスフィアで近所を探検している人にずっと認知されやすい。
others will link to it, searches will find it.	リンクする人もいるだろうし、サーチエンジンにもひっかかる。
A web page is therefore a better advertisement, a more effective performative act, a stronger claim on territory.	Web ページは、だから広告としても優れているし、パフォーマンス行為としても有効だし、領土主張としても強力だ。
This ethological analysis also encourages us to look more closely at mechanisms for handling conflict in the open-source culture.	この動物行動学的な分析は、オープンソース文化での紛争処理メカニズムをもっと詳しく見るよう示唆するものでもある。
It leads us to expect that, in addition to maximizing reputation incentives, ownership customs should also have a role in preventing and resolving conflicts.	これが正しければ、所有権慣習は評判インセンティブを最大化するだけでなく、紛争の防止と解決にもなんらかの役割を果たしていると考えていいはずだからだ。
Causes of Conflict	15　紛争の原因
In conflicts over open-source software we can identify four major issues:	オープンソース・ソフトをめぐる紛争の理由としては、次の４つの大きな問題を指摘できる：
Who gets to make binding decisions about a project?	だれがプロジェクトについて決定力のある決断をくだすのか？
Who gets credit or blame for what?	だれがなにについて、評価や非難を受けるのか？
How to reduce duplication of effort and prevent rogue versions from complicating bug tracking?	二度手間をさけて、非公式版がでてバグ追跡をややこしくするのを止めるにはどうするか？
What is the Right Thing, technically speaking?	技術的に見たら、なにが正しいことだったのか？
If we take a second look at the ``What is the Right Thing'' issue, however, it tends to vanish.	でもこの「技術的な正しさ」という点についてよく考えてみると、これは問題にはならない。
For any such question, either there is an objective way to decide it accepted by all parties or there isn't.	この手の問題には必ず、万人が納得する客観的な決定方法があるか、あるいはないかのどっちかだからだ。
If there is, game over and everybody wins.	もしそれがあれば、話はそこでおしまいでみんな勝つ。
If there isn't, it reduces to ``Who decides?''.	もしないのなら、それは「だれが決めるんだ？」という話に還元される。
Accordingly, the three problems a conflict-resolution theory has to resolve about a project are	同じように、紛争解決理論がプロジェクトについて解決しなくてはならない三つの問題は
(a) where the buck stops on design decisions,	(A) 設計上の決断を下すときに最終的な采配を下すのはだれか、
(b) how to decide which contributors are credited and how,	(B) どの貢献者がどのようにクレジットされるかをどう決めるか、
and (c) how to keep a project group and product from fissioning into multiple branches.	(C) プロジェクトグループやその成果物が複数に枝分かれして分裂するのをどう防ぐか、となる。
The role of ownership customs in resolving issues (a) and (c) is clear.	問題(A) と（C）の解決のために所有権慣習の果たす役割ははっきりしている。
Custom affirms that the owners of the project make the binding decisions.	習慣により、プロジェクトの所有者こそが方向を左右する決定を下すことが認められる。
We have previously observed that custom also exerts heavy pressure against dilution of ownership by forking.	そしてプロジェクト分裂による勢力の希薄化に対しては、慣習が強い圧力をかけることはこれまで見た通り。
It's instructive to notice that these customs make sense even if one forgets the reputation game and examines them from within a pure `craftmanship' model of the hacker culture.	ここで、評判ゲームは忘れてこれをハッカー文化についての純粋な「職人気質」モデルから見た場合にも、こうした慣習は筋が通っていることは認識しておくといいだろう。
In this view these customs have less to do with the dilution of reputation incentives than with protecting a craftsman's right to execute his vision in his chosen way.	この見方では、こうした慣習は評判インセンティブの希薄化よりはむしろ、職人が自分のビジョンを自分の選ぶ形で実行するという職人の権利を守ることを重視していることになる。
The craftsmanship model is not, however, sufficient to explain hacker customs about issue (b), who gets credit for what	職人モデルは、問題（B）「だれがなにについてクレジットを与えられるか」についてのハッカー慣習を説明するには十分ではない
?because a pure craftsman, one unconcerned with the reputation game, would have no motive to care.	（だって、純粋な職人は評判ゲームなんか気にしないから、そんなことを気にする動機がない）。
To analyze these, we need to take the Lockean theory one step further and examine conflicts and the operation of property rights within projects as well as between them.	これを分析するには、ロック理論をもう一歩進めて、所有権上の抗争や運用がどう行われているかをプロジェクト同士だけでなく、プロジェクト内部から見てやらなくてはならない。
Project Structures and Ownership	16　プロジェクト構造と所有権
The trivial case is that in which the project has a single owner/maintainer.	簡単な例は、プロジェクトの所有者・管理者が一人しかいない場合だ。
In that case there is no possible conflict.	この場合、紛争は起こり得ない。
The owner makes all decisions and collects all credit and blame.	所有者がすべての決定をくだして、賞賛も批判もすべて自分で背負う。
The only possible conflicts are over succession issues	紛争として唯一あり得るのは引き継ぎ問題だけだ
?who gets to be the new owner if the old one disappears or loses interest.	――もとの所有者がいなくなったり興味をなくしたりした場合、だれが新しい所有者になるのか。
The community also has an interest, under issue (c), in preventing forking.	コミュニティとしても、問題(C)から、プロジェクトの分裂を避けたいと考える。
These interests are expressed by a cultural norm that an owner/maintainer should publicly hand title to someone if he or she can no longer maintain the project.	こうした利害は文化規範として、所有者・管理者は自分がプロジェクトを管理できなくなった場合には、公式にその権利をだれかに譲るべきだというかたちで表現される。
The simplest non-trivial case is when a project has multiple co-maintainers working under a single `benevolent dictator' who owns the project.	いちばん単純ながら、簡単ではないケースとしては、プロジェクトを所有する一人の「優しい独裁者」のもとに複数の共同管理者が働いているような場合だ。
Custom favors this mode for group projects;	慣習は、グループプロジェクトについてはこのモードを好む。
it has been shown to work on projects as large as the Linux kernel or Emacs, and solves the ``who decides'' problem in a way that is not obviously worse than any of the alternatives.	これは Linux カーネルや Emacs ほどの大プロジェクトでも使えるし、「だれが決める」問題も解決してくれるし、その解決法も、その他のあらゆる代替案より特にひどいというわけでもない。
Typically, a benevolent-dictator organization evolves from an owner-maintainer organization as the founder attracts contributors.	典型的には、優しい独裁者組織は、創始者が貢献者を集めるにしたがって所有管理者組織から発展して生まれる。
Even if the owner stays dictator, it introduces a new level of possible disputes over who gets credited for what parts of the project.	所有者が独裁者であり続けても、それはプロジェクトのどの部分についてだれがクレジットを得るかという点について新しいレベルの紛争の可能性を持ち込むことになる。
In this situation, custom places an obligation on the owner/dictator to credit contributors fairly	この状況では、慣習は所有者／独裁者が公平に貢献者にクレジットを与えることを義務づける
(through, for example, appropriate mentions in README or history files).	（たとえばREADME履歴ファイルの中でのしかるべき記載なんかで）。
In terms of the Lockean property model, this means that by contributing to a project you earn part of its reputation return	ロック式所有権モデルでいえば、これはつまりプロジェクトへの貢献によってその評判リターンの一部を稼げるということだ
(positive or negative).	（いいものも悪いものも）。
Pursuing this logic, we see that a `benevolent dictator' does not in fact own his entire project absolutely.	この論理をつきつめると、「優しい独裁者」はその全プロジェクトを文句なしに占有しているわけじゃないのがわかる。
Though he has the right to make binding decisions, he in effect trades away shares of the total reputation return in exchange for others' work.	方向性を決める決断をする権利を持ってはいるけれど、かれは実際問題として、全体の評判の一部を他人の作業と交換にゆずりわたす。
The analogy with sharecropping on a farm is almost irresistible,	農場での分益小作人との対比はほとんど抵抗しがたいものがある。
except that a contributor's name stays in the credits and continues to `earn' to some degree even after that contributor is no longer active.	ただし、ハッカーの場合、貢献者の名前はクレジットに残り、その貢献者がもはや活発でなくなったときにも、ある程度の「収益」をあげ続ける点はちがうけれど。
As benevolent-dictator projects add more participants, they tend to develop two tiers of contributors;	優しい独裁者プロジェクトの参加者が増えるにつれて、参加者は二派にわかれる傾向がある。
ordinary contributors and co-developers.	通常の貢献者と共同開発者だ。
A typical path to becoming a co-developer is taking responsibility for a major subsystem of the project.	共同開発者となる典型的な道としては、プロジェクトの主要サブシステムの責任を負うことだ。
Another is to take the role of `lord high fixer', characterizing and fixing many bugs.	もう一つは「高等修理卿」の役割を負って、多くのバグを抽出してなおすことだ。
In this way or others, co-developers are the contributors who make a substantial and continuing investment of time in the project.	こういった方法を通じて、共同開発者は貢献者のなかでもプロジェクトに相当量の時間を投資し続ける。
The subsystem-owner role is particularly important for our analysis and deserves further examination.	サブシステム所有者の役割は、本論の分析ではときに大事なので、もっと詳しくみるべきだ。
Hackers like to say that `authority follows responsibility'.	ハッカーたちは「権威は責任に伴う」というのが好きだ。
A co-developer who accepts maintainance responsibility for a given subsystem generally gets to control both the implementation of that subsystem and its interfaces with the rest of the project,	あるサブシステムのメンテナンス責任を負う共同開発者は、そのサブシステムの実装と、その他プロジェクトとのインターフェース部分との両方をコントロールできるようになる。
subject only to correction by the project leader (acting as architect).	それを修正できるのは、アーキテクトとして働くプロジェクトリーダだけ。
We observe that this rule effectively creates enclosed properties on the Lockean model within a project,	このルールは、実質的にはプロジェクトのロック・モデル内部に、囲い込まれた所有地をつくりだしているものとみることができる。
and has exactly the same conflict-prevention role as other property boundaries.	だからほかの領地境界とまったく同じように、紛争防止の役割を持つことになるわけだ。
By custom, the `dictator' or project leader in a project with co-developers is expected to consult with those co-developers on key decisions.	習慣的に、共同開発者のいるプロジェクトの「独裁者」またはプロジェクトリーダは、その共同開発者たちにだいじな判断のときには相談することが期待されている。
This is especially so if the decision concerns a subsystem that a co-developer `owns' (that is, has invested time in and taken responsibility for).	これは特に、その決断が共同開発者「所有」のサブシステム（つまり、その共同開発者がそれに時間を注いで、責任を負っているサブシステム）にかかわるものであるときにあてはまる。
A wise leader, recognizing the function of the project's internal property boundaries, will not lightly interfere with or reverse decisions made by subsystem owners.	賢いリーダは、プロジェクト内部の領土境界の機能がわかっているから、サブシステム所有者の決定をじゃましたり、ひっくりかえしたりするようなことは軽々しくしない。
Some very large projects discard the `benevolent dictator' model entirely.	一部のすごく大きなプロジェクトは、「やさしい独裁者」モデルを完全に捨てている。
One way to do this is turn the co-developers into a voting committee (as with Apache).	これをやる方法の一つは、共同開発者たちを議決委員会にしてしまうことだ（Apacheがこうしている）。
Another is rotating dictatorship,	別の方法としては、独裁権を巡回方式にすることだ。
in which control is occasionally passed from one member to another within a circle of senior co-developers;	ここではコントロール権は、上級共同開発者たちのサークルのなかで次から次へとまわされる
the Perl developers organize themselves this way.	（Perl開発者たちはこういう形の組織を採用している）。
Such complicated arrangements are widely considered unstable and difficult.	こういう複雑な仕組みは、一般には不安定でむずかしいものと思われている。
Clearly this perceived difficulty is largely a function of the known hazards of design-by-committee, and of committees themselves;	明らかにこのむずかしいという印象は、委員会による設計や委員会そのものの危険性の関数である面が大きい。
these are problems the hacker culture consciously understands.	こういう問題について、ハッカー文化ははっきりわかっている。
However, I think some of the visceral discomfort hackers feel about committee or rotating-chair organizations is that they're hard to fit into the unconscious Lockean model hackers use for reasoning about the simpler cases.	でも、ハッカーたちが委員会や巡回式組織について生理的に感じている気持ち悪さは、それがもっと簡単な場合についてハッカーたちが理由づけるときに使う、無意識のロック式モデルにおさまりにくいことがあるんだろう。
It's problematic, in these complex organizations, to do an accounting of either ownership in the sense of control or ownership of reputation returns.	こういう複雑な組織では、コントロールという意味での所有権や、評判の収益の所有権をきちんとつけるのがむずかしいからだ。
It's hard to see where the internal boundaries are, and thus hard to avoid conflict unless the group enjoys an exceptionally high level of harmony and trust.	内部の境界がどこにあるかは見えにくいので、グループとして例外的に高い調和と信頼関係ができていない限り、紛争を避けるのはむずかしい。
Conflict and Conflict Resolution	17　紛争とその解決
We've seen that within projects, an increasing complexity of roles is expressed by a distribution of design authority and partial property rights.	これまで見てきたのは、プロジェクト内部では役割がますます複雑化し、それがデザイン決定権の配分と部分的な所有権によって表現されるということだった。
While this is an efficient way to distribute incentives, it also dilutes the authority of the project leader	これはインセンティブを配分する効率のよい方法だけれど、プロジェクトリーダーの権威を弱めるものでもある
?most importantly, it dilutes the leader's authority to squash potential conflicts.	――いちばん大事な点として、リーダーが紛争をおさえこむための権威を弱めてしまうんだ。
While technical arguments over design might seem the most obvious risk for internecine conflict, they are seldom a serious cause of strife.	設計にかかわる技術的な論争こそが、一見すると血を見るような争いにいたる一番の原因になりそうだと思うかもしれないけれど、でもこれは深刻なもめごとの原因にはめったにならない。
These are usually relatively easily resolved by the territorial rule that authority follows responsibility.	こういうのは、権威は責任に伴うというなわばりのルールによってそこそこ簡単に解決がつく。
Another way of resolving conflicts is by seniority	紛争解決手段としてもう一つあるのは、序列によるものだ
?if two contributors or groups of contributors have a dispute, and the dispute cannot be resolved objectively, and neither owns the territory of the dispute, the side that has put the most work into the project as a whole (that is, the side with the most property rights in the whole project) wins.	――もし貢献者二人、または貢献者集団二つが争いを始めて、それが客観的に解決できず、どちらもその争いのなわばりを所有はしていないとき、そのプロジェクト全体につぎ込んだ作業量の多いほう（つまり、プロジェクト全体の中で地役権を最大に持つ側）が勝つ。
(Equivalently, the side with the least invested loses.	（同じように、投入したものが少ない方が負ける。
Interestingly this happens to be the same heuristic that many relational database engines use to resolve deadlocks.	おもしろいことに、これは多くのリレーショナルデータベース・エンジンが、デッドロックを解決するヒューリスティクとまったく同じだ。
When two threads are deadlocked over resources, the side with the least invested in the current transaction is selected as the deadlock victim and is terminated.	二つのスレッドが、あるリソースをめぐってデッドロックになったら、現在のトランザクションに投入したものがいちばん少ないほうが、デッドロックの犠牲者として選ばれて、終了させられる。
This usually selects the longest running transaction, or the more senior, as the victor.)	これはつまり通常は、いちばん長く走っているトランザクション、あるいはトランザクションとして上位にあるのが、勝者となるということだ。）
These rules generally suffice to resolve most project disputes.	こういうルールだけで、ほとんどのプロジェクト上の争いを解決するには十分だ。
When they do not, fiat of the project leader usually suffices.	十分でない場合にも、リーダの采配でだいたいなんとかなる。
Disputes that survive both these filters are rare.	この二重のフィルタを越えるほどの紛争はほとんどない。
Conflicts do not, as a rule, become serious unless these two criteria ("authority follows responsibility" and "seniority wins") point in different directions, and the authority of the project leader is weak or absent.	紛争は原則的に、こうした二つの基準（「権威は責任にともなう」「序列の高いほうが勝つ」）が矛盾する結果を出して、しかもそのプロジェクトリーダの権利が弱かったり不在だったりするときにしか生き延びない。
The most obvious case in which this may occur is a succession dispute following the disappearance of the project lead.	これが起きるいちばんはっきりした例は、プロジェクトのリーダが消えたあとで、その後継をめぐる争いだ。
I have been in one fight of this kind.	ぼくは一度、この種の争いに加わっていたことがある。
It was ugly, painful, protracted, only resolved when all parties became exhausted enough to hand control to an outside person,	みにくくて苦痛で、長引いて、最終的に解決されたのも、関係者がみんな疲れ切って、コントロールを外部の人に任せようと決めたから可能になった。
and I devoutly hope I am never anywhere near anything of the kind again.	もう二度とあの種のものには近づかずにすみますように、と心から願わずにはいられない。
Ultimately, all of these conflict-resolution mechanisms rest on the entire hacker community's willingness to enforce them.	最終的には、こういう紛争解決メカニズムは、ハッカーコミュニティがそれを強制しようという意志をもっているかどうかにかかってくる。
The only available enforcement mechanisms are flaming and shunning	そして唯一の強制メカニズムは、フレーミングと黙殺だ
?public condemnation of those who break custom, and refusal to cooperate with them after they have done so.	――慣習を破る者たちに対する公開糾弾と、破った者たちとはもう協力しないということだ。
Acculturation Mechanisms and the Link to Academia	18　文化への順応過程とアカデミズムとの関連
An early version of this essay posed the following research question:	この論文の以前のバージョンは、今後の研究テーマとして次の課題を挙げていた：
how does the community inform and instruct its members as to its customs?	ハッカー・コミュニティはそのメンバーに、慣習をどうやって伝えて指導するのか？
Are the customs self-evident or self-organizing at a semi-conscious level?	慣習は自明なものなのか、あるいは無意識のレベルで自己組織的なものなのか、
Are they taught by example?	事例によって教えられるのか、
Are they taught by explicit instruction?	それとも明文化された指示によって教えられるのか？
Teaching by explicit instruction is clearly rare,	明文化された指示による教育は明らかにほとんどない。
if only because few explicit descriptions of the culture's norms have existed for instructional use up to now.	そもそもこの文化の規範についての明文化された記述は、いままでほとんどなかったから使いようがなかった。
Many norms are taught by example.	多くの規範は事例によって教えられる。
To cite one very simple case, there is a norm that every software distribution should have a file called README or READ.ME that contains first-look instructions for browsing the distribution.	すごく簡単な例を挙げるなら、あらゆるソフトの配布パッケージは README や READ.ME というファイルを含むべきだという規範がある。
This convention has been well established since at least the early 1980s;	この慣習は1980年代初期には確立されていたものだけれど、
it has even, occasionally, been written down.	でもいまのところそれが明文化されたことはない。
But one normally derives it from looking at many distributions.	みんな、いろんなパッケージを見た結果としてその規範を知るわけだ。
On the other hand, some hacker customs are self-organizing once one has acquired a basic (perhaps unconscious) understanding of the reputation game.	一方で、ハッカー慣習のなかには、評判ゲームについての基本的な（おそらくは無意識の）理解さえ獲得できたら自己組織的に導かれるものもある。
Most hackers never have to be taught the three taboos I listed earlier in this essay, or at least would claim if asked that they are self-evident rather than transmitted.	第3章でぼくが挙げた3つのタブーについて、ハッカーのほとんどはわざわざ教わる必要はないし、そうでなくても、あんなのは教えるまでもなく自明のことだというだろう。
This phenomenon invites closer analysis	この現象はもっと詳細な分析が必要だ
?and perhaps we can find its explanation in the process by which hackers acquire knowledge about the culture.	――そしてその説明は、ハッカーがハッカー文化についての知識をどうやって得るかというプロセスを見ればわかるかもしれない。
Many cultures use hidden clues (more precisely `mysteries' in the religio/mystical sense) as an acculturation mechanism.	文化順応メカニズムとして、隠されたヒント（宗教・神秘学的な意味ではもっと厳密な「謎」）を使う文化は多い。
These are secrets that are not revealed to outsiders, but are expected to be discovered or deduced by the aspiring newbie.	これは部外者には明かされない謎だが、熱心なタコ（newbie）なら見つけだしたり演繹したりできると期待されている。
To be accepted inside, one must demonstrate that one both understands the mystery and has learned it in a culturally sanctioned way.	内部に受け入れられるためには、その謎が理解できていて、しかもそれを文化的に認められた方法で学んだことを示さなくてはならない。
The hacker culture makes unusually conscious and extensive use of such clues or tests.	ハッカー文化は、こういうヒントやテストを異常なほど意識的かつ広く利用している。
We can see this process operating at at least three levels:	このプロセスは、少なくとも三つのレベルで機能していることがわかる。
Password-like specific mysteries.	パスワード風のはっきりした謎。
As one example, there is a Usenet newsgroup called alt.sysadmin.recovery that has a very explicit such secret;	一例として、USENET には alt.sysadmin.recovery というニュースグループがあって、こういう秘密の例として非常にはっきりしたものを持っている。
you cannot post without knowing it,	その秘密を知らないとメッセージをポストできない。
and knowing it is considered evidence you are fit to post.	そしてその秘密を知っているということが、ポストするのにふさわしい人物だという証拠と見なされる。
The regulars have a strong taboo against revealing this secret.	常連はこの秘密をばらすことについて、強いタブーを持っている。
The requirement of initiation into certain technical mysteries.	ある技術的な謎へのイニシエーションが必要なこと。
One must absorb a good deal of technical knowledge before one can give valued gifts	価値ある贈り物ができるようになるためには、人は相当量の技術的な知識を吸収しなくてはならない
(e.g. one must know at least one of the major computer languages).	（たとえば、主要コンピュータ言語のどれか一つを知らなくてはならない）。
This requirement functions in the large in the way hidden clues do in the small, as a filter for qualities (such as capability for abstract thinking, persistence, and mental flexibility) that are necessary to function in the culture.	この必要条件が大きな場で果たす役割は、小さな集団で隠されたヒントが果たす役割と同じで、この文化の中で活動するのに必要な資質（たとえば抽象思考能力、根気、精神的な柔軟性など）のフィルタとして機能する。
Social-context mysteries.	社会的な文脈の謎。
One becomes involved in the culture through attaching oneself to specific projects.	人がハッカー文化に関わりを持つのは、特定のプロジェクトへの参加を通じてだ。
Each project is a live social context of hackers that the would-be contributor has to investigate and understand socially as well as technically in order to function.	各プロジェクトはハッカーたちの生々しい社会的な文脈であり、そこへの参加者になりたい人間が活動するためには、いろいろ調べて技術的な理解とともに社会的な理解を身につけなくてはならない
(Concretely, a common way one does this is by reading the project's web pages and/or email archives.)	（具体的には、これをやる一般的な方法はそのプロジェクトのWebページを読んだり、e-mailアーカイブを読んだりすることだ）。
It is through these project groups that newbies experience the behavioral example of experienced hackers.	こういうプロジェクト集団を通じて、タコ（newbie）たちは経験豊かなハッカーたちの行動事例を経験する。
In the process of acquiring these mysteries, the would-be hacker picks up contextual knowledge that (after a while) does make the three taboos and other customs seem `self-evident'.	こういう謎を身につける過程で、ハッカー候補は文脈的な知識を身につけてゆき、（しばらくすれば）そのおかげで確かに三つのタブーやその他の慣習は「あたりまえ」に思えてくるわけだ。
One might, incidentally, argue that the structure of the hacker gift culture itself is its own central mystery.	ついでながら、ハッカー贈与文化の構造そのものが、それ自体中心的な謎だと論じる人もいるかもしれない。
One is not considered acculturated (concretely: no one will call you a hacker) until one demonstrates a gut-level understanding of the reputation game and its implied customs, taboos, and usages.	評判ゲームやそこにこめられた慣習、タブー、利用法について、本能的な理解を実証してみせない限り、文化に順応したとはみなされない
But this is trivial;	でもこれは些末なことだ。
all cultures demand such understanding from would-be joiners.	あらゆる文化は、参加者候補に対してそういう理解を要求する。
Furthermore the hacker culture evinces no desire to have its internal logic and folkways kept secret	さらにハッカー文化は、内的論理や民俗的な方法を秘密にしておこうなんていう希望はぜんぜん持っていない
?or, at least, nobody has ever flamed me for revealing them!	――少なくとも、それをばらしたぼくに対してフレームしてきた人はだれもいない！
Respondents to this essay too numerous to list have pointed out that hacker ownership customs seem intimately related to (and may derive directly from) the practices of the academic world, especially the scientific research commmunity.	名前を挙げきれないくらい多数のコメントが寄せられ、ハッカーの所有権慣習は学問世界、特に科学研究コミュニティの行いと密接に関連し、そこから直接派生したものかもしれないと指摘してくれた。
This research community has similar problems in mining a territory of potentially productive ideas, and exhibits very similar adaptive solutions to those problems in the ways it uses peer review and reputation.	こうした研究コミュニティは、潜在的に生産的なアイデアのなわばりを掘り起こすという面で似たような問題を抱えているし、同業者のレビューや評判を使うという点で、その問題に対して非常に類似した適応解決手段を示している。
Since many hackers have had formative exposure to academia	多くのハッカーたちは、アカデミズムの世界と正式な接触を持ったことがある
(it's common to learn how to hack while in college)	（大学でハッキングを学ぶのはよくあることだ）。
the extent to which academia shares adaptive patterns with the hacker culture is of more than casual interest in understanding how these customs are applied.	だからアカデミズムの世界が適応パターン面でハッカー文化とどれほど共通性があるかという話は、こういう慣習の適用方法を理解するにあたっては、ついで以上の興味を向けるべき課題だ。
Obvious parallels with the hacker `gift culture' as I have characterized it abound in academia.	ぼくが特徴づけたようなハッカー「贈与文化」との明らかな類比が、アカデミズムの世界でもたくさん見られる。
Once a researcher achieves tenure, there is no need to worry about survival issues.	研究者が終身職を手に入れると同時に、もはや生存の問題は気にする必要がなくなる
(Indeed, the concept of tenure can probably be traced back to an earlier gift culture in which ``natural philosophers'' were primarily wealthy gentlemen with time on their hands to devote to research.)	（実は終身職の概念は、「自然哲学者」たちがおもに金持ちの紳士たちで、研究に没頭するだけの暇をもっていた、初期の贈与文化までさかのぼることができる）。
In the absence of survival issues, reputation enhancement becomes the driving goal, which encourages sharing of new ideas and research through journals and other media.	生存問題がない以上、評判の向上が作業をつき動かす目標となり、それは雑誌などのメディアを通じて新しいアイデアと研究の共有を奨励する。
This makes objective functional sense	これは客観的にみて、機能的に筋が通っている。
because scientific research, like the hacker culture, relies heavily on the idea of `standing upon the shoulders of giants',	科学研究はハッカー文化と同じく、「巨人の肩に立つ（先人の成果に積み重ねる）」という考え方に大きく依存しているからだ。
and not having to rediscover basic principles over and over again.	これにより、同じ基本原理をなんども発表しなおさずにすむ。
Some have gone so far as to suggest that hacker customs are merely a reflection of the research community's folkways and have actually (in most cases) been acquired there by individual hackers.	ある人はこの議論を極端にすすめて、ハッカー慣習は単に研究コミュニティの民俗的な慣習の反映にすぎず、実は（ほとんどが）そこで獲得されたものだ、とまで主張する。
This probably overstates the case,	これはたぶん話を誇張させすぎているだろう。
if only because hacker custom seems to be readily acquired by intelligent high-schoolers!	ハッカー慣習は頭のいい高校生でもすぐに獲得できてしまうという一点だけでもそれは明らかだと思う。
There is a more interesting possibility here.	ここにはもっとおもしろい可能性がある。
I suspect academia and the hacker culture share adaptive patterns not because they're genetically related, but because they've both evolved the one most optimal social organization for what they're trying to do, given the laws of nature and the instinctive wiring of human beings.	ぼくの憶測だけれど、学問の世界とハッカー文化が同じ適応パターンを示すのは、それが出自の点で親戚だからではなく、物理法則と人間の本能の仕組みを千手としたときに、それぞれ自分たちがやろうとしていたことを実現するための、唯一最適な社会組織を発達させたんじゃないだろうか。
The verdict of history seems to be that free-market capitalism is the globally optimal way to cooperate for economic efficiency;	歴史的にみて、自由市場資本主義こそが経済効率を求めて協力するための世界的に最適な方法だという審判はくだったようだ。
perhaps, in a similar way, the reputation-game gift culture is the globally optimal way to cooperate for generating (and checking!) high-quality creative work.	ひょっとして同じように、評判ゲームに基づく贈与文化は、高品質の創造的作業を産み出し（そしてチェックする！）ために協力するにあたって、世界的に最適な方法なのかもしれない。
This suggests from a slightly different angle one of the speculations in The Cathedral And The Bazaar;	それは『伽藍とバザール』（邦訳、原文)での考察を、ちょっと別の角度からも論証しなおしたものとなる。
that, ultimately, the industrial/factory mode of software production was doomed to be outcompeted from the moment capitalism began to create enough of a wealth surplus that many programmers could live in a post-scarcity gift culture.	つまり多くのプログラマがポスト稀少性時代の贈与文化の中で生きられるだけの富の余剰を資本主義が作り出せるようになった瞬間から、最終的にはソフト生産の産業資本主義様式は競争に負けるべく運命づけられているのだ、という考察だ。
Conclusion: From Custom to Customary Law	19　結論：慣習から慣習法へ
We have examined the customs which regulate the ownership and control of open-source software.	これまでオープンソース・ソフトの所有権とコントロールを支配する慣習をみてきた。
We have seen how they imply an underlying theory of property rights homologous to the Lockean theory of land tenure.	その根底にある理論が、ロック式の土地所有権理論と似た所有権概念であることもみた。
We have related that to an analysis of the hacker culture as a `gift culture' in which participants compete for prestige by giving time, energy, and creativity away.	それと結びつけて、参加者が時間とエネルギーと創造性をあげてしまうことで名声を競う「贈与文化」としてハッカー文化を分析してみた。
We have examined the implications of this analysis for conflict resolution in the culture.	そしてその分析が、文化内の紛争解決にとって持つ意味について検討してみた。
The next logical question to ask is "Why does this matter?"	論理的に考えて次にたずねるべき質問は「それがどうしたの？」というものだ。
Hackers developed these customs without conscious analysis and (up to now) have followed them without conscious analysis.	ハッカーは意識的な分析なしにこうした慣習を発展させてきたし、（いままでは）意識的な分析なしにそれにしたがってきた。
It's not immediately clear that conscious analysis has gained us anything practical	それを意識的に分析してみたところで、なにか実用性のある成果が得られたかどうかは、すぐにははっきりしない
?unless, perhaps, we can move from description to prescription and deduce ways to improve the functioning of these customs.	――ただし、これによって記述から処方へと歩みを進めて、こういう習慣の機能を改良する方法が抽出できるなら話は別だろう。
We have found a close logical analogy for hacker customs in the theory of land tenure under the Anglo-American common-law tradition.	英米慣習法の伝統の土地所有権理論が、ハッカー慣習と論理的にとても近い関係にあることを見てきた。
Historically [Miller], the European tribal cultures that invented this tradition improved their dispute-resolution systems by moving from a system of unarticulated, semi-conscious custom to a body of explicit customary law memorized by tribal wisemen ?and eventually, written down.	歴史的にみて [Miller]、これを発明したヨーロッパの部族文化は、明文化もはっきり意識化もされない慣習から部族の賢者たちが記憶するはっきりした慣習法体系に移行し、やがてはそれを成文化することで、紛争解決システムを向上させていった。
Perhaps, as our population rises and acculturation of all new members becomes more difficult, it is time for the hacker culture to do something analogous	たぶん、人数がふえてきて新メンバー全員の文化順応を行うのがだんだん難しくなってくるにつれて、ハッカー文化もなにかそれと似たようなことをする時期がきているんだろう
?to develop written codes of good practice for resolving the various sorts of disputes that can arise in connection with open-source projects, and a tradition of arbitration in which senior members of the community may be asked to mediate disputes.	――オープンソース・プロジェクトとのかかわりで生じる可能性のあるさまざまな紛争を解決するためのよい方法を、明文化したコードとして開発し、コミュニティの長老メンバーが紛争調停を行うような、仲裁の伝統をつくりあげることだ。
The analysis in this essay suggests the outlines of what such a code might look like, making explicit that which was previously implicit.	この論文での分析から、これまで内在的だったものを明文化するようなそういうコードの概略が、どんなものになるべきかが示唆される。
No such codes could be imposed from above;	こういうコードは決して上から押しつけられるものではあり得ない。
they would have to be voluntarily adopted by the founders or owners of individual projects.	個別プロジェクトの創始者や所有者が、自主的に採用するものでなくてはならない。
Nor could they be completely rigid,	そしてそれは完全に硬直したものでもありえない。
as the pressures on the culture are likely to change over time.	文化にかかる圧力はだんだん変わるはずだからだ。
Finally, for enforcement of such codes to work, they would have to reflect a broad consensus of the hacker tribe.	最後に、こういうコードが実行上うまく機能するには、ハッカー部族の幅広い合意を反映したものでなくてはならない。
I have begun work on such a code, tentatively titled the "Malvern Protocol" after the little town where I live.	ぼくはそういうコードを書く作業を始めていて、ぼくが住んでいる小さな町の名前をとってそれを仮に「マルヴァーン綱領」と名付けている。
If the general analysis in this paper becomes sufficiently widely accepted, I will make the Malvern Protocol publicly available as a model code for dispute resolution.	もしこの論文の一般的な分析がそれなりに広く受け入れられたら、マルヴァーン綱領を紛争解決コードの見本として公開する。
Parties interested in critiquing and developing this code, or just offering feedback on whether they think it's a good idea or not, are invited to contact me by email.	このコードの批評や開発に興味のある向きや、単にそれがいいか悪いかフィードバックをくれたい人は、電子メールでぼくにコンタクトしてほしい。
Questions for Further Research	20　これからの研究の課題
The culture's (and my own) understanding of large projects that don't follow a benevolent-dictator model is weak.	ハッカー文化（そしてぼく）は、優しい独裁者モデルに従わない大規模プロジェクトについてあまりよく理解できていない。
Most such projects fail.	そういうプロジェクトの多くは失敗する。
A few become spectacularly successful and important (Perl, Apache, KDE).	でも少数はものすごい大成功をおさめて重要になる（Perl、Apache、KDE）。
Nobody really understands where the difference lies.	ちがいがどこにあるのか、だれにもわかっていない。
There's a vague sense abroad that each such project is sui generis and stands or falls on the group dynamic of its particular members, but is this true or are there replicable strategies that a group can follow?	（そういうプロジェクトはそれぞれsui generis（まったく独自のもの）であり、たまたまそのメンバーのグループ力学に基づいて成功したりしなかったりするのだというのが、漠然とただよう理解だけれど、でもこれって本当なんだろうか、それともある集団がとるべき複製可能な戦略があるんだろうか？）
A fascinating study of Icelandic folkmoot law,	アイスランドの民会法についてのすばらしい研究。
which both illuminates the ancestry of the Lockean theory of property and describes the later stages of a historical process by which custom passed into customary law and thence to written law.	ロック式所有権理論がどれほど古いかを明らかにするとともに、慣習が慣習法へとひきつがれ、そして成文法になる歴史的なプロセスの後半を描いている。
There is much enlightening silliness to be found in Discordianism.	すごく軽い冗談口てんこもりだけれど、
Amidst it, the `SNAFU principle' provides a rather trenchant analysis of why command hierarchies don't scale well.	そのなかの「SNAFU 原理」なる代物は、上意下達方式がなぜスケーラビリティが低いのかについて、なかなか深遠な分析を提供している。
There's a browseable HTML version.	ブラウズ可能な HTML 版あり。
An excellent introduction to evolutionary psychology.	進化心理学へのすぐれた入門書。
Some of the papers bear directly on the three cultural types I discuss (command/exchange/gift), suggesting that these patterns are wired into the human psyche fairly deep.	論文のいくつかは、ぼくが論じている3種類の文化タイプ（上意下達、交換、贈与）と直接かかわるもので、こういうパターンが人間の心理のかなり深いところにまで食い込んでいるらしいことを示唆している。
I discovered this paper after my version 1.7.	この論文はバージョン 1.7 のあとで発見した。
It has obvious flaws (Goldhaber's argument for the inapplicability of economic reasoning to attention does not bear close examination),	一目でわかる欠点もある（Goldhaber は、関心というものには経済的な理由づけが適用できないと論じているけれど、この議論はよく読むと成り立たない）
but Goldhaber nevertheless has funny and perceptive things to say about the role of attention-seeking in organizing behavior.	けれど、それでも Goldhaber は組織行動における関心集めの役割についておもしろくて鋭いことを言っている。
The prestige or peer repute I have discussed can fruitfully be viewed as a particular case of attention in his sense.	ぼくが論じた名声や仲間内の評判は、かれが言う意味での関心の特殊例として見ると有益。
[HH] I have summarized the history of the hacker culture in A Brief History Of Hackerdom.	[HH] ハッカー社会（hackerdom）の歴史については、ここにまとめてみた（邦訳はこちら）。
The book that will explain it really well remains to be written, probably not by me.	これをほんとうにきちんと説明してくれる本は未だに書かれていないし、それを書くのはたぶんぼくではないと思う。
[N] The term `noosphere' is an obscure term of art in philosophy.	[N]「ノウアスフィア（noosphere）」は哲学特有の専門用語で、
It is pronounced KNOW-uh-sfee (two o-sounds, one long and stressed, one short and unstressed tending towards schwa).	「ノウ・ア・スフィア」が正しい発音
If one is being excruciatingly correct about one's orthography, the term is properly spelled with a diaeresis over the second `o' to mark it as a separate vowel.	表記について死ぬほど厳密でありたいなら、正しくは二番目の o の上に点々がつく。
In more detail;	もっと詳しく言えば：
this term for ``the sphere of human thought'' derives from the Greek `noos' meaning `mind', `intelligence', or `perception'.	この「人間の思考の圏域」を表す用語は、ギリシャ語の「nous」、つまり精神や意志、息などを指す単語から生まれている。
It was invented by E. LeRoy in Les origines humaines et l'evolution de l'intelligence (Paris 1928).	E. LeRoy が Les origines humaines et l'evolution de l'intelligence (Paris 1928)で発明したことばだ。
It was popularized first by the Russian biologist and pioneering ecologist Vladimir Ivanovich Vernadsky, (1863?1945), then by the Jesuit paleontologist/philosopher Pierre Teilhard de Chardin (1881?1955).	これはさらに、ロシアの生物学者にして先駆的なエコロジスト Vladimir Ivanovich Vernadsky (1863-1945)によって広められ、さらにはイエズス会の古生物学者兼哲学者ピエール・ティヤール・ド・シャルダン Pierre Teilhard de Chardin (1881-1955)がこれを広めた。
It is with Teilhard de Chardin's theory of future human evolution to a form of pure mind culminating in union with the Godhead that the term is now primarily associated.	いまではこの用語は主に、人間が将来純粋な精神体へと進化して神様と融合するというかれの理論と結びついて考えられている。
[DF] David Friedman, one of the most lucid and accessible thinkers in contemporary economics, has written an excellent outline of the history and logic of intellectual-property law.	[DF]現代経済学で最も雄弁かつわかりやすい論者デビッド・フリードマンは、知的財産法の歴史と論理について見事な概論を書いている。
I recommend it as a starting point to anyone interested in these issues.	この問題に関心ある人すべての出発点としておすすめする。
[BSD] One interesting difference between the Linux and BSD worlds is that the Linux kernel (and associated OS core utilities) have never forked, but BSD's has, at least three times.	[SP]　Linux と BSD の世界とのおもしろいちがいの一つは、Linux のカーネル（および関連する OS の中心的なユーティリティ）は一度も分裂していないけれど、BSD は少なくとも 3 回は分裂しているということだ。
What makes this interesting is that the social structure of the BSD groups is centralized in a way intended to define clear lines of authority and to prevent forking, while the decentralized and amorphous Linux community takes no such measures.	これがおもしろいのは、BSD グループの社会構造は中央集権化されていて、権限をはっきりと線引きすることで分裂を防ぐようになっているのに、中央集権化されていなくて不定型なLinuxコミュニティは分裂を防ぐような手段をまったく講じていないからだ。
It appears that the projects which open up development the most actually have the least tendency to fork!	開発をなるべく開放したほうが、いちばん分裂しにくくなるとしか思えない！
Henry Spencer <henry@spsystems.net> suggests that, in general, the stability of a political system is inversely proportional to the height of the entry barriers to its political process.	Henry Spencer <henry@spsystems.net> の考えによれば、一般に政治的なシステムの安定性は、その政治プロセスへの参入障壁の高さに反比例するのではないか、とのこと。
His analysis is worth quoting here:	かれの分析は、ここで引用するだけの価値がある：
One major strength of a relatively open democracy is that most potential revolutionaries find it easier to make progress toward their objectives by working via the system rather by attacking it.	「比較的オープンな民主主義の大きな強みの一つは、ほとんどの潜在的革命家は自分の目的を達成するのに、システムを利用したほうがシステムを攻撃するよりも簡単だと判断する、ということだ。
This strength is easily undermined if established parties act together to `raise the bar', making it more difficult for small dissatisfied groups to see some progress made toward their goals.	各種組織が協力して「敷居を上げて」、不満を持った小集団が自分の目標を多少なりとも達成するのをむずかしくすると、この強みはすぐに消えてしまう。
(A similar principle can be found in economics.	（同じような原理は経済でも見られる。
Open markets have the strongest competition, and generally the best and cheapest products.	開放市場では競合がいちばん激しく、さらに最高で最低価格の製品が得られるのがふつうだ。
Because of this, it's very much in the best interests of established companies to make market entry more difficult	このため、既存企業としては、新規参入をなるべくむずかしくするのがいちばん利益になる
?for example, by convincing governments to require elaborate RFI testing on computers, or by creating `consensus' standards which are so complex that they cannot be implemented effectively from scratch without large resources.	――たとえば政府に対し、コンピュータに入念な RFI テストを義務づけさせたり、ポケットが深くない限り、複雑すぎて1から実装するのが実質的に不可能な「合意に基づく」規格を作ったりするわけだ。
The markets with the strongest entry barriers are the ones that come under the strongest attack from revolutionaries, e.g. the Internet and the Justice Dept. vs. the Bell System.)	参入障壁がいちばん強力な市場は、革命家、たとえばインターネットや、司法省対ベルシステムの独禁法裁判などからいちばん攻撃を受けやすい市場でもある。）
An open process with low entry barriers encourages participation rather than secession,	参入障壁の低いオープンなプロセスは、分離させるより、むしろ参加をうながす。
because one can get results without the high overheads of secession.	分離による高いオーバーヘッドなしに成果が得られるからだ。
The results may not be as impressive as what could be achieved by seceding, but they come at a lower price, and most people will consider that an acceptable tradeoff.	その成果は、分離したら達成できるものほどはすごくないかもしれないけれど、必要コストは低いし、多くの人はこれをがまんできる範囲のトレードオフだと判断する。
(When the Spanish government revoked Franco's anti-Basque laws and offered the Basque provinces their own schools and limited local autonomy, most of the Basque Separatist movement evaporated almost overnight.	（スペイン政府がフランコの反バスク法を廃止して、バスク地方に独自の学校と一定の自治権を与えたら、バスク独立運動のほとんどは一瞬で消えた。
Only the hard-core Marxists insisted that it wasn't good enough.)	それでは不十分だと固執したのは、ゴリゴリのマルクス主義者だけだった。）」
[RP] There are some subtleties about rogue patches.	[RP]非公式パッチについてはいくつか細かい点がある。
One can divide them into `friendly' and `unfriendly' types.	まずこれは、「友好的なもの」と「敵対するもの」に分類できる。
A `friendly' patch is designed to be merged back into the project's main-line sources under the maintainer's control	「友好的」なパッチは管理者のコントロール下で、プロジェクトのソースコードの主流に織り込まれるように設計されている
(whether or not that merge actually happens);	（それが実際に織り込まれるかはまた別の話）。
an `unfriendly' one is intended to yank the project in a direction the maintainer doesn't approve.	「敵対」パッチは、管理者の認めない方向にプロジェクトをねじまげようとするものだ。
Some projects (notably the Linux kernel itself) are pretty relaxed about friendly patches and even encourage independent distribution of them as part of their beta-test phase.	一部のプロジェクト（とくに Linux カーネルそのもの）は友好パッチにはすごく甘くて、むしろベータテストの段階では、独自のパッケージを推奨したりさえする。
An unfriendly patch, on the other hand, represents a decision to compete with the original and is a serious matter.	一方の敵対パッチはオリジナルと張り合おうという決断を示すもので、深刻な事態となる。
Maintaining a whole raft of unfriendly patches tends to lead to forking.	敵対パッチを大量に管理するようになると、プロジェクトはやがて分裂に向かうことが多い。
[LW] I am indebted to Michael Funk <mwfunk@uncc.campus.mci.net> for pointing out how instructive a contrast with hackers the pirate culture is.	[LW]ハッカーと海賊ソフト文化との対比がいかに示唆的かを指摘してくれた点で、Michael Funk <mwfunk@uncc.campus.mci.net>には感謝したい。
Linus Walleij has posted an analysis of their cultural dynamics that differs from mine	Linus Wallejは、かれらの文化力学についてぼくとは異なる分析をポストしている
(describing them as a scarcity culture)	（かれらを希少性文化として描いている。
in A Comment on `Warez D00dz' Culture.	これは A Comment on `Warez D00dz' Culture (http://www.df.lth.se/‾triad/papers/Raymond_D00dz.htmlを参照。
The contrast may not last.	この対比は、長続きしないかもしれない。
Former cracker Andrej Brandt <andy@pilgrim.cs.net.pl> reports that he believes the cracker/warez d00dz culture is now withering away, with its brightest people and leaders assimilating to the open-source world.	もとクラッカーのAndrej Brandt <andy@pilgrim.cs.net.pl> の見解によると、cracker/warez d00dz 文化は現在しぼみつつあって、いちばん優れた人材やリーダーたちは、オープンソースの世界に取り込まれているという。
Independent evidence for this view may be provided by a precedent-breaking July 1999 action of the cracker group calling itself `Cult of the Dead Cow'.	この視点について独立した証拠としては、「Cult of the Dead Cow」というクラッカー集団が 1999 年 6 月に行った、前例のない行動がある。
They have released their `Back Orifice 2000' for breaking Microsoft Windows security tools under the GPL.	かれらは、Microsoft Windows のセキュリティを破るためのツールである「Back Orifice 2000」を GPL のもとで公開した。
[HT] In evolutionary terms, the craftsman's urge itself may (like internalized ethics) be a result of the high risk and cost of deception.	[HT] 進化論的にいえば、職人の衝動自体が（内面化された倫理と同じく）裏切りの高リスクとコストの結果かもしれない。
Evolutionary psychologists have collected experimental evidence [BCT] that human beings have brain logic specialized for detecting social deceptions,	進化心理学者たちは、人間が社会的なだましを検出するのに特化した脳論理回路を持っているという証拠を得ている[BCT]。
and it is fairly easy to see why our ancestors should have been selected for ability to detect cheating.	そして、われわれの先祖がインチキを検出する能力を持ったために選別されたのはなぜか、理解するのは容易だろう。
Therefore, if one wishes to have a reputation for personality traits that confer advantage but are risky or costly, it may actually be better tactics to actually have these traits than to fake them.	だから、もしリスクもコストも高いけれど、メリットももたらすような性格の持ち主だという評判を得たければ、そういう性質があるふりをしてごまかすよりも、実際にそういう性質を身につけるほうが戦術的に優れているかも知れない
(``Honesty is the best policy'')	（「正直がいちばん」というやつだ）。
Evolutionary psychologists have suggested that this explains behavior like barroom fights.	進化心理学者たちは、これで酒場のけんかのような行動も説明できるのでは、と言う。
Among younger adult male humans, having a reputation for toughness is both socially and (even in today's feminist-influenced climate) sexually useful.	若い大人の男性の間では、「タフだ」という評判は社会的にも（そして現在のフェミニズムの栄養が強い風土にあってなお）性的にも有用なのだ。
Faking toughness, however, is extremely risky;	「タフさ」を詐称するのは、非常にリスクが高い。
the negative result of being found out leaves one in a worse position than never having claimed the trait.	それがばれたときのマイナスの影響は、それを主張しなかった場合に比べてもっと悪い立場にその人物を追いやってしまう。
The cost of deception is so high that it is sometimes better minimaxing to internalize toughness and risk serious injury in a fight to prove it.	この詐欺のコストはあまりに高いので、「タフさ」を内面化して、けんかで無理にそれを証明するために深刻なけがのリスクを負うほうが、最小効用の最大化（ミニマックス化）のためには有効なことさえある。
Parallel observations have been made about less controversial traits like honesty.	もっと議論にならない「正直さ」のような性向についても、似たような観察がなされている。
Though the primary meditation-like rewards of creative work should not be underestimated, the craftsman's urge is probably at least in part just such an internalization	創造的な仕事の、主に瞑想にも似た見返りは過小評価してはならないけれど、職人の衝動というのは、おそらく部分的にはまさにこうした内面化からくるものなのだろう
(where the base trait is `capacity for painstaking work' or something similar).	（そこでは基本的な性向は、「面倒な仕事をこなす能力」といったようなものになる）。
[MH] A concise summary of Maslow's hierarchy and related theories is available on the Web at Maslow's Hierarchy of Needs	[MH] マスローのヒエラルキーと関連理論についての簡潔なまとめは、web上で読める。
[DC] However, demanding humility from leaders may be a more general characteristic of gift or abundance cultures.	[DC] しかしながら、リーダーに謙虚さを求めるというのは、贈与文化、過剰文化のもっと一般的な性質なのかもしれない。
David Christie <dc@netscape.com> reports on a trip through the outer islands of Fiji:	David Christie <dc@netscape.com> は、フィジーの周辺部の島を旅したときについてこう書いている:
In Fijian village chiefs, we observed the same sort of self-deprecating, low-key leadership style that you attribute to open source project leaders.	「フィジーの村長にも、あなたがオープンソースのリーダーについて述べたのと同じように、卑下する腰の低いリーダーシップのスタイルが観察されました。
[...] Though accorded great respect and of course all of whatever actual power there is in Fiji, the chiefs we met demonstrated genuine humility and often a saint-like acceptance of their duty.	[中略] 大いなる尊敬を集め、そしてフィジーにある限りの現実の力をすべて持っているのに、われわれが会った村長たちは本物の謙虚さを示し、しばしば自分たちの任務を聖人のように受け入れていました。
This is particularly interesting given that being chief is a hereditary role,	これは、村長というのが世襲だということを考えるとなおさら興味深いものです。
not an elected position or a popularity contest.	選出されるわけでもないし、人気投票で決まるのでもありません。
Somehow they are trained to it by the culture itself, although they are born to it, not chosen by their peers.''	どういうわけか、生まれついてのことで仲間に選ばれたわけでもないのに、文化そのものによって訓練されているらしいのです。」
He goes on to emphasize that he believes the characteristic style of Fijian chiefs springs from the difficulty of compelling cooperation:	かれはさらに、このフィジーの村長に特有のスタイルは、協力を強制するのがむずかしいという事実からくるのだと思っていることを強調している。
a chief has ``no big carrot or big stick''.	村長は「大きなニンジンも、大きな棒も持っていない」わけだ。
[NO] As a matter of observable fact, people who found successful projects gather more prestige than people who do arguably equal amounts of work debugging and assisting with successful projects.	[NO] 見ればすぐにわかることだが、うまくいったプロジェクトを創始した人のほうが、成功したプロジェクトのデバッグや援助で同じくらいの仕事をした人にくらべて、高い評判を獲得する。
An earlier version of this paper asked	この論文のかつてのバージョンでは、次のような疑問を提示していた：
``Is this a rational valuation of comparative effort, or is it a second-order effect of the unconscious territorial model we have adduced here?''	「これは比較できる作業の価値評価として合理的なものだろうか、それともぼくたちがここで示してきた無意識の領土モデルからくる二次的な副産物なんだろうか？」
Several respondents suggested persuasive and essentially equivalent theories.	何人かのコメントは、説得力ある、基本的には同じ理論を示唆してくれている。
The following analysis by Ryan Waldron <rew@erebor.com> puts the case well:	以下の Ryan Waldron <rew@erebor.com> の分析がこの論点をうまく表現している：
In the context of the Lockean land theory, one who establishes a new and successful project has essentially discovered or opened up new territory on which others can homestead.	「ロック式土地理論の文脈では、新しい成功したプロジェクトを確立した人物は、本質的に新しい領土を開拓して、そこをほかの人たちが入植できるようにしたことになる。
For most successful projects, there is a pattern of declining returns, so that after a while, the credit for contributions to a project has become so diffuse that it is hard for significant reputation to accrete to a late participant,	ほとんどの成功したプロジェクトでは、収益はだんだん減るというパターンがあるので、しばらくすると、プロジェクトへの貢献のクレジットは実に間が空いたものになってきて、後からの参加者には、十分な評価が蓄積しにくくなってしまう。
regardless of the quality of his work.	その人がどんなに高質な仕事をしようとも。
For instance, how good a job would I have to do making modifications to the perl code to have even a fraction of the recognition for my participation that Larry, Tom, Randall, and others have achieved?	たとえば、ぼくがこれからPerlを改善して、Larry や Tom や Randall などが達成した認知のごく一部でも獲得しようと思ったら、本当にすさまじくいい仕事をしなくてはならないだろう。
However, if a new project is founded [by someone else] tomorrow, and I am an early and frequent participant in it, my ability to share in the respect generated by such a successful project is greatly enhanced by my early participation therein	でも、新しいプロジェクトが [だれか別の人によって] 明日にでも創始されたら、そしてぼくが初期の熱心な参加者になったら、そのうまくいったプロジェクトによって生じた尊敬の分け前をもらう能力は、早めに参加していたということによって大きく拡大する
(assuming similar quality of contributions).	（貢献の中身が同程度だったとしても）。
I reckon it to be similar to those who invest in Microoft stock early and those who invest in it later.	たぶん、早めに Micro$oft 株を買った人と、後で投資した人の差に近いと思う。
Everyone may profit, but early participants profit more.	みんな儲かるけれど、早めに買った人はもっと儲かる。
Therefore, at some point I will be more interested in a new and successful IPO than I will be in participating in the continual increase of an existing body of corporate stock.	だからどこかの時点で、ぼくは既存の企業の株が絶えず値上がりするのに加わるよりは、新しい成功する IPO のほうに興味をおぼえるようになるはずだ。」
Ryan Waldron's analogy can be extended.	Ryan Waldron のアナロジーはもっと拡張できる。
The project founder has to do a missionary sell of a new idea that may or may not be acceptable or of use to others.	プロジェクトの創始者は、他の人に受け入れられるか、つかいものになるかもわからない新しいアイデアを、伝道師のように売り込まなくてはならない。
Thus the founder incurs something analogous to an IPO risk	だから創始者は IPO リスクと似たよなものを負担することになる
(of possible damage to their reputation),	（自分の評判へのダメージの可能性として）。
more so than others who assist with a project that has already garnered some acceptance by their peers.	これは、仲間内である程度受け入れられたプロジェクトを手伝った人よりも、負担するリスクが大きい。
The founder's reward is consistent despite the fact that the assistants may be putting in more work in real terms.	創始者の見返りは、実際問題として助手たちが仕事をたくさんつぎ込んでいても、一定だ。
This is easily seen as analogous to the relationship between risk and rewards in an exchange economy.	これは交換経済におけるリスクと見返りの関係として楽に理解できる。
Other respondents have observed that our nervous system is tuned to perceive differences, not steady state.	他の評者たちの見解では、われわれの神経システムは、ちがいを認識するように調整されていて、安定状態には敏感ではない。
The revolutionary change evidenced by the creation of a new project is therefore much more noticeable than the cumulative effect of constant incremental improvement.	新しいプロジェクトの創造によって目的される革命的な変化は、したがってたえまない段階的な改善の集積効果より、ずっと認知されやすい。
Thus Linus is revered as the father of Linux,	だから Linus は Linux の父として尊敬される。
although the net effect of improvements by thousands of other contributors have done more to contribute to the success of the OS than one man's work ever could.	その他何千という貢献者たちによる貢献の純粋量は、Linus 一人の仕事なんかでは絶対に不可能なほど、OS の成功に貢献してはいても。
[HD] The phrase ``de-commoditizing'' is a reference to the Halloween Documents	[HD] 「脱・共有化」（de-commoditizing）ということばは、「ハロウィーン文書」への言及。
in which Microsoft used ``de-commoditize'' quite frankly to refer to their most effective long-term strategy for maintaining an exploitative monopoly lock on customers.	この文書でマイクロソフトは、顧客を収奪できるような独占的囲い込みを維持するための、いちばん有効な長期戦略として、この「脱共有化」を何のためらいもなく提案している。
[GNU] The Free Software Foundation's main website carries an article that summarizes the results of many of these studies.	[GNU]　フリーソフトウェア財団 (Free Software Foundation) の主ウェブサイトは、こうした研究の結果をまとめた記事を載せている。
The quotes in this essay are excerpted from there.	本論での引用はそこから抜粋したものだ。
Acknowledgements	22　謝辞
Robert Lanphier <robla@real.com> contributed much to the discussion of egoless behavior.	Robert Lanphiir <robla@real.com> はエゴのない行動についての議論に大きく貢献してくれた。
Eric Kidd <eric.kidd@pobox.com> highlighted the role of valuing humility in preventing cults of personality.	Eric Kidd <eric.kidd@pobox.com> は、個人崇拝を避ける意味で謙虚さが大事であるという点を明確にしてくれた。
The section on global effects was inspired by comments from Daniel Burn <daniel@tsathoggua.lab.usyd.edu.au>.	全世界的な影響についての章は、Daniel Burn <daniel@tsathoggua.lab.usyd.edu.au> からのコメントに触発された。
Mike Whitaker <mrw@entropic.co.uk> inspired the main thread in the section on acculturation.	Mike Whitaker <mrw@entropic.co.uk> は文化への順応に関する議論の大筋の発想を与えてくれた。
Chris Phoenix <cphoenix@best.com> pointed out the importance of the fact that hackers cannot gain reputation by doing other hackers down.	Chris Phoenix <cphoenix@best.com> は、ハッカーたちは他のハッカーを追い落としても評判を高めることはできないという事実の重要性を指摘してくれた。
Revision 1.210 April 1998esr First published on the Web.	[1998年4月10日] Web上でバージョン1.2を公開。
Revision 1.312 April 1998esr	[1998年4月12日] バージョン1.3。
Typo fixes and responses to first round of public comments.	誤植の訂正と、最初の一般コメント群への対応。
First four items in bibliography.	書誌の最初の4点。
An anonymously contributed observation about reputation incentives operating even when the craftsman is unaware of them.	匿名で寄せられた、評判インセンティブが職人自身も気づかないうちに機能しているという見解を加筆。
Added instructive contrasts with warez d00dz, material on the `software should speak for itself' premise, and observations on avoiding personality cults.	warez d00dzとの示唆的な対照性について加筆、「ソフトは自ら語るべきだ」との考えについての部分加筆、個人崇拝の回避に関する考えを加筆。
As a result of all these changes, the section on `The Problem of Ego' grew and fissioned.	こうした変更の結果、「エゴの問題」の章が拡大して分裂。
Revision 1.716 April 1998esr	[1998年4月16日] バージョン1.7。
New section on `Global implications'	「分野全体としての意義」についての章を追加。
discusses historical tends in the colonization of the noosphere, and examines the `category-killer' phenomenon.	ノウアスフィアの植民地化に関する歴史的トレンドを論じ、「カテゴリーキラー」現象について検討。
Added another research question.	今後の研究課題を追加。
Revision 1.827 April 1998esr	[1998年4月27日] バージョン1.8。
Added Goldhaber to the bibliography.	書誌にGoldhaberを追加。
This is the version that will go in the Linux Expo proceedings.	Linux Expo予稿集に載るのはこのバージョン。
Revision 1.926 May 1998esr	[1998年5月26日] バージョン 1.9。
Incorporated RMS's assertion that he is not anticommercial.	RMSの、自分は反商業主義ではないという主張を追加。
New section on acculturation and academia (thanks to Ross J. Reedstrom, Eran Tromer, Allan McInnes, Mike Whitaker, and others).	「文化適応とアカデミズム」についての章を追加（Ross J. Reedstrom、Eran Tromer、Allen MacInnes 他に感謝）。
More about humility, (`egoless behavior') from Jerry Fass and Marsh Ray.	謙虚さ（「エゴのない行動」）について加筆、Jerry Fass と Marsh Ray からのコメントに基づく。
Revision 1.1011 July 1998esr	[1998年7月11日] バージョン 1.10。
Remove Fare Rideau's reference to `fame' at his suggestion.	本人の示唆に基づき、Fare Rideau のコメントから名声ということばを除く。
Revision 1.1421 November 1998esr	[1998年11月21日] バージョン 1.14。
Minor editorial and stale-link fixes.	ちょっとした編集上の修正と古いリンクの訂正。
Revision 1.2131 Aug 1999esr	[1999年8月8日]
Major revision for the O'Reilly book.	O'Reilly の本用に大幅改訂。
Incorporated some ideas about the costs of forking and rogue patches from Michael Chastain.	Michael Chastain からもらった、プロジェクト分裂のコストと非公式パッチのコストについてのアイデアを組み込む。
Thomas Gagne (tgagne@ix.netcom.com) noticed the similarity between "seniority wins" and database heuristics.	Thomas Gagne <tgagne@ix.netcom.com> は、「年功が勝つ」というのとデータベースのヒューリスティクスの類似性に気がついた。
Henry Spencer's political analogy.	Henry Spencer の政治とのアナロジー。
Ryan Waldron and El Howard (elhoward@hotmail.com) contributed thoughts on the value of novelty.	Ryan Waldron と El Howard <elhoward@hotmail.com> は、目新しさの価値について考えを出してくれた。
Thomas Bryan (tbryan@arlut.utexas.edu) explained the hacker revulsion to ``embrace and extend''.	Thomas Bryan <tbryan@arlut.utexas.edu> は「抱き込んで拡張」に対するハッカーの嫌悪を説明してくれた。
Darcy Horrocks inspired the new section ``How Fine A Gift?''	Darcy Horrocks は新しい章の「どれほどすばらしい贈り物？」の示唆を与えてくれた。
Other new material on the connection to the Maslovian hierarcy of values, and the taboo against attacks on competence.	マスロー式価値のヒエラルキーとの関連についての新しい文章と、能力に対する攻撃に関するタブーについて加筆。
