The arrest of Arsene Lupin	アルセーヌ・ルパンの逮捕
THE strangest of journeys!	とても不思議な旅行だった！
And yet it had begun so well!	あんなにいい感じで始まったのにな！
I, for my part, had never made a voyage that started under better auspices.	あれより良い状況で始まった旅行はなかったよ。
The Province is a swift and comfortable transatlantic liner, commanded by the most genial of men.	アルスター号はスピードが速くて快適な大西洋横断定期船だったし、船員も愛想が良かった。
The company gathered on board was of a very select character.	船には特に選ばれた人たちだけが乗っていた。
Acquaintances were formed and amusements organized.	新たな交友関係ができたし、楽しい遊びも計画された。
We had the delightful feeling of being separated from the rest of the world,	ぼくたちは、ぼくたちだけの世界にいるみたいな心地よい感覚を共有していた。
reduced to our own devices, as though upon an unknown island, and obliged, therefore, to make friends with one another.	まるで未知の島に取り残されたみたいな感覚があって、それ故に互いに親しくならなければいけないように感じたんだ。
And we grew more and more intimate. . . .	だから、みんなすごく親しくなってしまったんだ…。
Have you ever reflected on the element of originality and surprise contained in this grouping of a number of people who, but a day earlier, had never seen one another, and who are now, for a few days, destined to live together in the closest contact, between the infinite sky and the boundless sea, defying the fury of the ocean, the alarming onslaught of the waves, the malice of the winds, and the distressing calmness of the slumbering waters ?	君はこういうふうに考えないかい？驚くべき風変わりなことがここにはあるんだ。今言ったように、それまで互いに知らなかった人たちが、何日間も、無限に続く空と果てしない海との間にある船という閉じた空間で一緒に過ごす運命になって、海の猛威に挑み、波が絶え間なく襲いかかってきたり、転覆するような風や眠っているように不気味に凪いでいる海面の驚異に警告を発したりするんだよ！
Life itself, in fact, with its storms and its greatnesses, its monotony and its variety, becomes a sort of tragic epitome;	そういった生活にはね、嵐も、偉大さも、単調さも複雑さもあるのだからして、一種の悲劇的な主題になりうるんだ。
and that, perhaps, is why we enjoy with a fevered haste and an intensified delight this short voyage of which we see the end.	たぶん、それだからこそ、終わりが見える短期間の船旅を、むりやりにでも非常に熱心に楽しむんだろうね。
But, of late years, a thing has happened	だけど、近年になって事情が変わった。
that adds curiously to the excitement of the passage.	船旅の興奮に新たな要因が加わったんだ。
The little floating island is no longer entirely separated from the world from which we believed ourselves cut adrift.	かっての孤島は、もうぼくたちが思っているような「世界から切り離された空間」ではないんだよ。
One link remains, and is at intervals tied and at intervals untied in mid-ocean.	大海原の真ん中ではときどき切れるんだけど、たまに一本の糸がやってくるんだ。
The wireless telegraph!	無線電信だよ！
As who should say a summons from another world, whence we receive news in the most mysterious fashion!	まるで別世界から召喚を受けるように、今言った不思議な空間にニュースを持ってくるんだ。
The imagination no longer has the resource of picturing wires along which the invisible message glides:	もうメッセージを伝える線を想像することはできない。
the mystery is even more insoluble, more poetic;	神秘は前よりわかりにくくなり、いっそう詩的になってきた。
and we must have recourse to the winds to explain the new miracle.	ぼくたちは、その新しい奇跡を解くのに、風の力を借りなければいけないんだよ。
And so, from the start, we felt that we were being followed, escorted, even preceded by that distant voice	そもそもの始まりから、なにかにあとをつけられているように感じていたし、もうそいつに追いつかれているかも、とか、遠くからささやいてきたかも、という感じさえしていた。
which, from time to time, whispered to one of us a few words from the continent which we had quitted.	ときどき、ぼくたちが後にした大陸から、誰かが乗客のひとりになにかささやいているみたいだったよ。
Two of my friends spoke to me.	友だちが二人、ぼくに話しかけてきた。
Ten others, twenty others sent to all of us, through space, their sad or cheery greetings.	ほかに十人から二十人くらいが、良い悪いにかかわらず、ぼくたちに声を送ってきていた。
Now, on the stormy afternoon of the second day,	そんなある日のこと、航海の二日目に嵐にあったんだ。
when we were five hundred miles from the French coast,	フランスの海岸から五百マイルくらいの地点だった。
the wireless telegraph sent us a message of the following tenor:	無線電信がぼくたちにこんなメッセージを送ってきたんだ。
"Arsene Lupin on board your ship, first class, fair hair, wound on right forearm, travelling alone under alias R--"	アルセーヌルパンキセンチュウニアリ　イットウ　キンパツ　ミギウデニキズ　ヒトリタビ　ナマエヲＲ…
At that exact moment, a violent thunderclap burst in the dark sky.	ここまでメッセージが来たときに、暗い空に激しい雷鳴が響き渡った。
The electric waves were interrupted.	電信はここで終わってしまったんだ。
The rest of the message failed to reach us.	残りはついに届かなかった。
We knew only the initial of the name under which Arsene Lupin was concealing his identity.	ぼくたちには、アルセーヌ・ルパンが身を隠すためにつかう偽名のイニシャルだけしか分からなかったんだ。
Had the news been any other, I have no doubt but that the secret would have been scrupulously kept by the telegraph-clerks and the captain and his officers.	ほかの種類のニュースだったら、電信を受けた船員と船長とで、良心的に秘密を守ることができただろう。
But there are certain events that appear to overcome the strictest discretion.	だけど、今あげたニュースは間違いなく、どんなに慎重に隠そうとしても広まってしまうものだったんだね。
Before the day was past, though no one could have told how the rumor had got about, we all knew that the famous Arsene Lupin was hidden in our midst.	どこから広まったのかは分からないんだけれども、あまり日がたたないうちに、アルセーヌ・ルパンが船にひそんでいることが明らかになってしまった。
Arsene Lupin in our midst!	乗客の中にルパンがいるんだ！
The mysterious housebreaker whose exploits had been related in all the newspapers for months!	もう何ヶ月も、あらゆる新聞にその名が挙がっている、あの不思議な怪盗が！
The baffling individual with whom Ganimard, our greatest detective, had entered upon that duel to the death of which the details were being unfolded in so picturesque a fashion!	フランスの誇る名探偵であるガニマールが、その詳細が絵巻になるような命がけの闘いを挑んだ、あのルパンが！
Arsene Lupin, the fastidious gentleman who confines his operations to country-houses and fashionable drawing-rooms,	アルセーヌ・ルパンは、自らの好みに従って、田舎の邸宅と上流社会の客間でしか仕事をしない紳士なんだ。
and who one night, after breaking in at Baron Schormann's, had gone away empty-handed, leaving his visiting card:	ある夜など、ショルマン男爵家に忍びこんだ後、何もとらずに自分の名刺を置いていったんだよ。
Arsene Lupin	アルセーヌ・ルパン
Gentleman	怪盗紳士
with these words added in pencil:	そこには鉛筆でこう書いてあった。
"Will return when your things are genuine."	「あなたの持ち物が本物になったときに、また参上いたします。」
Arsene Lupin, the man with a thousand disguises,	アルセーヌ・ルパンは、千の顔を持つ男なんだ。
by turns chauffeur, opera-singer, book-maker, gilded youth, young man, old man, Marseillese bagman, Russian doctor, Spanish bull-fighter!	運転手・オペラ歌手・賭元・金持ちの子息・青年・老人・マルセイユの外交官・ロシアの医者・スペインの闘牛士と、なんにでも変装できるんだ！
Picture the situation:	状況はこうだ。
Arsene Lupin moving about within the comparatively restricted compass of a transatlantic liner, nay -- more, within the small space reserved to the first-class passengers -- where one might come across him at any moment, in the saloon, the drawing-room, the smoking-room!	アルセーヌ・ルパンが、大西洋横断定期船という比較的限定された範囲内で動きまわっていて――一等船客という集団の中、と言い換えてもいいね――いつ何時、サロンや客間や喫煙室といった場所ですれ違うかもしれないんだ！
Why, Arsene Lupin might be that gentleman over there . . . or this one close by . . . or my neighbor at table . . . or the passenger sharing my stateroom . . .	アルセーヌ・ルパンはあそこにいる紳士かも……いや、すぐ近くのこの紳士かも……テーブルでとなりにいるあの人か……大広間にいるあの人かもしれない……。
"And just think, this is going to last for five days!"	「考えてもみて、こんな状態があと五日間続くのよ！」
cried Miss Nellie Underdown, on the following day.	次の日にはネリー・アンダーダウン嬢に泣きつかれたよ。
"Why, it's awful!	「何てひどいことでしょう！
I do hope they'll, catch him!"	彼にはぜひ捕まっていただきたいですわ。」
And, turning to me,	そして、ぼくに向かってこう言ったのさ。
" Do say, Monsieur d'Andrezy,	「ねえ教えて、ダンドレジーさん。
you're such friends with the captain,	あなたは船長と仲がよろしかったですわね。
haven't you heard anything?"	なにかお聞きになりまして？」
I wished that I had, if only to please Nellie Underdown.	ネリー・アンダーダウン嬢を喜ばせるために、なにか言ってあげたかったね。
She was one of those magnificent creatures that become the cynosure of all eyes wherever they may be.	だって、彼女はとてもすばらしくて、どこにいても注目の的になる人だったからね。
Their beauty is as dazzling as their fortune.	その美しさは宝石のように輝いていた。
A court of fervent enthusiasts follow in their train.	熱心な崇拝者の列が彼女の後ろにあったよ。
She had been brought up in Paris by her French mother,	ネリーはフランス人の母親によってパリで育てられた。
and was now on her way to Chicago to join her father, Underdown, the American millionaire.	そのときは、彼女の父で、アメリカの大富豪であるアンダーダウン氏の元へ行くためにシカゴへ向かう途中だった。
A friend, Lady Gerland, was chaperoning her on the voyage.	ジェラード嬢という友だちが彼女に付き添っていたよ。
I had paid her some slight attentions from the first.	ぼくは航海のはじめから彼女に興味がなくはなかった。
But, almost immediately, in the rapid intimacy of ocean travel, her charms had gained upon me,	だけどね、航海中に急速に仲が進展して、彼女の魅力にぼくはまいってしまった。
and my emotions now exceeded those of a mere flirtation whenever her great dark eyes met mine.	ネリーの、大きく見開いた黒い目に見つめられると、いつもぼくは単なる気まぐれというには小さすぎる高ぶりを覚えたものだ。
She, on her side, received my devotion with a certain favor.	彼女の方でも、ぼくの献身に特別な好意を抱いてくれたんだ。
She condescended to laugh at my jokes and to be interested in my stories.	ぼくの話には笑ってくれるし、興味を持ってぼくの話を聞いてくれた。
A vague sympathy seemed to respond to the assiduity which I displayed.	ぼくが時折見せる献身に対して、ばくぜんと同情を示してくれたりもしたんだ。
One rival alone, perhaps, could have given me cause for anxiety:	ひとりライバルがいてね、そいつが心配の種だった。
a rather good-looking fellow, well-dressed and reserved in manner,	確かにそいつは美男子だったし、上品な身なりをしていて、マナーも完璧だった。
show silent humor seemed at times to attract her more than did my somewhat "butterfly" Parisian ways.	そいつが静かに話をしだすと、このぼくが示す「あけすけな」パリジャン気質よりも彼女の気をひくらしかった。
He happened to form one of the group of admirers surrounding Miss Underdown at the moment when she spoke to me.	彼もまたアンダーダウン嬢を取り囲む崇拝者のひとりだった。
We were on deck, comfortably installed in our chairs.	ぼくたちはデッキにいて、そこの椅子に気持ちよく座っていた。
The storm of the day before had cleared the sky.	前の日の嵐で、空はすっかり晴れわたっていた。
It was a delightful afternoon.	楽しい午後だったねえ。
"I have heard nothing very definite,"	「確かなことは何も聞いていません。」
I replied.	ぼくはそう答えた。
"But why should we not be able to conduct our own inquiry	「しかし、ぼくたち自身で調査ができないか、そう思っています。
just as well as old Ganimard, Lupin's personal enemy, might do?"	ちょうど、ルパンの個人的な敵だった老ガニマールがやったみたいにうまくできないものでしょうか。」
"I say, you're going very fast!"	「まあ、気が早いこと。」
"Why?	「なぜでしょう？
Is the problem so complicated?"	難しいとお考えなのですか？」
"Most complicated."	「とても難しいですわ。」
"You only say that because you forget the clews	「あなたはひとつ忘れておられます。
which we possess towards its solution."	ぼくたちはすでに解答へ至る道しるべを持っているのです。」
"Which clews?"	「どういうことですの？」
"First, Lupin is travelling under the name of Monsieur R-----."	「第一に、ルパンはＲで始まる名前で旅行している。」
"That's rather vague."	「それはかなりあいまいですわね。」
"Secondly, he's travelling alone."	「第二に、彼はひとりで旅行している。」
"If you consider that a sufficient detail!"	「そんなことがなんになるのでしょう！」
"Thirdly, he is fair."	「第三に、彼は金髪である。」
"Well, then?"	「そうですわね。それで？」
"Then we need only consult the list of first-class passengers and proceed by elimination."	「以上から、ぼくたちは乗船名簿を調べて、あてはまらない人をチェックすればいいのです。」
I had the list in my pocket.	ぼくはポケットに名簿を持っていた。
I took it out and glanced through it:	それを取り出して、目を通していった。
"To begin with, I see that there are only thirteen persons whose names begin with an R."	「まず始めに、名前がＲで始まる人が十三人しかいないことがすでに分かっています。」
"Only thirteen?"	「たった13人ですか？」
"In the first class, yes.	「一等船室にはそれだけです。
Of these thirteen R's, as you can ascertain for yourself,	このことについては、あなたご自身で確かめることができます。
Of these thirteen R's, as you can ascertain for yourself,	うち九人は妻とか子ども、従者を連れています。
That leaves four solitary passengers:	そのため、四人だけが残ります。
the Marquis de Raverdan . . ."	ド・ラベルタン侯爵―。」
"Secretary of legation,"	「公使の秘書ですわ。」
interrupted Miss Underdown.	アンダーダウン嬢がさえぎった。
"I know him."	「私、あの人を存じ上げてます。」
"Major Rawson . . . "	「ローソン中佐……。」
"That's my uncle,"	「私のおじです。」
said someone.	誰かが言った。
"Signor Rivolta . . . "	「リボルタさん……。」
"Here!"	「私だ。」
cried one of us,	ぼくたちの中から声があがった。
an Italian, whose face disappeared from view behind a huge black beard.	その人はイタリア人で、顔はふさふさした黒いあごひげにおおわれていた。
Miss Underdown had a fit of laughing:	アンダーダウン嬢は長いこと笑っていたよ。
"That gentleman is not exactly fair!"	「その人は金髪ではないですわね！」
"Then," I continued,	ぼくは続けた。
"we are bound to conclude that the criminal is the last on the list."	「これによって、ぼくたちはリストの最後に載っている人物こそが犯人であると結論できます。」
"Who is that?"	「それは誰ですの？」
"Monsieur Rozaine.	「ロゼーヌさんです。
Does any one know Monsieur Rozaine?"	誰か、ロゼーヌさんを知っている人はいますか？」
No one answered.	誰も答えなかった。
But Miss Underdown, turning to the silent young man whose assiduous presence by her side vexed me, said:	そのとき、アンダーダウン嬢は、そばで静かにしていた（ぼくはそのことにいらだっていた）青年の方を向いてこう言ったのだ。
"Well, Monsieur Rozaine, have you nothing to say?"	「ねえ、ロゼーヌさん、あなたなにか意見がございまして？」
All eyes were turned upon him.	全員が彼を注目した。
He was fairhaired!	彼はみごとな金髪だった！
I must admit I felt a little shock pass through me.	ぼくは少なからずショックを受けたことを認めるよ。
And the constrained silence that weighed down upon us showed me that the other passengers present also experienced that sort of choking feeling.	ぼくたちを襲った沈黙は、無言のうちに、みなが同じようにショックを受けていることを示していたんだ。
The thing was absurd, however, for, after all, there was nothing in his manner to warrant our suspecting him.	ばかばかしいことだけども、そのときは彼の立ち居振る舞いの中に、疑わしいところはなかったんだ。
"Have I nothing to say?"	「私に何を言えといわれるのですか？」
he replied.	彼は返事をした。
"Well, you see, realizing what my name was and the color of my hair and the fact that I am travelling by myself,	「あなたが言ったとおり、私の名前、髪の色、ひとり旅であること、以上の事実が明らかです。
I have already made a similar inquiry and arrived at the same conclusion.	私はすでに、同じことをして、同じ結論に達しました。
My opinion, therefore, is that I ought to be arrested."	従って、私の意見は、私は逮捕されるべきであると言うことです。」
He wore a queer expression as he uttered these words.	こう告げたときのロゼーヌはとても妙だった。
His thin, pale lips grew thinner and paler eyes were bloodshot.	唇が前よりも薄く、青白くなっていたし、普段は青白いはずの目が血走っていたんだ。
There was no doubt but that he was jesting.	ロゼーヌが冗談を言っていることは明らかだったけど、
And yet his appearance and attitude impressed us.	ぼくたちにはその表情や態度が気になった。
Miss Underdown asked, innocently:	アンダーダウン嬢は、なにげなくこう尋ねたんだ。
"But have you a wound?"	「ですが、傷は持っていらっしゃるのですか？」
"That's true," he said. "The wound is missing."	「ありがたいことに、傷は持っていません。」
With a nervous movement, he pulled up his cuff and uncovered his arm.	ロゼーヌ氏は神経質な感じで袖口をまくり上げて、腕をぼくたちに見せた。
But a sudden idea struck me.	しかし、そのときある考えがぼくの心に浮かんだ。
My eyes met Miss Underdown's:	ぼくの目がアンダーダウン嬢の目と合った。
he had shown his left arm.	ロゼーヌは左の腕を見せたのだ。
And, upon my word. I was on the point of remarking upon this,	ぼくはすぐに、そのことを指摘しようとした。
when an incident occurred to divert our attention.	だがそのとき、ある出来事が起きたんで、みんなの注意がそっちに行ってしまったんだ。
Lady Gerland, Miss Underdown's friend, came running up.	ジェラード嬢（アンダーダウン嬢の友人だよ）が走ってやってきた。
She was in a state of great agitation.	彼女はひどく動揺していた。
Her fellow- passengers crowded round her;	みんながその周りを囲んだ。
and it was only after many efforts that she succeeded in stammering out:	大変な努力の末に、どもりながらも彼女はこう言ったんだ。
"My jewels! . . . My pearls!	「私の宝石……私の真珠
. . . They've all been stolen!"	……全部盗まれたんです！」
No, they had not all been stolen, as we subsequently discovered;	その後ぼくたちが捜索したところによれば、全部が盗まれたわけではなかった。
a much more curious thing had happened:	だけど、もっと不思議なことがあったんだ。
the thief had made a selection!	泥棒はね、盗むものを選んでいたんだ。
From the diamond star, the pendant of uncut rubies, the broken necklaces and bracelets, he had removed not the largest but the finest, the most precious stones -- those,	ダイヤモンドの勲章や、ルビーのペンダント（それ自体は無事だった）や、ネックレスやブレスレット（それらは壊されていた）から、泥棒は、もっとも大きくて、美しくて、価値がある宝石だけを盗んでいったんだ。
in fact, which had the greatest value and at the same time occupied the smallest space.	それだけ持っていくんなら、値段は高いし、同時に、容積も小さくてすむからね。
The settings were left lying on the table.	台座は机の上に荒っぽく置かれていた。
I saw them,	ぼくはそれを見た。
we all saw them,	みんなも見ていたよ。
stripped of their gems like flowers from which the fair, bright-colored petals had been torn.	美しい色とりどりの花びらをちぎられた花みたいに、宝石が座金から抜き取られていたんだよ。
And to carry out this work, he had had, in broad daylight, while Lady Gerland was taking tea, to break in the door of the state-room in a frequented passage, to discover a little jewel-case purposely hidden at the bottom of a bandbox, to open it and make his choice!	この仕事を実行するためには、泥棒は、真っ昼間、ジェラード嬢がお茶を取りに行っている間に、よく人が通る廊下で個室のドアを壊して、バンドボックス［＃注一］の底に隠された小さな宝石箱を見つけて、それを開けて、宝石を選び出す、そういったことをすべてこなさなきゃいけなかったんだ。
We all uttered the same cry.	ぼくも含め、みんなが同じ言葉を叫んだ。
There was but one opinion among the passengers when the theft became known:	この泥棒行為が分かったとき、みんな同じことを考えたんだ。
it was Arsene Lupin.	これはアルセーヌ・ルパンの仕業だ。
And, indeed, the theft had been committed in his own complicated, mysterious, inscrutable . . .	確かに、窃盗行為は彼自身の手で複雑にされ、奇妙で不可解な事件になっていた……。
and yet logical manner,	けれど一方では、論理的なやり口だとぼくなんかは思ったね。
for we realized that, though it would have been difficult to conceal the cumbersome mass which the ornaments as a whole would have formed, he would have much less trouble with such small independent objects as single pearls, emeralds and sapphires.	扱いにくい飾り物を全部隠すのは難しいけれど、真珠やエメラルドやサファイアみたいな、小さいものだけ隠すんなら、そんなに難しくないんだ。
At dinner this happened:	夕食時に変化が起こった。
the two seats to the right and left of Rozaine remained unoccupied.	ロゼーヌの両隣の席は空席になっていた。
And, in the evening, we knew that he had been sent for by the captain.	そして夜になって、ぼくたちはロゼーヌが船長に呼ばれたことを知った。
His arrest, of which no one entertained a doubt, caused a genuine relief.	彼の逮捕（この頃にはみんな、彼がルパンだと信じていた）は、ぼくたちを安心させた。
We felt at last that we could breathe.	ついにぼくたちも呼吸ができるのだ。
We played charades in the saloon.	サロンでシャレード［＃注２］を楽しんだ。
We danced.	ダンスもした。
Miss Underdown, in particular, displayed an obstreperous gayety	アンダーダウン嬢は特に、ぼくに対して無理にでも明るく振る舞った。
which made it clear to me that, though Rozaine's attentions might have pleased her at first, she no longer gave them a thought.	ロゼーヌの心遣いは、最初は彼女の気をひいたんだろうが、もうそのことは頭になかった。
Her charm conquered me entirely.	ぼくは彼女の魅力にまいってしまった。
At midnight, under the still rays of the moon, I declared myself her devoted lover in emotional terms	真夜中になって、まだ月の光が残るなか、ぼくはアンダーダウン嬢に真摯な愛を告白した。
which she did not appear to resent.	それに対して怒った様子はみせなかったよ。
But, the next day, to the general stupefaction,	だが翌日、誰もが仰天することが起こった。
it became known that the charges brought against him were insufficient.	ロゼーヌに対する告訴がまだ不完全だったんだ。
Rozaine was free.	彼が釈放されたんだ。
It seemed that he was the son of a wealthy Bordeaux merchant.	ロゼーヌは、自分はボルドーに住む大商人の息子だと言明した。
He had produced paper's which were in perfect order.	そして、疑問の余地がない正規の書類を提出したんだ。
Moreover, his arms showed not the slightest trace of a wound.	それに、腕には両方とも傷の跡がなかったんだ。
"Papers, indeed!"	「書類は本物なんだろう。」
exclaimed Rozaine's enemies.	ロゼーヌの敵はこう言っていた。
"Birth-certificates!	「出生証明書！
Tush!	フン！
Why, Arsene Lupin can supply them by the dozen!	アルセーヌ・ルパンはそれくらい何ダースも提出できるさ！
As for the wound, it only shows that he never had a wound	傷のことか……傷がないのを見せたにすぎんね。
. . . or that he has removed its traces!"	あるいは、傷跡を消したんだろうよ！」
Somebody suggested that, at the time when the theft was committed, Rozaine -- this had been proved -- was walking on deck.	それに対して、盗みが行われた時間にロゼーヌはデッキを歩いていたんだ（このことは証明されていた）というものもいた。
In reply to this it was urged	それに対しては、こんな反論がなされた。
that, with a man of Rozaine's stamp, it was not really necessary for the thief to be present at his own crime.	ロゼーヌのような男なら、自分自身が働く盗みに立ち会う必要はないだろう。
And, lastly, apart from all other considerations, there was one point upon which the most sceptical hadnothing to say:	それにね、ほかのことはさておき、ロゼーヌを弁護する人たちが決して口にしないことが１つあった。
who but Rozaine was travelling alone, had fair hair, and was called by a name beginning with the letter R?	ロゼーヌ以外に、１人旅で、金髪で、Ｒで始まる名前の人がいるのか？
Who but Rozaine answered to the description in the wireless telegram?	ロゼーヌ以外に、無線電信の内容と一致する人がいるのか？
And when Rozaine, a few minutes before lunch, boldly made for our group,	昼食前に、ロゼーヌが大胆にもぼくたちのグループに近づいてきた。
Lady Gerland and Miss Underdown rose and walked away.	すると、ジェラード嬢とアンダーダウン嬢はすぐにグループを離れていったんだ。
It was a question of pure fright.	明らかに疑っていたんだ。
An hour later, a manuscript circular was passed from hand to hand among the staff of the vessel, the crew, and the passengers of all classes.	一時間後、手書きの告知が出て、船のスタッフ、船員、乗客全員にまわされた。
M. Louis Rozaine had promised a reward of ten thousand francs to whosoever should unmask Arsene Lupin or discover the possessor of the stolen jewels.	Ｍ・ルイス・ロゼーヌがこう提案したんだ。
"And if no one helps me against the ruffian,"	「もし、悪漢を見つけだす試みに賛成する人がいなければ、私が自分でやって見せます。」
said Rozaine to the captain,	とまで船長に言ったそうだ。
The contest between Rozaine and Arsene Lupin,	ロゼーヌ対アルセーヌ・ルパン。
or rather, in the phrase that soon became current, between Arsene Lupin himself and Arsene Lupin, was not lacking in interest.	興味が尽きない闘いだったよ。
It lasted two days.	闘いは二日間続いた。
Rozaine was observed wandering to right and left, mixing with the crew, questioning and ferreting on every hand.	ロゼーヌは至る所を見てまわり、船員に混じって、誰彼となく質問していた。
His shadow was seen prowling about at night.	夜になると、あたりをうろつく彼の影が見えていた。
The captain, on his side, displayed the most active energy.	あとに付き従う船長が一番張り切っていたね。
The Provence was searched from stem to stern, in every nook and corner.	アルスター号は舳先から船尾まで、あらゆるところが捜索された。
Every state-room was turned out, without exception, under the very proper pretext	すべての客室が対象になった。
that the stolen objects must be hidden somewhere -- anywhere rather than in the thief's own cabin.	盗まれた宝石は、泥棒自身の客室を除いてどこかに隠されていなければならない、というもっともな口実があったからね。
"Surely they will end by finding something?"	「これなら、なにか見つかるでしょうね？」
asked Miss Underdown.	アンダーダウン嬢があるときこう言ってきた。
"Wizard though he may be, he can't make pearls and diamonds invisible."	「どんな魔法使いだって、真珠やダイヤを見えなくすることはできませんものね。」
"Of course they will,"	「もちろん見つけるでしょう。」
I replied,	ぼくは言った。
"or else they will have to search the linings of our hats and clothes and anything that we carry about with us."	「もしそうならなければ、あの人たちはぼくたちの帽子や服の裏地とか、所持品をも捜索する必要がありますね。」
And, showing her my five-by-four Kodak,	そういっておいて、五×四型のコダック製カメラを彼女に見せた。
with which I never wearied of photographing her in all manner of attitudes,	彼女の姿勢や表情をいっぱい撮影しようと、飽くなき努力を費やしていたんだ。
I added, "Why, even in a camera no larger than this there would be room to stow away all Lady Gerland's jewels.	「たとえばこのカメラですが、ジェラード嬢の宝石をすべて隠すためにはこれで十分なくらいですよ。
You pretend to take snapshots	あなたは写真を撮るふりをします。
and the thing is done."	そして、すべてが終わるのです。」
"Still, I have heard say that every burglar always leaves a clew of some kind behind him."	「でも、泥棒はみんな現場に証拠を残すものだと聞いたことがありますわ。」
"There is one who never does:	「決してそうしない人が一人だけいます。
Arsene Lupin."	それがアルセーヌ・ルパンなのです。」
"Why?"	「なぜでしょう？」
"Why?	「『なぜでしょう？』と言われますか？
Because he thinks not only of the crime which he is committing, but of all the circumstances that might tell against him."	理由は、アルセーヌ・ルパンはこれから実行する盗みのことを考えるだけでなく、自分に不利な条件もすべて数え上げているからです。」
"You we're more confident at first."	「あなた、最初はもっと自身がおありでしたわ。」
"Ah, but I had not seen him at work then!"	「それは、ルパンの仕事を見たことがなかったからです。」
"And so you think . . . "	「それで、今は……。」
"I think that we are wasting our time."	「ぼくたちは、時間を無駄にしていると思いますね。」
As a matter of fact, the investigations produced no result whatever,	実際、調査の結果何も発見できなかった。
or, at least, that which was produced did not correspond with the general effort:	いや、少なくとも、あれだけ徹底した調査にはみあっていなかった。
the captain lost his watch.	船長の時計がなくなっていたんだ。
He was furious,	船長は怒っていたね。
redoubled his zeal,	さらに力を入れるようになった。
and kept an even closer eye than before on Rozaine, with whom he had several interviews.	以前よりロゼーヌを厳重に監視していたし、何回か会見を持ったりもした。
The next day, with a delightful irony, the watch was found among the second officer's collars.	だがその翌日、皮肉にも、時計は二等航海士のカラー入れから発見されたんだ。
All this was very wonderful, and pointed clearly to the humorous handiwork of a burglar,	すべては非常にすばらしく、泥棒のユーモラスな仕事ぶりを明瞭に示していた。
if you like, but an artist besides.	芸術家以外にはこんなふうにはしないだろうね。
He worked at his profession for a living, but also for his amusement.	アルセーヌ・ルパンにとって、泥棒という仕事は職業としてやるものだったけど、趣味としての側面もそこにはあったんだ。
He gave the impression of a dramatist	劇のような感じを、自分の仕事に与えていた。
who thoroughly enjoys his own plays and who stands in the wings laughing heartily at the comic dialogue and diverting situations which he himself has invented.	自分の脚本を楽しげに演じ、そでに控えて自分で演出した喜劇に笑い転げ、自分でつくり出した状況から目を背けさせるんだ。
He was decidedly an artist in his way;	ルパンはまさに、個性豊かな芸術家だった。
and, when I observed Rozaine, so gloomy and stubborn, and reflected on the two-faced part which this curious individual was doubtless playing, I was unable to speak of him without a certain feeling of admiration....	ぼくは、頑固にふさぎ込んでいるロゼーヌを見ていると、この奇妙な男が間違いなく持っているはずの二面性の影響を受けてしまって、ある種の賞賛なしには彼の話をすることができなかった……。
Well, on the night but one before our arrival in America, the officer of the watch heard groans on the darkest portion of the deck.	さて、アメリカに到着する一日前の夜、当直の船員が、デッキの一番暗いところでうなり声を聞いたそうだ。
He drew nearer, went up, and saw a man stretched at full length, with his head wrapped in a thick, gray muffler, and his hands tied together with a thin cord.	船員がうなり声の主に近寄っていくと、そこには頭を厚手の灰色マフラーで巻かれ、両腕を細いひもで縛られて倒れている男がいたんだ。
They unfastened his bonds, lifted him, and gave him a restorative.	船員は結び目をほどき、彼を助け起こして気付け薬を与えた。
The man was Rozaine.	男はロゼーヌだった。
Yes, it was Rozaine, who had been attacked in the course of one of his expeditions, knocked down, and robbed.	そう、ロゼーヌは捜索中に攻撃され、殴り倒されて、縛られていたのだ。
A visiting-card pinned to his clothes bore these words:	服に名刺が取り付けられていて、そこにはこう書いてあった。
"Arsene Lupin accepts M. Rozaine's ten thousand francs, with thanks."	アルセーヌ・ルパンは謹んでロゼーヌ氏の一万フランを頂戴いたします。
As a matter of fact the stolen pocket-book contained twenty thousand-franc notes.	実際に財布が盗まれていた。
Of course, the unfortunate man was accused of counterfeiting this attack upon his own person.	もちろん、この不運な男は自分自身への襲撃をねつ造したという告発も受けた。
But, apart from the fact that it would have been impossible for him to bind himself in this way, it was proved that the writing on the card differed absolutely from Rozaine's handwriting, whereas it was exactly like that of Arsene Lupin, as reproduced in an old newspaper which had been found on board.	だけどね、発見されたときみたいにきつく自分で自分を縛ることは不可能だったし、それとは別に、名刺の筆跡はロゼーヌのそれとはまったく違っていて、むしろアルセーヌ・ルパンの筆跡（船上で見つかった古新聞に載っていたんだ）と一致していることが証明されたんだ。
So Rozaine was not Arsene Lupin!	つまり、ロゼーヌはアルセーヌ・ルパンではなかったんだ！
Rozaine was Rozaine, the son of a Bordeaux merchant!	ロゼーヌはロゼーヌで、ボルドーの商人の息子だったのだ！
And Arsene Lupin's presence had been asserted once again and by means of what a formidable act!	そして、このような恐ろしい行為によって、アルセーヌ・ルパンの存在が再びよみがえってきたのだ！
Sheer terror ensued.	船中は恐怖に包まれた。
The passengers no longer dared stay alone in their cabins nor wander unaccompanied to the remoter parts of the ship.	乗客は、もう客室に一人でいたり、船の離れに単独でとどまっていたりはしなかった。
Those who felt sure of one another kept prudently together.	互いに大丈夫と確信した人同士で用心深く固まっていた。
And even here an instinctive mistrust divided those who knew one another best.	それでも、本能的に不信感を覚えて、もっとも仲のよかった人同士で仲違いしたりしていた。
The danger no longer threatened from a solitary individual kept under observation and therefore less dangerous.	単独の個人に襲われるという危険ならば、そいつを監視することで、危険でなくすることができただろう。
Arsene Lupin now seemed to be . . . to be everybody.	アルセーヌ・ルパンは、今では誰ででもあるという状態だった……。
Our over-excited imaginations ascribed to him the possession of a miraculous and boundless power.	興奮のあまり、ルパンは神秘的で果てしない力の持ち主だとさえ思われていた。
We supposed him capable of assuming the most unexpected disguises,	一番ありえない種類の変装さえも、彼ならできるだろうってね。
of being by turns the most respectable Major Rawson, or the most noble Marquis de Raverdan, or even -- for we no longer stopped at the accusing initial -- this or that person known to all, and travelling with wife, children and servants.	つまり、尊敬すべきローソン中佐や、高貴なるド・ラベルタン侯爵に変装しているかもしれないのだし、挙げ句の果てに――もう誰もイニシャルのことは考えなくなってたね――知名度の高い人や、妻や子どもや使用人を連れている人でさえも交代で疑われたよ。
The wireless telegrams brought us no news;	無線電信は何も言ってこなかった。
at least, the captain did not communicate them to us.	少なくとも、船長はぼくたちに、そのことについては何も言わなくなった。
And this silence was not calculated to reassure us.	そのことは、不安を解消する役には立たなかった。
It was small wonder, therefore, that the last day appeared interminable.	航海の最終日は永遠に続くように思われた。
The passengers lived in the anxious expectation of a tragedy.	乗客たちは、悲劇的な予想の中に沈み込んでいた。
This time it would not be a theft, it would not be a mere assault; it would be crime -- murder.	なにかが起こるだろう、単なる盗みとか、襲撃とかではなくて、犯罪らしい犯罪、つまり殺人が起こるだろうってね。
No one was willing to admit that Arsene Lupin would rest content with those two insignificant acts of larceny.	アルセーヌ・ルパンがたった二つの盗みで仕事を終わりにすると信じている人はいなかった。
He was absolute master of the ship;	アルセーヌ・ルパンこそが船を支配していた。
he reduced the officers to impotence;	航海士はそれに対して無力だった。
he had but to wreak his will upon us.	ルパンは自由に希望を叶えてきた。
He could do as he pleased;	まさにやりたい放題だった。
he held our lives and property in his hands.	その手にみんなの生命と財産を握っていた。
These were delightful hours to me, I confess,	ぼくにとっては楽しいときでもあったと告白しておこう。
for they won for me the confidence of Nellie Underdown.	なぜなら、ぼくはついにネリー・アンダーダウンの信頼を獲得したんだ。
Naturally timid and impressed by all these events, she spontaneously sought at my side the protection	今までにあげた出来事によって、まったく自然な恐怖に襲われて、ネリーはぼくの保護を求めてきた。
which I was happy to offer her.	喜んで受け入れたよ。
In my heart, I blessed Arsene Lupin.	心のなかで、アルセーヌ・ルパンに感謝した。
Was it not he who had brought us together?	ルパンの存在によって、ぼくとネリーの仲がまとまったのではないのか？
Was it not to him that I owed the right to abandon myself to my fondest dreams?	ぼくが甘い夢に浸ることができるのも、ルパンのおかげではなかったか？
Dreams of love and dreams more practical:	それが恋の夢であり、またそれが実現不可能な夢ではないことを、
why not confess it?	どうして告白しないでいられようか？
The d'Andrezys are of good Poitevin stock, but the gilt of their blazon is a little worn;	ダンドレジー家はポチバンの名家だったが、その名声は少しばかり落ち込んでいた。
and it did not seem to me unworthy of a man of family to think of restoring the lost lustre of his name.	一家の名誉を旧に復することを考える気持ちがぼくの中になかったといえばうそになるだろうね。
Nor, I was convinced, did these dreams offend Nellie.	ぼくの中では、こういった夢想はネリーを怒らせてはいないという確信があった。
Her smiling eyes gave me leave to indulge them.	ネリーの目は微笑んでいた。
Her soft voice bade me hope.	柔らかい声に、ぼくは希望がもてた。
And we remained side by side until the last moment, with our elbows resting on the bulwark rail, while the outline of the American coast grew more and more distinct.	アメリカの海岸が見えてくるころには、ぼくとネリーは、デッキを取り巻く欄干にもたれて、寄り添っていられるようになった。
The search had been abandoned.	犯人の捜索は断念された。
All seemed expectation.	すべては想像の中にあった。
From the first-class saloon to the steerage, with its swarm of emigrants, every one was waiting for the supreme moment when the insoluble riddle would be explained.	一等船客から三等船客（その中には移民する人たちもたくさんいた）まで、すべての乗客が、未解決の謎が説明される最期の一瞬を待っていた。
Who was Arsene Lupin?	誰がアルセーヌ・ルパンだったんだろう？
Under what name, under what disguise was the famous Arsene Lupin lurking?	アルセーヌ・ルパンは、どんな名前で、どんな変装をしてひそんでいたんだろう？
The supreme moment came.	いよいよ最後の瞬間がやってきた。
If I live to be a hundred, never shall I forget its smallest detail.	もし今後百年生きたとしても、細部に至るまでいちいち忘れないだろうね。
"How pale you look, Nellie!"	「青白い顔をしているね、ネリー。」
I said, as she leaned,	寄り添っている彼女にそう言った。
almost fainting, on my arm.	ぼくの腕の中で、ネリーは失神しそうになっていた。
"And you, too.	「あら、あなたもですわ。
0h, how you have changed!"	まるで変わってしまっているわ。」
she replied.	彼女が返事をした。
"Think what an exciting minute this is	「考えてもごらん。
and how happy I am to pass it at your side.	ぼくはあなたのそばにいられて、本当に幸せですよ。
I wonder, Nellie, if your memory will sometimes linger . . ."	ネリー、あなたの記憶の中に、ときどきにでも思いだしてくださると思うと……。」
All breathless and fevered,	ネリーの息が詰まり、熱気を帯びてきた。
she was not listening.	ぼくの言葉が耳に入らないらしかった。
The gang-plank was lowered.	タラップが下げられた。
But before we were allowed to cross it, men came on board:	しかし、ぼくたちがそこを通れるようになるまでにいろんな人たちが甲板にやってきた。
custom-house officers, men in uniform, postmen.	税関吏や制服の男たち、郵便配達員といった人たちだよ。
Nellie murmured:	ネリーがつぶやいた。
"I shouldn't be surprised even if we heard that Arsene Lupin had escaped during the crossing!"	「もしもアルセーヌ・ルパンが船から逃げだしていたとしても、私は驚きませんわ。」
"He may have preferred death to dishonor, and plunged into the Atlantic rather than submit to arrest!"	「彼は逮捕される不名誉よりは死を選ぶでしょうから、大西洋に飛び込んだのかもしれませんね。」
"Don't jest about it,"	「冗談はおよしになって。」
said she, in a tone of vexation.	彼女は悩ましげに言った。
Suddenly I gave a start	突然ぼくは身震いした。
and, in answer to her question, I replied:	理由を聞かれて、こう返事をした。
"Do you see that little old man standing by the gang-plank?"	「タラップのそばにいる、小柄な老人が見えますか？」
"The one in a green frock-coat with an umbrella?"	「傘を差して、緑のブロックコートを着た人のこと？」
"That's Ganimard."	「あれがガニマールです。」
"Ganimard?"	「ガニマール？」
"Yes,	「そうです。
the famous detective who swore that he would arrest Arsene Lupin with his own hand.	必ず自分の手でアルセーヌ・ルパンを逮捕すると誓った、有名な探偵です。
Ah, now I understand why we received no news from this side of the ocean.	ああ、ぼくは今やっと、大西洋のこちら側からニュースが来なかった理由が理解できました。
Ganimard was here,	ガニマールがここにいたんですね。
and he does not care to have any one interfering in his little affairs."	彼は自分の仕事を誰かに邪魔されるのがお嫌いなんだそうです。」
"So Arsene Lupin is sure of being caught?"	「では、ルパンの逮捕は確実ですわね？」
"Who can tell?	「誰にそう言えますか？
Ganimard has never seen him, I believe, except made-up and disguised.	ガニマールは変装をしたルパンにしか会ったことがないということですよ。
Unless he knows the name under which he is travelling . . ."	この旅行で使っている偽名を知っているなら話は別ですがね。」
"Ah," she said, with a woman's cruel curiosity, "I should love to see the arrest!"	「ああ、逮捕される瞬間を見たいですわ。」
"Have patience," I replied.	「待ってみましょう。
"No doubt Arsene Lupin has already observe** his enemy's presence.	アルセーヌ・ルパンもすでに敵の存在に気づいているはずです。
He will prefer to leave among the last when the old man's eyes are tire."	きっと、老人の目が疲れたころになって降りていくつもりでしょう。」
The passengers began to cross the gang-plank.	乗客がタラップを降り始めた。
Leaning on his umbrella with an indifferent air,	ガニマールは、無関心といった感じで、傘にもたれかかっていた。
Ganimard seemed t pay no attention to the throng that crowded past between the two hand-rails.	両側の手すりの間にひしめく人たちになんの注意も払っていないように見えた。
I noticed the ship's officers, standing behind him, whispered in his ear from time to time.	ガニマールのそばに船員が立っていて、ときどきなにかささやいているようだった。
The Marquis de Raverdan, Major Rawson, Rivolta, the Italian, went past, and others and many more.	ド・ラベルタン侯爵、ローソン中佐、イタリア人のリボルタと、乗客が次々に下船していった。
Then I saw Rozaine approaching.	その最後尾に、ロゼーヌが近づいていくのが見えた。
Poor Rozaine!	かわいそうなロゼーヌ！
He did not seem to have recovered from his misadventures!	彼は自分の身にふりかかった出来事から回復していなかった。
"It may be he, all the same,"	「やっぱり彼なのかもしれませんね。」
said Nellie.	ネリーが言った。
"What do you think?"	「どう思われます？」
"I think it would be very interesting to have Ganimard and Rozaine in one photograph.	「一枚の写真にガニマールとロゼーヌをおさめるのもとても面白いですね。
Would you take the camera?	カメラを持っていただけませんか？
My hands are so full."	手がふさがっているので。」
I gave it to her,	ぼくはカメラをネリーに手渡した。
but too late for her to use it.	しかしそれを使うには遅すぎた。
Rozaine crossed.	ロゼーヌが手すりを通っていった。
The officer bent over to Ganimard's ear;	船員がガニマールに何かささやいていた。
Ganimard gave a shrug of the shoulders;	ガニマールは肩をすくめた。
and Rozaine passed on.	ロゼーヌは通りすぎた。
But then who, in Heaven's name, was Arsene Lupin?	だが、そうなると、アルセーヌ・ルパンとは誰なんだろうか？
"Yes," she said, aloud, "who is it!"	「そうだわ、いったい誰なんでしょう。」
There were only a score of people left.	船には二十人だけ乗客が残っていた。
Nellie looked at them, one after the other,	ネリーは彼らを代わる代わる見渡した。
with the bewildered dread that he was not one of the twenty.	アルセーヌ・ルパンが、その中の一人ではありませんようにという、当惑気味な表情を見せながら。
I said to her:	ぼくは彼女に言った。
"We cannot wait any longer."	「ぼくたちも、もう待てませんよ。」
She moved on.	ネリーが動いた。
I followed her.	ぼくもあとに続いた。
But we had not taken ten steps when Ganimard barred our passage.	しかし、十歩も行かないうちに、ガニマールがぼくたちの前に立ちふさがった。
"What does this mean?"	「これはどういうことですか？」
I exclaimed.	ぼくは叫んだ。
"One moment, sir.	「しばらくお待ちいただきます。
What's your hurry?"	何を急いでいるのですか？」
"I am escorting this young lady."	「ぼくは、この方に付き添っているのです。」
"One moment,	「お待ちいただきます。」
he repeated, in a more mysterious voice.	最初のより奇妙な声でガニマールが繰り返した。
He stared hard at me,	ガニマールは熱心にぼくを見つめた。
and then, looking me straight in the eyes, said:	それから、ぼくをまっすぐに見つめ、こう言ったんだ。
"Arsene Lupin, I believe."	「アルセーヌ・ルパンだろう。」
I gave a laugh.	ぼくは笑った。
"Bernard d'Andrezy, simply."	「違います。
"Bernard d'Andrezy died in Macedonia, three years ago."	「ベルナルド・ダンドレジーなら、三年前にマケドニアで死んでいる。」
"If Bernard d'Andrezy were dead I could not be here.	「ベルナルド・ダンドレジーが死んでいるんなら、今ここにいるはずがないでしょう。
And it's not so.	そんなことありえませんよ。
Here are my papers."	ここに身分証明もあります。」
"They are his papers.	「それは確かに彼の書類だ。
And I shall be pleased to tell you how you became possessed of them."	君がどうやってそれを手にいれたか、喜んで君に話してやるよ。」
"But you are mad!	「ですが、間違ってますよ！
Arsene Lupin took his passage under a name beginning with R."	アルセーヌ・ルパンは、Ｒで始まる名前で旅行しているのですよ。」
"Yes, another of your tricks	「そうだ、それもお前のやり方だ。
-- a false scent upon which you put the people on the other side, OH, you have no lack of brains, my lad!	向こうの大陸ではだましおおせたんだろう、ほんとに君は頭がいいよ！
But, this time, your luck has turned.	だが、今度はつきに見放されたな。
Come, Lupin,	来いルパン。
show that you're a good loser."	最後は立派に飾るんだ。」
I hesitated for a second.	ぼくは二の足を踏んだ。
He struck me smart blow on the right forearm.	ガニマールがぼくの右腕に傘をふりおろした。
I gave a cry of pain.	ぼくは「痛い！」と叫んだ。
He had hit the unhealed wound mentioned in the telegram.	電報で言ってただろ、右腕のまだ治ってない傷に当たったんだよ。
There was nothing in it but to submit.	降参するしかなかった。
I turned to Miss Underdown.	ぼくはアンダーダウン嬢の方を見た。
She was listening with a white face, staggering where she stood.	ぼくたちの会話を聞いて、顔面蒼白になり、よろめいていた。
Her glance met mine,	ネリーはぼくを見た。
and then fell upon the Kodak which I had handed her.	その目は次に、ぼくか渡したカメラに注がれた。
She made a sudden movement,	突然体を震わせた。
and I received the impression, the certainty, that she had understood.	間違いなく、彼女も察したんだ。
Yes, it was there	そう、盗品はカメラの中にあったんだ。
-- between the narrow boards covered with black morocco, inside the little camera which I had taken the precaution to place in her hands before Ganimard arrested me -- it was there that Rozaine's twenty thousand francs' and Lady Gerland's pearls anddiamonds lay concealed.	小さいカメラの中に、黒いモロッコ皮でおおわれた空間があってね、その中に、ロゼーヌの二万フランとジェラード嬢の真珠とかダイヤとかを隠していたんだ。
Now I swear that, at this solemn moment,	神に誓って言おう。
with Ganimard and two of his minions around me, everything was indifferent to me -- my arrest, the hostility of my fellow-men, everything save only this:	この厳粛な、ガニマールと二人の部下に囲まれた一瞬において、ぼくの逮捕や人たちの敵意といったようなものにはなんの意味もなかった。
the resolve which Nellie Underdown would take in regard to the object I had given into her charge.	ただ一つ、ネリー・アンダーダウンがこのぼくの裏切り行為に対してどう行動するのか、それだけが問題だった。
Whether they had this material and decisive piece of evidence against me, what cared I?	そのときネリーは、ぼくに対する重要かつ決定的に不利な証拠を握っていた。
The only question that obsessed my mind was, would Nelly furnish it or not?	そうじゃないよ、ネリーがその証拠を警察に提出するかどうかだけが重要だったのさ。
Would she betray me?	彼女はぼくを裏切るだろうか？
Would she ruin me?	ぼくを破滅させるだろうか？
Would she act as an irreconcilable foe, or as a woman who remembers, and whose contempt is softened by a touch of indulgence -- a shade of sympathy?	ネリーはぼくの敵となる行動をとるのか、はたまたぼくとの想い出を胸に残し、このぼくに少しばかり同情と寛大さを見せてもらえるだろうか、それだけが気になっていた。
She passed before me.	ネリーがぼくの前を通りすぎた。
I bowed very low, without a word.	ぼくは黙って深々と頭を下げた。
Mingling with the other passengers, she moved towards the gang-board,	ほかの乗客に混じって、ネリーはタラップの方へ進んでいった。
carrying my Kodak in her hand.	手にはコダックカメラを持ったままだった。
"Of course,"	「当然だろう。」
I thought,	ぼくは考えた。
"she will not dare to, in public.	「人が大勢いる中ではそんな勇気はないはずだ。
She will hand it over presently -- in an hour."	ここを通り抜けて１時間もしたら、当局に提出するつもりなんだろう。」
But, on reaching the middle of the plank, with a pretended movement of awkwardness, she dropped the Kodak in the water, between the landing-stage and the ship's side.	ところが、タラップの真ん中あたりに来たとき、ぎこちない動きで、ネリーが船と桟橋の間に見える海にコダックカメラを落としたんだ。
Then I watched her walk away.	そしてぼくは彼女が去っていくのを見た。
Her charming profile was lost in the crowd,	ぼくを魅了した横顔が群衆の中に消えた。
came into view again, and disappeared.	また現れて、見えなくなった。
It was over -- over for good and all.	これで終わりだった―永遠に終わりだった。
For a moment I stood rooted to the deck,	しばらくはデッキで動けなかった。
sad and, at the same time, pervaded with a sweet and tender emotion.	悲しかったけれど、心の奥ではあの甘美な感情に支配されていたんだ。
Then, to Ganimard's great astonishment, I sighed:	ガニマールも非常にびっくりしてたけどね、ぼくはため息をついてこんなことを言っていたんだ。
"Pity, after all, that I'm a rogue!"	「この身が恨めしい……すべて、ぼくが悪かったんだ……。」
It was in these words that Arsene Lupin, one winter's evening, told me the story of his arrest Chance and a series of incidents	以上が、ある冬の日に、アルセーヌ・ルパンが、自分が逮捕された瞬間について話してくれたことです。
which I will some day describe had established between us bonds of . . . shall I say friendship?	いずれ書くつもりですが、ふとしたことから、私たちの間には友情（あえてこう書きましょう）が成立していたのです。
Yes, I venture to think that Arsene Lupin honors me with a certain friendship;	私はアルセーヌ・ルパンと光栄にも確かな友情を結んでいる、とさえ考えています。
and it is owing to this friendship that he occasionally drops in upon me unexpectedly,	私の不意をついて時折尋ねてくるのも、この友情のおかげなのでしょう。
bringing into the silence of my study his youthful gayety, the radiance of his eager life, his high spirits	アルセーヌ・ルパンは、私の静かな書斎に、若々しい陽気さ、真剣なる人生の輝き、気高い精神を持ち込んでくれます。
-- the spirits of a man for whom fate has little but smiles and favors in store.	ただ微笑と好意とでしか報われない運命にある人間だけが持つあの精神のことです。
His likeness?	彼の風貌ですか？
How can I trace it?	なぜ私に言えましょうか？
I have seen Arsene Lupin a score of times, and each time a different being has stood before me	私はもう二十回もルパンを見ましたが、いつも違った顔で私の前に現れるのです。
. . . or rather the same being under twenty distorted images reflected by as many mirrors,	というか、同じ一人の人間でありながら、多くの鏡みたいに二十の異なったイメージを残していくのです。
each image having its special eyes, its particular facial outline, its own gestures, profile and character.	おのおのが違った目を持ち、それぞれ違う輪郭、ふるまい、生い立ち、個性を持っているのです。
"I myself," he once said to me, "have forgotten what I am really like.	かつて彼が私に言ったことがあります。
I no longer recognize myself in a glass."	鏡の中にさえ、ぼく自身を認められないんだよ。」
A paradoxical whim of the imagination, no doubt;	もちろん、これは逆説的な警句でしょう。
and yet true enough as regards those who come into contact with him, and who are unaware of his infinite resources, his patience, his unparalleled skill in make-up, and his prodigious faculty for changing even the proportions of his features one to the other.	でも、彼とのつきあいを持ち、その無限の能力や忍耐力、並ぶものがないメーキャップ技術、自分の特徴さえも自由にある顔から別の顔へと変えてしまう恐るべき能力に気づかない人にとっては、間違いなく真実なのです。
"Why," he asked, "should I have a definite fixed appearance?	ルパンは私にこう言いました。
Why not avoid the dangers attendant upon a personality that is always the same?	常に同じ個性でいるなんて、危険じゃないかね？
My actions constitute my identity sufficiently."	ぼくの行動だけで十分独創的なのにさ。」
And he added, with a touch of pride:	そして、やや誇らしげにこうつけ加えました。
"It is all the better if people are never able to say with certainty: 'There goes Arsene Lupin.'	「だれにだって『アルセーヌ・ルパンがここにいるぞ。』と確信を持って言えないならなおけっこう。
The great thing is that they should say without fear of being mistaken: 'That action was performed by Arsene Lupin.'"	大切なことは、『これこそアルセーヌ・ルパンがやったことだ。』と間違いなしに言わせることなんだよ。」
It is some of those actions of his, some of those exploits, that I will endeavor to narrate,	これから彼の功績を、ほんの一部ではありますが、お目にかけようと思っています。
thanks to the confidences with which he has had the kindness to favor me on certain winter evenings in the silence of my study....	あんな冬の日に、わざわざ私の静かな書斎にやってきて、私に対する好意から、打ち明け話をしてくれたルパンには、本当に感謝しています……。
