INTERVIEW WITH KARL MARX,	カール・マルクス Interview
London, July 3 -- You have asked me to find out something about the International Association, and I have tried to do so.	インターナショナルについて何かを調べ出せ、という依頼に応えて、わたしは努力してきた。
The enterprise is a difficult one just now.	この団体は現在、非常に難しい状況にある。
London is indisputably the headquarters of the Association, but the English people have got a scare, and smell International in everything as King James smelled gunpowder after the famous plot.	ロンドンは間違いなくこの団体の本拠地だが、イギリス人たちはおびえており、ジェームズ王が陰謀のあとで何を見ても火薬のにおいをかぎつけてしまったのと同様に、何があってもインターナショナルの関与を疑うような状態になってしまっている。
The consciousness of the Society has naturally increased with the suspiciousness of the public;	この組織の意識は、公衆からの疑惑に伴って高まった。
and if those who guide it have a secret to keep, they are of the stamp of men who keep a secret well.	そしてこの組織を導く者たちに何か秘密があるとするならば、かれらこそは秘密をよく守る人間の鏡である。
I have called on two of their leading members, have talked with one freely,	わたしはその指導者級のメンバー 2 人と連絡をとり、1 人と気さくにことばをかわした。
and I here give you the substance of my conversation.	そしてその内容を以下にお示しする。
I have satisfied myself of one thing,	わたしは以下のことを得心した。
that it is a society of genuine workingmen, but that these workmen are directed by social and political theories of another class.	すなわち、インターナショナルは本物の労働者の集団ではあるが、その労働者を導いているのは別の階級出身の社会政治理論家たちである。
One man whom I saw, a leading member of the Council, was sitting at his workman's bench during our interview, and left off talking to me from time to time to receive a complaint,	わたしの面会したそのうちの 1 人は、インタビューの間中、工員のベンチにすわり、時々わたしとの会話を中断して苦情を受けていた。
delivered in no courteous tone, from one of the many little masters in the neighborhood who employed him.	その苦情はかれの雇い主である数多くの班長の一人からのもので、遠慮会釈のない代物だった。
I have heard this same man make eloquent speeches in public	この同じ人物が雄弁な演説を公衆の前で行うのを聞いたことがある。
inspired in every passage with the energy of hate toward the classes that call themselves his rulers.	一節ごとに、自らを支配者と称する階級に対する憎悪のエネルギーをこめていた。
I understood the speeches after this glimpse at the domestic life of the orator.	この話者の一般生活をこうしてのぞき見てから、わたしはあの演説が理解できた。
He must have felt that he had brains enough to have organized a working government,	かれは、自分が完全な政府を組織できるだけの頭脳があると自負しているにちがいない。
and yet here he was obliged to devote his life to the most revolting taskwork of a mechanical profession.	それなにの、ここでのかれは工員というもっとも敬遠される作業に人生を費やさざるを得ないのだ。
He was proud and sensitive, and yet at every turn he had to return a bow for a grunt and a smile for a command that stood on about the same level in the scale of civility with a huntsman's call to his dog.	かれは誇り高く繊細であり、それでいながらことあるごとに、小言に対して会釈を返し、猟師が猟犬に下す命令と同程度の文化性しかない命令に対して笑みを返さなくてはならなかったのだ。
This man helped me to a glimpse of one side of the nature of the International,	この人物は、インターナショナルの一面についてわたしにかいま見せてくれた。
the result of Labor Against Capital of the workman who produces against the middleman who enjoys.	それは労働の資本に対する蜂起、生産する労働者の享受する中間層に対する蜂起である。
Here was the hand that would smite hard when the time came, and as to the head that plans, I think I saw that too, in my interview with Dr. Karl Marx.	それは時がきたれば力強く叩きつぶすであろう手であり、そしてそれを計画する頭についても、わたしは以下のカール・マルクス博士とのインタビューのなかでかいま見たように思う。
Dr. Karl Marx is a German doctor of philosophy, with a German breadth of knowledge derived both from observation of the living world and from books.	カール・マルクス博士はドイツの PhD であり、実際の生きた社会の観察と書物の両方から抽出された広いドイツ的知識を持っている。
I should conclude that he has never been a worker in the ordinary sense of the term.	また、かれが通常の意味での労働者であったことはないと述べておこう。
His surroundings and appearance are those of a well-to-do man of the middle class.	かれをとりまく環境もその外見も、中産階級の裕福な人物のものである。
The drawing room into which I was ushered on the night of the interview would have formed very comfortable quarters for a thriving stockbroker who had made his competence and was now beginning to make his fortune.	わがインタビューの晩にわたしが通された書斎は、才覚をあらわして財を築きはじめた気鋭の証券ブローカーの部屋としても適切なものだったろう。
It was comfort personified, the apartment of a man of taste of easy means, but with nothing in it peculiarly characteristic of its owner.	非常に個人的に快適なものとなっており、趣味のよい気さくな人物のアパートだったが、その持ち主についてことさら何かを告げるわけではなかった。
A fine album of Rhine views on the table, however, gave a clue to his nationality.	ライン川の眺めを描いた立派なアルバムが机の上に広げられ、それがかれの出自のヒントとなっている。
I peered cautiously into the vase on the sidetable for a bomb.	わたしは爆弾をさがして慎重にサイドテーブルの花瓶をのぞきこんだ。
I sniffed for petroleum, but the smell was the smell of roses.	石油のにおいを求めて鼻をならしたが、嗅げたのはバラの香りだけだった。
I crept back stealthily to my seat, and moodily awaited the worst.	わたしはこっそり自分の椅子に戻り、陰鬱な気分で最悪の事態を待った。
He has entered and greeted me cordially, and we are sitting face to face.	かれは部屋に入り、わたしを礼儀正しく迎え、そしていまやわれわれは向き合ってすわっている。
Yes, I am tete-a-tete with the revolution incarnate, with the real founder and guiding spirit of the International Society, with the author of the address in which capital was told that is it warred on labor, it must expect to have its house burned down about its ears -- in a word, with the Apologist for the Commune of Paris.	そう、わたしはあの革命の主導者、インターナショナルの本物の創始者にして指導精神たる人物、資本に対し、もし労働とやりあうつもりなら家に焼き討ちをかけられるであろうという宣言を書いた人物――つまりはパリ・コミューンの弁護人と、サシで向かい合っているのだ。
Do you remember the bust of Socrates?	ソクラテスの胸像をご記憶だろうか。
The man who died rather than profess his belief in the Gods of the time	当時の神への信仰を告白するよりも死を選んだ人間。
-- the man with the fine sweep of profile for the forehead running meanly at the end into a little snub, curled-up feature, like a bisected pothook, that formed the nose.	横顔にあの見事な額のでっぱりを持ち、それが終わりの方で、鼻を形作る団子状に丸まった、切断された鈎のようなものに陰険につながっているのを？
Take this bust in your mind's eye, color the beard black, dashing it here and there with puffs of gray;	この胸像を思い浮かべつつ、ひげを黒く染め、あちこちに灰色を散らしてみるといい。
clap the head thus made on a portly body of the middle height,	こうしてできた頭を、恰幅のいい中背の身体にのせてみよう。
and the Doctor is before you.	あなたの目の前にいるのが博士だ。
Throw a veil over the upper part of the face, and you might be in the company of a born vestryman.	顔の上半分にヴェールをかぶせると、生まれながらの教区民と言っても通用する。
Reveal the essential feature, the immense brown, and you know at once that you have to deal with that most formidable of all composite individual forces -- a dreamer who thinks, a thinker who dreams.	しかし本質的な部分である巨大な眉をあらわにすれば、すぐに自分が相手をしているのが、あらゆる組み合わせ力の中でも最も驚嘆すべきものであることがわかるだろう――考える夢見者、夢見る思考家だ。
I went straight to my business.	わたしはすぐに本題に入った。
The world, I said, seemed to be in the dark about the International,	世界は、インターナショナルについて五里霧中です、とわたしは述べた。
hating it very much, but not able to say clearly what thing it hated.	それを非常に嫌ってはいるものの、その嫌悪の対象がいかなるものなのかについて、はっきりとは言えない状態なのです。
Some, who professed to have peered further into the gloom than their neighbors, declared that they had made out a sort of Janus figure with a fair,	その霧の中を他の者より深くまでのぞきこんだと告白する一部の者は、そこに二つの顔を持つヤヌスの姿を見たと申しています。
honest workman's smile on one of its faces, and on the other, a murderous conspirator's scowl.	その一つの顔は、善良で正直な労働者の笑みを浮かべてるが、そのもう一つの顔には血に飢えた陰謀家の歪んだ表情が見えた、と。
Would he light up the case of mystery in which theory dwelt?	この理論を根付かせている謎を解明すべく光を当ててはいただけないものだろうか？
The professor laughed,	教授は笑った。
chuckled a little I fancied, at the thought that we were so frightened of him.	おそらくは多少の嘲笑もこめていたのだろう、われわれがかくもかれにおびえているということについて。
"There is no mystery to clear up, dear sir," he began, in a very polished form of the Hans Breitmann dialect,	「解明すべき謎などございませんよ」とかれは、非常に洗練されたドイツ訛で口を開いた。
"except perhaps the mystery of human stupidity in those who perpetually ignore the fact	「ただ唯一あるとすれば、人間の愚かしさというものの謎かもしれませんな。
that out Association is a public one, and that the fullest reports of its proceedings are published for all who care to read them.	われわれの団体は秘密でもなんでもなく、その議事録は一言一句が出版されていて、読みたければだれでも読めるという事実を果てしなく無視し続けるのですから。
You may buy our rules for a penny, and a shilling laid out in pamphlets will teach you almost as much about us as we know ourselves.	あなたもわれわれの綱領を一ペニーで購入できますし、パンフレットに一シリングお出しいただければ、われわれが自分で知っているのとほとんど同じくらいのことを、あなたもわれわれについて知ることができるのです。
R. [Landor]: Almost -- yes,	――いま、「ほとんど同じくらい」とおっしゃいました。
perhaps so;	そうかもしれません。
but will not the something I shall not know constitute the all-important reservation?	が、しかしそれでは知り得ない部分が、一番重要な秘匿部分なのではありますまいか。
To be quite frank with you, and to put the case as it strikes an outside observer, this general claim of depreciation of you must mean something more than the ignorant ill will of the multitude.	正直に申し上げますが、そして外部の観察者が持つ印象に従っていわせていただきますが、世間一般にこうしたあなたの主張が割り引かれて受け取られているというのは、大衆の無知による悪意という以上のものがあるにちがいないと思われるのです。
And it is still pertinent to ask, even after what you have told me, what is the International Society?	そして今おっしゃったことのあとで、敢えておたずねするのが不躾でないならば、そもそもインターナショナルとな何なのでしょうか？
Dr. M.: You have only to look at the individuals of which it is composed -- workmen.	マルクス：それを構成する個人を見ればわかることです――労働者たちです。
R.: Yes,	――ええ。
but the soldier need be no exponent of the statecraft that sets him in motion.	しかしながら、兵士はそれを突き動かす国家体の具現であるとは限りません。
I know some of your members,	あなたがたのメンバーには何人か会いました。
and I can believe that they are not of the stuff of which conspirators are made.	そしてかれらが陰謀家のような代物でないことは信じられます。
Besides, a secret shared by a million men would be no secret at all.	だいたい、百万人の知る秘密はもはや秘密とは呼べませんから。
But what if these were only the instruments in the hands of a bold, and, I hope you will forgive me for adding, not overscrupulous conclave?	しかしながら、これらの成員たちが単なる道具にすぎず、それがもっと強力で、こう付け加えるのをお許し願いたいのですが、大胆な秘密会議の手に握られているとしたらどうでしょう。
Dr. M.: There is nothing to prove.	マルクス：そんな証拠は一つもないでしょう。
R.: The last Paris insurrection?	――先日のパリの暴動は？
Dr. M.: I demand firstly the proof that there was any plot at all -- that anything happened that was not the legitimate effect of the circumstances of the moment;	マルクス：まずそもそも何らかの陰謀があったという証明を是非ともお願いしたいものです――あそこで起こったことがすべて、あの時点における状況の必然的な帰結でなかったという証明を。
or the plot granted, I demand the proofs of the participation in it of the International Association.	あるいは、そこに陰謀があったとしても、それにインターナショナルが荷担していたという証拠をお示し願いたいものです。
R.: The presence of the communal body of so many members of the Association.	――インターナショナルのメンバーたちが数多く集団で参加していました。
Dr. M.: Then it was a plot of the Freemasons, too, for their share in the work as individuals was by no means a slight one.	マルクス：ではそれがフリーメーソンの陰謀だとも言えるわけですな、個人として参加していたフリーメーソン会員の数は多大なものでしたから。
I should not be surprised, indeed, to find the Pope setting down the whole insurrection to their account.	ローマ法王なら、まさにあの暴動をすべてフリーメーソンのせいにすることでしょう。そうなってもわたしは驚きませんがね。
But try another explanation.	しかしながら、他に説明のしようがあるのではないですか。
The insurrection in Paris was made by the workmen of Paris.	パリの暴動は、パリの労働者によるものです。
The ablest of the workmen must necessarily have been its leaders and administration,	労働者の中でもっとも有能なものが、その暴動の指導者であり指揮者であったことはまちがいないでしょう。
but the ablest of the workmen happen also to be members of the International Association.	しかしながら、もっとも有能な労働者は、同時にインターナショナルの会員でもあったのです。
Yet, the Association, as such, may be in no way responsible for their action.	でも、だからといって集団としてのインターナショナルは、かれらの行動にいささかも責任があるわけではない。
R.: It will seem otherwise to the world.	――でも世間はそうは考えますまい。
People talk of secret instruction from London, and even grants of money.	人々は、ロンドンから秘密指令が下ったとうわさしておりますし、資金まで出たとも申しております。
Can it be affirmed that the alleged openness of the Association's proceedings precludes all secrecy of communication?	インターナショナルの議事の表面上の公開性を主張なさっていますが、連絡上の秘密すら完全に存在しないのだと考えていいわけなんでしょうか。
Dr. M.: What association ever formed carried on its work without private as well as public agencies?	マルクス：これまで組織された団体の中で、公開部分とそうでない部分を両方持たずに仕事を行ってきたものなどありませんよ。
But to talk of secret instruction from London, as of decrees in the matter of faith and morals from some centre of papal domination and intrigue, is wholly to misconceive the nature of the International.	しかしながら、ロンドンからの秘密指令などという話は、中央のローマ教皇的な圧制と策謀から真義と道徳に関わる託宣が下されるようなお話ですが、そもそもインターナショナルの性格を完全に誤解したものです。
This would imply a centralized form of government for the International, whereas the real form is designedly that which gives the greatest play to local energy and independence.	もしそれが事実なら、インターナショナルは中央集権化された政治形態を持っているということになりますが、その実際の形態は地域のエネルギーと自主独立性を最も重視するよう設計されているのです。
In fact, the International is not properly a government for the working class at all.	実のところ、インターナショナルは労働階級の政府とすら正しくは申せません。
It is a bond of union rather than a controlling force.	それは組合の連合であって、制御する力ではないのです。
R.: And of union to what end?	――してその組合の目的とは？
Dr. M.: The economical emancipation of the working class by the conquest of political power.	マルクス：政治権力の奪取による労働者の経済的解放です。
The use of that political power to the attainment of social ends.	そしてその政治権力を、社会の目標のために行使することです。
It is necessary that our aims should be thus comprehensive to include every form of working-class activity.	したがって、われわれの活動はあらゆる労働階級の活動を包含する広範なものでなくてはならない。
To have made them of a special character would have been to adapt them to the needs of one section -- one nation of workmen alone.	ある特殊な性格のものにすれば、それを一部セクションのニーズに合わせることになります――つまり労働者だけの国家、ということです。
But how could all men be asked to unite to further the objects of a few?	しかしながら、少数者の目的を追求するために、すべての人々に団結するようお願いしたりなんかできないでしょう。
To have done that, the Association must have forfeited its title to International.	それをするなら、インターナショナルはその名前を捨てなくてはならない。
The Association does not dictate the form of political movements;	この団体は、政治運動の形態を指示するものではない。
it only requires a pledge as to their end.	その目的に対して言質を与えるものなんです。
It is a network of affiliated societies spreading all over the world of labor.	それは労働の世界津々浦々に広がる、結びあった社会のネットワークなんです。
In each part of the world, some special aspect of the problem presents itself, and the workmen there address themselves to its consideration in their own way.	世界の各部分で、問題のそれぞれ別の面が露呈してきて、その地の労働者はそれぞれ独自のやりかたで、自分たちの関心事に対応していくんです。
Combinations among workmen cannot be absolutely identical in detail in Newcastle and in Barcelona, in London and in Berlin.	労働者の中での組み合わせは、細かいところでは絶対にちがってきます。ニューキャッスルとバルセロナとではちがうし、ロンドンとベルリンでもちがう。
In England, for instance, the way to show political power lies open to the working class.	たとえばイギリスでは、労働階級にとって政治的な力を示す方法はさまざまに開かれています。
Insurrection would be madness where peaceful agitation would more swiftly and surely do the work.	平和的なアジテーションが迅速かつ確実に目的を達成できるのに、暴動を起こすなんてきちがい沙汰です。
In France, a hundred laws of repression and a mortal antagonism between classes seem to necessitate the violent solution of social war.	フランスでは、何百という抑圧的な法律と階級間の道徳的な反目のため、社会的戦争という暴力的な解決方法が必要となるようですね。
The choices of that solution is the affair of the working classes of that country.	その解決方法の選択は、その国の労働階級の問題です。
The International does not presume to dictate in the matter and hardly to advise.	インターナショナルはその点について、指示するつもりはありませんし、ほとんど助言さえ与えません。
But to every movement it accords its sympathy and its aid within the limits assigned by its own laws.	しかし、そのすべての運動に対して、インターナショナルは共感を寄せ、自分の規定によって課された制限の範囲内で支援をさしのべるのです。
R.: And what is the nature of that aid?	――して、その支援とはいかなる性質のものなのでしょうか。
Dr. M.: To give an example, one of the commonest forms of the movement for emancipation is that of strikes.	マルクス：たとえばですね、解放運動のもっとも一般的な形態は、ストライキです。
Formerly, when a strike took place in one country, it was defeated by the importation of workmen from another.	かつて、ある国でストライキが起こると、それは別の国から労働者が輸入されることによって打倒されてしまいました。
The International has nearly stopped all that.	インターナショナルは、これをほぼ完全に止めました。
It receives information of the intended strike, it spreads that information among its members, who at once see that for them the seat of the struggle must be forbidden ground.	ストの計画を報されると、メンバーたちにその情報を広め、かれらはすぐにその闘争の地が不可侵なものとなるよう手配します。
The masters are thus left alone to reckon with their men.	主人たちは、自分たちの雇い人と交渉するしかなくなります。
In most cases, the men require no other aid than that.	ほとんどの場合、これ以上の支援は必要とされません。
Their own subscriptions, or those of the societies to which they are more immediately affiliated, supply them with funds, but should the pressure upon them become too heavy, and the strike be one of which the Association approves, their necessities are supplied out of the common purse.	かれら自身の会費や、かれらがもっと直接的に関わっている社会が資金を供給しますが、かれらへの圧力が重くなりすぎて、そのストライキがインターナショナルの認めるものとなれば、共通財源から必要資金が供給されます。
By these means, a strike of the cigar makers of Barcelona was brought to a victorious issue the other day.	この手段によって、バルセロナの葉巻製造者のストは先日勝利をもって終わりました。
But the Society has not interest in strikes,	しかしながら、社会はストライキに興味はありません。
though it supports them under certain conditions.	ただし、限られた状況下でそれを支持することはありますが。
It cannot possibly gain by them in a pecuniary point of view, but it may easily lose.	金銭的な視点からいえば、社会がストライキで何かを得ることは絶対になく、むしろ失うことのほうが多いでしょう。
Let us sum it all up in a word.	一言で要約するとこういうことです。
The working classes remain poor amid the increase of wealth, wretched amid the increase of luxury.	労働階級は、富の増加のなかで貧しいままにおかれ、奢侈の増加の中で窮乏のままにおかれるのです。
Their material privation dwarfs their moral as well as their physical stature.	その物質的な欠乏は、道徳的な地位や肉体的な地位をも貶めるのです。
They cannot rely on others for a remedy.	それに対して他の者たちに頼ることもできません。
It has become then with them an imperative necessity to take their own case in hand.	このようにして、かれら自身が自分たちに関わる事象を自ら掌握することが、避けがたい必須事項となったのです。
They must revive the relations between themselves and the capitalists and landlords,	労働者は、自分たちの内部における相互の関係や、資本家たちや地主との関係を改めなくてはなりません。
and that means they must transform society.	ということはつまり、社会を変えなくてはならないと言うことです。
This is the general end of every known workmen's organization;	これが現存するあらゆる労働者組織の最終目標です。
land and labor leagues, trade and friendly societies, co-operative production are but means toward it.	土地組合や労働組合、交易組織や友愛組織、生協店舗や共同生産は、そこに到達するための手段にすぎません。
To establish a perfect solidarity between these organizations is the business of the International Association.	これらの組織の間に完全な結束を作り出すのがインターナショナルの仕事です。
Its influence is beginning to be felt everywhere.	その影響は、あちこちに見られるようになってきています。
Two papers spread its views in Spain, three in Germany, the same number in Austria and in Holland, six in Belgium, and six in Switzerland.	スペインでは二紙、ドイツでは三紙、オーストリアとオランダでも同数、ベルギーでは六紙、スイスでも六紙がわれわれの考えを広めています。
And now that I have told you what the International is, you may, perhaps, be in a position to form your own opinion as to its pretended plots.	さて、インターナショナルのなんたるかを説明いたしましたので、それが陰謀に加担したとかいうお話についてご自分なりの見解をまとめていただけるかと思いますが。
R.: And Mazzini, is he a member of your body?	――ではマツィーニは、あなたがたの一員ですか。
Dr. M.: (laughing) Ah, no.	マルクス：（笑いながら）いやいや。
We should have made but little progress if we had not got beyond the range of his ideas.	かれの思想の枠内にとどまっていたら、われわれはほとんど進歩しなかったことでしょう。
R.: You surprise me.	――これは驚きですね。
I should certainly have thought that he represented most advanced views.	わたしはてっきり、かれが一番進歩的な考え方の代表だと考えていたのですが。
Dr. M.: He represents nothing better than the old idea of a middle-class republic.	マルクス：かれが代表しているのは、古くさい中産階級共和国の考え方にすぎません。
We want no part of the middle class.	われわれは中産階級とはなんら関係を持つつもりはないのです。
He has fallen as far to the rear of the modern movement as the German professors,	マツィーニは現代運動の最後尾にまで脱落してしまい、いまやドイツの教授たちといっしょです。
who, nevertheless, are still considered in Europe as the apostles of the cultured democratism of the future.	かれらも、ヨーロッパでは未だに未来の文化的民主主義の使徒と思われていますがね。
They were so, at one time -- before '48, perhaps,	まあ、一時はそうでした――たぶん 48 年以前までは。
when the German middle class, in the English sense, had scarcely attained its proper development.	当時はイギリス的な意味でのドイツの中産階級は、まだしかるべき発展をほとんど遂げていませんでした。
But now they have gone over bodily to the reaction, and the proletariat knows them no more.	しかしながら、いまやかれらは相対として反動側に行ってしまったので、プロレタリアートとはもはや袂を分かちました。
R.: Some people have thought they saw signs of a positivist element in your organization.	――あなたの結社に実証主義的な面を見ようとする人々もおりますが。
Dr. M.: No such thing.	マルクス：そんなものはありません。
We have positivists among us, and others not of our body who work as well.	会員に実証主義者はおりますし、会員ではなくてもいっしょに活動する人々の中にも、そうした者はおります。
But this is not by virtue of their philosophy, which will have nothing to do with popular government, as we understand it, and which seeks only to put a new hierarchy in place of the old one.	しかしながらこれはその哲学のためではありませんし、われわれの理解しているような人民政府とも関係なく、古い階級関係にかわって新しい階級関係をつくりだそうとするだけのものです。
R.: It seems to me, then, that the leaders of the new international movement have had to form a philosophy as well as an association themselves.	――すると、インターナショナルの指導者たちは結社のみならず新しい哲学を生み出さねばならないように思えるのですが。
Dr. M.: Precisely.	マルクス：まさにその通り。
It is hardly likely, for instance, that we could hope to prosper in our war against capital if we derive our tactics, say, from the political economy of Mill.	たとえば、資本に対する戦いにおいて、もしミルの政治経済学から戦術を引き出すなら、われわれに大した勝利は望めますまい。
He has traced one kind of relationship between labor and capital.	かれは労働と資本の関係の一種類をたどってみせました。
We hope to show that it is possible to establish another.	われわれは、別の関係をうちたてることが可能だと示したいのです。
R.: And the United States?	――ではアメリカは？
Dr. M.: The chief concerns of our activity are for the present among the old societies of Europe.	マルクス：われわれの主要な活動拠点は、今のところヨーロッパの旧社会の中にあります。
Many circumstances have hitherto tended to prevent the labor problem from assuming an all-absorbing importance in the United States.	いままでは、多くの状況のため、アメリカでは労働問題がすべてを圧倒する大問題とはなってきませんでした。
But they are rapidly disappearing, and it is rapidly coming to the front there with the growth, as in Europe, of a laboring class distinct from the rest of the community and divorced from capital.	しかしながらそうした状況は急速に消滅しつつありますし、ヨーロッパで見られたのと同様、労働階級がコミュニティの他の部分とは別個に成長し、資本から切り離されるにつれて、急速に全面に出て来つつあります。
R.: It would seem that in this country the hoped-for solution, whatever it may be, will be attained without the violent means of revolution.	――このイギリスにおいては、あなたが希望なさっている解決は、なんであれ革命という暴力的な手段に頼らずに実現されるものと思うのですが。
The English system of agitating by platform and press, until minorities become converted into majorities, is a hopeful sign.	演説や新聞によってアジテーションを行い、少数派が転向して多数派になるというイギリス式のシステムは希望が持てると思うのですが。
Dr. M.: I am not so sanguine on that point as you.	マルクス：その点、わたしはあなたほど楽天的ではありません。
The English middle class has always shown itself willing enough to accept the verdict of the majority, so long as it enjoyed the monopoly of the voting power.	イギリスの中産階級は、自分たちが投票の独占を保てる場合には、多数派の審判を受け入れる用意があることを常に示してきました。
But, mark me, as soon as it finds itself outvoted on what it considers vital questions, we shall see here a new slaveowners's war.	しかしながら賭けてもいいが、中産階級がきわめて重要な問題と考える点について投票で破れたばあい、この国でも新たな奴隷所有者の戦争が起こることでしょう。
I have given you, as well as I can remember them, the heads of my conversation with this remarkable man.	わたしはこの印象的な人物との会話の趣旨を、記憶できた限り再現した。
I shall leave you to form your own conclusions.	結論を出すのはお任せする。
Whatever may be said for or against the probability of its complicity with the movement of the Commune, we may be assured that in the International Association, the civilized world has a new power in its midst, with which it must soon come to a reckoning for good or ill.	コミューン運動への関与について、肯定的・否定的に何を言われているにしても、インターナショナルは、よかれ悪しかれ文明社会が自らの中にあるものとして認識せざるを得ない新しい力を持つものであることはまちがいない。
