THE MERMAID DEN LILLE HAVFRUE	人魚のひいさま
Hans Christian Andersen	ハンス・クリスティアン・アンデルセン
Far out at sea the water is as blue as the bluest cornflower, and as clear as the clearest crystal;	はるか、沖合へでてみますと、海の水は、およそうつくしいやぐるまぎくの花びらのように青くて、あくまですきとおったガラスのように澄みきっています。
but it is very deep, too deep for any cable to fathom,	でも、そこは、ふかいのなんのといって、どんなにながく綱（つな）をおろしても底にとどかないというくらいふかいのです。
and if many steeples were piled on the top of one another they would not reach from the bed of the sea to the surface of the water.	お寺の塔を、いったい、いくつかさねて積み上げたら、水の上までとどくというのでしょうか。
It is down there that the Mermen live.	そういうふかい海の底に、海のおとめたち――人魚のなかまは住んでいるのです。
Now don't imagine that there are only bare white sands at the bottom;	ところで、海の底なんて、ただ、からからな砂地があるだけだろうと、そうきめてしまってはいけません。
oh no! the most wonderful trees and plants grow there, with such flexible stalks and leaves, that at the slightest motion of the water they move just as if they were alive.	どうして、そこには、世にもめずらしい木や草がたくさんしげっていて、そのじくや葉のしなやかなことといったら、ほんのかすかに水がゆらいだのにも、いっしょにゆれて、まるで生きものがうごいているようです。
All the fish, big and little, glide among the branches just as, up here, birds glide through the air.	ちいさいのも、おおきいのも、いろんなおさかなが、その枝と枝とのなかをつうい、つういとくぐりぬけて行くところは、地の上で、鳥たちが、空をとびまわるのとかわりはありません。
The palace of the Merman King lies in the very deepest part;	この海の底をずっと底まで行ったところに、海の人魚の王さまが御殿をかまえています。
its walls are of coral and the long pointed windows of the clearest amber,	その御殿の壁は、さんごでできていて、ほそながく、さきのとがった窓は、すきとおったこはくの窓でした。
but the roof is made of mussel shells which open and shut with the lapping of the water.	屋根は貝がらでふけていて、海の水がさしひきするにつれて、貝のふたは、ひとりでにあいたりしまったりします。
This has a lovely effect,	これはなかなかうつくしいみものでした。
for there are gleaming pearls in every shell, any one of which would be the pride of a queen's crown.	なぜといって、一枚一枚の貝がらには、それひとつでも女王さまのかんむりのりっぱなそうしょくになるような、大きな真珠（しんじゅ）がはめてあるのでしたからね。
The Merman King had been for many years a widower, but his old mother kept house for him;	ところで、この御殿のあるじの王さまは、もうなが年のやもめぐらしで、そのかわり、年とったおかあさまが、いっさい、うちのことを引きうけておいでになりました。
she was a clever woman, but so proud of her noble birth that she wore twelve oysters on her tail, while the other grandees were only allowed six.	このおかあさまは、りこうな方でしたけれど、いちだんたかい身分をほこりたさに、しっぽにつける飾りのかきをごじぶんだけは十二もつけて、そのほかはどんな家柄のものでも、六つから上つけることをおゆるしになりませんでした。
Otherwise she was worthy of all praise,	――そんなことをべつにすれば、たんとほめられてよい方でした。
especially because she was so fond of the little mermaid princesses, her grandchildren.	とりわけ、お孫さんにあたるひいさまたちのおせわをよくなさいました。
They were six beautiful children, but the youngest was the prettiest of all; her skin was as soft and delicate as a roseleaf, her eyes as blue as the deepest sea,	それはみんなで六人、そろってきれいなひいさんたちでしたが、なかでもいちばん下のひいさまが、たれよりもきりょうよしで、はだはばらの花びらのようにすきとおって、きめがこまかく、目はふかいふかい海のようにまっ青でした。
but like all the others she had no feet, and instead of legs she had a fish's tail.	ただほかのひいさまたちとおなじように、足というものがなくて、そこがおさかなの尾になっていました。
All the livelong day they used to play in the palace in the great halls,	ながいまる一日、ひいさまたちは、海の底の御殿の、大広間であそびました。
where living flowers grew out of the walls.	そとの壁からは、生きた花が咲きだしていました。
When the great amber windows were thrown open the fish swam in,	大きなこはくの窓をあけると、おさかながつういとはいって来ます。
just as the swallows fly into our rooms when we open the windows,	それはわたしたちが窓をあけると、つばめがとび込んでくるのに似ています。
but the fish swam right up to the little princesses, ate out of their hands, and allowed themselves to be patted.	ただ、おさかなは、すぐと、ひいさまたちの所まで泳いで行って、その手からえさをとってたべて、なでいたわってもらいました。
Outside the palace was a large garden, with fiery red and deep blue trees,	御殿のそとには、大きな花園があって、はでにまっ赤な木や、くらいあい色の木がしげっていました。
the fruit of which shone like gold, while the flowers glowed like fire on their ceaselessly waving stalks.	その木の実は金のようにかがやいて、花はほのおのようにもえながら、しじゅうじくや葉をゆらゆらさせていました。
The ground was of the finest sand, but it was of a blue phosphorescent tint.	海の底は、地面からしてもうこまかい砂でしたが、それは硫黄（ゆおう）の火のように青く光りました。
Everything was bathed in a wondrous blue light down there; you might more readily have supposed yourself to be high up in the air, with only the sky above and below you, than that you were at the bottom of the ocean.	そこでは、なにもかも、ふしぎな、青い光につつまれているので、それはふかい海の底にいるというよりも、なにか宙（ちゅう）に浮いていて、上にも下にも青空をみているようでした。
In a dead calm you could just catch a glimpse of the sun	海のないでいるときには、お日さまが仰げました。
like a purple flower with a stream of light radiating from its calyx.	それはむらさきの花のようで、そのうてなからながれだす光が、海の底いちめんひろがるようにおもわれました。
Each little princess had her own little plot of garden, where she could dig and plant just as she liked.	ひいさまたちは、めいめい、花園のなかに、ちいさい花壇（かだん）をもっていて、そこでは、すき自由に、掘りかえすことも植えかえることもできました。
One made her flower-bed in the shape of a whale;	ひとりのひいさまは、花壇を、くじらの形につくりました。
another thought it nice to have hers like a little mermaid;	するともうひとりは、じぶんのは、かわいい人魚に似せたほうがいいとおもいました。
but the youngest made hers quite round like the sun, and she would only have flowers of a rosy hue like its beams.	ところが、いちばん下のひいさまは、それをまんまるく、そっくりお日さまのかたちにこしらえて、お日さまとおなじようにまっ赤に光る花ばかりを咲かせました。
She was a curious child, quiet and thoughtful,	このひいさまはひとりちがって、ふしぎとものしずかな、かんがえぶかい子でした。
and while the other sisters decked out their gardens with all kinds of extraordinary objects which they got from wrecks, she would have nothing besides the rosy flowers like the sun up above, except a statue of a beautiful boy.	ほかのおねえさまたちが、難船した船からとって来ためずらしい品物をならべたててよろこんでいるとき、このひいさまだけは、うつくしい大理石の像をひとつとって来て、大空のお日さまの色に似た、ばら色の花の下に、それをおいただけでした。
It was hewn out of the purest white marble and had gone to the bottom from some wreck.	それはまっ白にすきとおる石をきざんだ、かわいらしい少年の像で、難破（なんぱ）して海の底にしずんだ船のなかにあったものでした。
By the statue she planted a rosy red weeping willow which grew splendidly,	この像のわきに、ひいさまは、ばら色したしだれやなぎを植えました。
and the fresh delicate branches hung round and over it, till they almost touched the blue sand	それがうつくしくそだって、そのみずみずしい枝が像をこして、むこうの赤い砂地の上までたれました。
where the shadows showed violet, and were ever moving like the branches.	そこに濃（こ）いむらさきの影ができて、枝といっしょにゆれました。
It looked as if the leaves and the roots were playfully interchanging kisses.	それはまるで、こずえのさきと根とがからみあって、たわむれているようにみえました。
Nothing gave her greater pleasure than to hear about the world of human beings up above;	このひいさまにとつて、海の上にある人間の世界の話をきくほど、おおきなよろこびはありません。
she made her old grandmother tell her all that she knew about ships and towns, people and animals.	おばあさまにせがむと、船のことや、町のことや、人間やけもののことや、知っていらっしゃることはなにもかも話してくださいました。
But above all it seemed strangely beautiful to her that up on the earth the flowers were scented, for they were not so at the bottom of the sea;	とりわけ、ひいさまにとってめずらしくおもわれたのは、海の底ではついないことなのに、地の上では、お花がにおっているということでした。
also that the woods were green, and that the fish which were to be seen among the branches could sing so loudly and sweetly that it was a delight to listen to them.	それと、森がみどり色していて、その森のこずえのなかに、おさかなが、高い、かわいらしい声で歌がうたえて、それがきくひとの耳をたのしくするということでした。
You see the grandmother called little birds fish,	その、おばあさまがおさかなとおっしゃったのは、小鳥のことでした。
or the mermaids would not have understood her, as they had never seen a bird.	だって、ひいさまたちは、小鳥というものをみたことがないのですもの、そういって話さなければわからないでしょう。
'When you are fifteen,'	「まあ、あなたたち、十五になったらね。」
said the grandmother,	と、おばあさまはいいました。
'you will be allowed to rise up from the sea	「そのときは、海の上へ浮かび出ていいおゆるしをあげますよ。
and sit on the rocks in the moonlight, and look at the big ships sailing by, and you will also see woods and towns.'	そうすれば、岩に腰をかけて、お月さまの光にひたることもできるし、大きな船のとおるところもみられるし、森や町だってみられるようになるよ。」
One of the sisters would be fifteen in the following year,	来年は、いちばん上のおねえさまが、十五になるわけでした。
but the others,--well, they were each one year younger than the other, so that the youngest had five whole years to wait before she would be allowed to come up from the bottom, to see what things were like on earth.	でも、ほかのおねえさまたちは――そう、めいめい、一年ずつ年がちがっていましたから、いちばん下のひいさまが、海の底からあがっていって、わたしたちの世界のようすをみることになるまでには、まる五年も待たなければなりません。
But each one promised the others to give a full account of all that she had seen, and found most wonderful on the first day.	でも、ひとりがいけば、ほかのひとたちに、はじめていった日みたこと、そのなかでいちばんうつくしいとおもったことを、かえって来て話す約束ができました。
Their grandmother could never tell them enough, for there were so many things about which they wanted information.	なぜなら、おばあさまのお話だけでは、どうも物たりなくて、ひいさまたちの知りたいとおもうことが、だんだんおおくなって来ましたからね。
None of them was so full of longings as the youngest, the very one who had the longest time to wait, and who was so quiet and dreamy.	そのなかでも、いちばん下のひいさまは、あいにく、いちばんながく待たなくてはならないし、ものしずかな、かんがえぶかい子でしたから、それだけたれよりもふかくこのことをおもいつづけました。
Many a night she stood by the open windows and looked up through the dark blue water which the fish were lashing with their tails and fins.	いく晩もいく晩も、ひいさまは、あいている窓ぎわに、じっと立ったまま、くらいあい色した水のなかで、おさかながひれやしっぽをうごかして、およぎまわっているのをすかしてみていました。
She could see the moon and the stars, it is true;	お月さまと星もみえました。
their light was pale, but they looked much bigger through the water than they do to our eyes.	それはごくよわく光っているだけでしたが、でも水をすかしてみるので、おかでわたしたちの目にみえるよりは、ずっと大きくみえました。
When she saw a dark shadow glide between her and them,	ときおり、なにかまっ黒な影のようなものが、光をさえぎりました。
she knew that it was either a whale swimming above her, or else a ship laden with human beings.	それが、くじらがあたまの上をおよいでとおるのか、またはおおぜい人をのせた船の影だということは、ひいさまにもわかっていました。
I am certain they never dreamt that a lovely little mermaid was standing down below, stretching up her white hands towards the keel.	この船の人たちも、はるか海の底に人魚のひいさまがいて、その白い手を、船のほうへさしのべていようとは、さすがにおもいもつかなかったでしょう。
The eldest princess had now reached her fifteenth birthday,	さて、いちばん上のひいさまも、十五になりました。
and was to venture above the water.	いよいよ、海の上に出られることになりました。
When she came back she had hundreds of things to tell them, but the most delightful of all, she said, was to lie in the moonlight, on a sandbank in a calm sea, and to gaze at the large town close to the shore,	このおねえさまがかえって来ると、山ほどもおみやげの話がありましたが、でも、なかでいちばんよかったのは、波のしずかな遠浅（とおあさ）の海に横になりながら、すぐそばの海ぞいの大きな町をみていたことであったといいます。
where the lights twinkled like hundreds of stars; to listen to music and the noise and bustle of carriages and people,	そこでは、町のあかりが、なん百とない星の光のようにかがやいていましたし、音楽もきこえるし、車や人の通るとよめきも耳にはいりました。
to see the many church towers and spires, and to hear the bells ringing;	お寺のまるい塔と、とがった塔のならんでいるのが見えたし、そこから、鐘の音もきこえて来ました。
and just because she could not go on shore she longed for that most of all.	でも、そこへ上がっていくことはできませんから、ただなにくれと、そういうものへのあこがれで、胸をいっぱいにしてかえって来たということでした。
Oh, how eagerly the youngest sister listened!	まあ、いちばん下のひいさまは、この話をどんなに夢中できいたことでしょう。
and when, later in the evening she stood at the open window and looked up through the dark blue water, she thought of the big town with all its noise and bustle,	それからというもの、あいた窓ぎわに立って、くらい色の水をすかして上を仰ぐたんびに、このひいさまは、いろいろの物音ととよめきのする、その大きな町のことをかんがえました。
and fancied that she could even hear the church bells ringing.	するうち、そこのお寺の鐘の音が、つい海の底までも、ひびいてくるようにおもいました。
The year after, the second sister was allowed to mount up through the water and swim about wherever she liked.	そのあくる年、二ばんめのおねえさまが、海の上へあがって行って、好きな所へおよいでいっていい、おゆるしがでました。
The sun was just going down when she reached the surface, the most beautiful sight, she thought, that she had ever seen.	このあねえさまが、浮き上がると、そのときちょうどお日さまが沈みましたが、これこそいちばんうつくしいとおもったものでした。
The whole sky had looked like gold, she said, and as for the clouds! well, their beauty was beyond description;	大空がいちめん金をちらしたようにみえて、その光をうつした雲のきれいだったこと、とてもそれを書きあらわすことばはないといいました。
they floated in red and violet splendour over her head, and, far faster than they went,	くれないに、またむらさきに、それがあたまの上をすうすう通ってながれていきました。
a flock of wild swans flew like a long white veil over the water towards the setting sun;	けれども、その雲よりももっとはやく、野のはくちょう［＃「はくちょう」は底本では「はくちょう」］のむれが、それはながい、白いうすものが空にただようように、しずんで行く夕日を追って、波の上をとんでいきました。
she swam towards it, but it sank and all the rosy light on clouds and water faded away.	このおねえさまも、これについてまけずにおよいでいきましたが、そのうち、お日さまはまったくしずんで、ばら色の光は、海の上からも、雲の上からも消えていきました。
The year after that the third sister went up,	また次の年には、三ばんめのおねえさまが上がっていきました。
and, being much the most venturesome of them all, swam up a broad river which ran into the sea.	このおねえさまは、たれよりもむこうみずな子でしたから、大きな川が海にながれだしている、そこの川口をさかのぼっておよいでいってみました。
She saw beautiful green, vine-clad hills;	そこにはぶどうのつるにおおわれたうつくしいみどりの丘がみえました。
palaces and country seats peeping through splendid woods.	むかしのお城や荘園（しょうえん）が、みごとに茂った森のなかからちらちらしていました。
She heard the birds singing,	いろんな鳥のうたいかわす声も聞きました。
and the sun was so hot that she was often obliged to dive, to cool her burning face.	するうちお日さまが、照りつけて来たので、ほてった顔をひやすために、たびたび水にもぐらなくてはなりませんでした。
In a tiny bay she found a troop of little children	水がよどんでちいさな入江になった所で、かわいい人間のこどもたちのかたまって、あそんでいるのに出あいました。
running about naked and paddling in the water;	まるはだかで、かけまわって、ぼちゃぼちゃ水をはねかしました。
she wanted to play with them, but they were frightened and ran away.	いっしょにあそぼうとすると、みんなおどろいて逃げていってしまいました。
Then a little black animal came up;	するとそこへ、ちいさな、まっ黒な動物がでて来ました。
it was a dog, but she had never seen one before; it barked so furiously at her that she was frightened and made for the open sea.	これは犬でしたが、犬なんて、みたことはなかったし、いきなり、はげしくほえかかって来たので、こわくなって、またひろい海へおよいでもどりました。
She could never forget the beautiful woods, the green hills and the lovely children who could swim in the water although they had no fishes' tails.	でも、あのうつくしい森もみどりの丘も、それから、おさかなのしっぽももっていないくせに、水におよげるかわいらしいこどもたちのことをも、このひいさまは、いつまでもわすれることができませんでした。
The fourth sister was not so brave; she stayed in the remotest part of the ocean, and, according to her account, that was the most beautiful spot.	さて、四ばんめのおねえさまは、それほどむこうみずではありませんでしたから、そこで、ひろい大海のまんなかに居ずくまったままでしたが、でもそこがどこよりもいちばんうつくしかったと話しました。
You could see for miles and miles around you, and the sky above was lifke a great glass dome.	もうぐるりいちめん、なんマイルと先の知れないとおくまで見はらせて、あたまの上の青空は、とほうもなく大きなガラス鐘のようなものでした。
She had seen ships,	船というものもみました。
but only far away, so that they looked like sea-gulls.	でも、それはただ遠くにはなれていて、まるでかもめのようにみえていました。
There were grotesque dolphins turning somersaults, and gigantic whales squirting water through their nostrils like hundreds of fountains on every side.	それからおどけもののいるかが、とんぼがえりしたり、大きなくじらが鼻のあなから、しおをふきだして、そのへんいちめんに、なん百とない噴水がふきだしたようでした。
Now the fifth sister's turn came.	こんどは、五ばんめのおねえさまの番になりました。
Her birthday fell in the winter, so that she saw sights that the others had not seen on their first trips.	このひいさまは、おたん生日が、ちょうど冬のあいだでしたので、ほかのおねえさまたちのみなかったものをみました。
The sea looked quite green, and large icebergs were floating about,	海はふかいみどり色をたたえて、その上に、氷の山がまわりをとりまいて浮いていました。
each one of which looked like a pearl, she said, but was much bigger than the church towers built by men.	そのひとつびとつが白く光って、まるで真珠（しんじゅ）の山のようでしたが、それも人間の建てたお寺の塔よりもずっと高いものだつたといいました。
They took the most wonderful shapes, and sparkled like diamonds.	それがまたきみょうともふしぎともいいようのないかたちをして、どれもダイヤモンドのようにちかちか［＃「ちかちか」は底本では「ちかちが」］かがやいていました。
She had seated herself on one of the largest, and all the passing ships sheered off in alarm when they saw her sitting there with her long hair streaming loose in the wind.	このおねえさまは、そのなかのいちばん大きい山に腰をかけて、そのながい髪の毛を風のなぶるままにさせていますと、そのまわりに寄って来た帆船（ほぶね）の船頭は、みんなおどろいて、船をかえしました。
In the evening the sky became overcast with dark clouds; it thundered and lightened, and the huge icebergs glittering in the bright lightning, were lifted high into the air by the black waves.	でも、夕方になると空は雲でつつまれて、かみなりが鳴ったり、いなづまが走ったり、まっ黒な波が大きな氷の山を高くつき上げて、いなづまのつよい光にあてました。
All the ships shortened sail, and there was fear and trembling on every side,	のこらずの船が帆をおろして、そこには、おそれとおののきとがたかまっていました。
but she sat quietly on her floating iceberg watching the blue lightning flash in zigzags down on to the shining sea.	けれども、人魚のむすめは、へいきで、ちかちか光る氷の山の上に腰をのせたまま、かがやく海の上に、いなづま形に射かける稲光（いなびかり）の青い色をながめていました。
The first time any of the sisters rose above the water she was delighted by the novelties and beauties she saw;	さて、こうして、おねえさまたちは、めいめいに、はじめて海の上へ浮かんで出てみた当座（とうざ）こそ、まのあたりみた、めずらしいもの、うつくしいものに心をうばわれました。
but once grown up, and at liberty to go where she liked, she became indifferent and longed for her home;	けれども、いまは一人まえのむすめになって、いつどこへでも好きかってにいかれるとなると、もうそれも心をひかなくなりました。
in the course of a month or so they all said that after all their own home in the deep was best, it was so cosy there.	またうちがこいしくなって来て、やがて、ひと月もすると、やはり海の底ほどけしきのいい所はどこにもないし、うちほどけっこうな住居（すまい）はないわ、といいあうようになりました。
Many an evening the five sisters interlacing their arms would rise above the water together.	もういく晩も、夕方になると、五人のおねえさまたちは、おたがい手を組んで、つながって、水の上へあがっていきました。
They had lovely voices, much clearer than any mortal,	みんな、どんな人間もおよばないうつくしい声をもっていました。
and when a storm was rising, and they expected ships to be wrecked, they would sing in the most seductive strains of the wonders of the deep, bidding the seafarers have no fear of them.	あらしが来かけると、やがて船はしずむほかないことが分かっていますから、みんなして船のそばへおよいでいって、やさしい歌をうたってやりました。
But the sailors could not understand the words,	でも、そのことばは、人間には分かりません。
they thought it was the voice of the storm;	それをやはりあらしの音だとおもっていました。
nor could it be theirs to see this Elysium of the deep,	それにまた、しずんでいくひとたちが、しずみながら海の底をみるなんて、そんなうまいわけにはいかないのです。
for when the ship sank they were drowned,	なぜなら、船がしずむと、それなり船人はおぼれてしまいます。
and only reached the Merman's palace in death.	そうして、しかばねになって、人魚の王さまの御殿へはこばれてくるのですもの。
When the elder sisters rose up in this manner, arm-in-arm, in the evening, the youngest remained behind quite alone,	きょうだいたちが、こうして手をつないで、夕方、水の上へあがっていくとき、いちばん下のひいさまだけは、いつもひとりぼっちあとにのこっていました。
looking after them as if she must weep;	そうしてみんなのあとをみおくっていると、なんだか泣かずにいられない気持になりました。
but mermaids have no tears,	けれども［＃「けれども」は底本では「けれとも」］、海おとめには、涙というものがないのです。
and so they suffer all the more.	そのため、よけい、せつないおもいをしました。
'Oh! if I were only fifteen!'	「ああ、あたし、どうかしてはやく十五になりたいあ。」
she said,	と、このひいさまはいいました。
'I know	「あたしにはわかっている。
how fond I shall be of the world above, and of the mortals who dwell there.'	あの上の世界でも、そこにうちをつくって住んでいる人間でも、あたしきっと好きになれるでしょう。」
At last her fifteenth birthday came.	するうち、とうとう、ひいさまも十五になりました。
'Now we shall have you off our hands,'	「さあ、いよいよ、あなたも、わたしの手をはなれるのだよ。」
said her grandmother, the old queen-dowager.	と、ごいんきょのおばあさまがおっしゃいました。
'Come now, let me adorn you like your other sisters!'	「では、いらっしゃい、おねえさまたちとおなじように、あなたにもおつくりをしてあげるから。」
and she put a wreath of white lilies round her hair,	こういって、おばあさまは、白ゆりの花かんむりを、ひいさまの髪にかけました。
but every petal of the flowers was half a pearl;	でも、その花びらというのが、一枚一枚、真珠（しんじゅ）を半分にしたものでした。
then the old queen had eight oysters fixed on to the princess's tail to show her high rank.	それからまだおばあさまは、八つまで、大きなかきを、ひいさまのしっぽにすいつかせて、それを高貴（こうき）な身分のしるしにしました。
'But it hurts so!'	「そんなことをおさせになって、あたし、いたいわ。」
said the little mermaid.	と、ひいさまはいいました。
'You must endure the pain for the sake of the finery!'	「身分だけにかざるのです。
said her grandmother.	と、おばあさまは、おっしゃいました。
But oh! how gladly would she have shaken off all this splendour,	ああ、こんなかざりものなんか、どんなにふり捨てたかったでしょう。
and laid aside the heavy wreath.	おもたい花かんむりなんか、どんなにほうりだしたかったでしょう、
Her red flowers in her garden suited her much better,	ひいさまは、花壇に咲いている赤い花のほうが、はるかよく似合うことはわかっていました。
but she did not dare to make any alteration.	でも、いまさら、それをどうすることもてきません。
'Good-bye,'	「いってまいります。」
she said, and mounted as lightly and airily as a bubble through the water.	と、ひいさまはいって、それはかるく、ふんわりと、まるであわのように、水の上へのぼっていきました。
The sun had just set when her head rose above the water,	ひいさまが、海の上にはじめて顔をだしたとき、ちょうどお日さまはしずんだところでした。
but the clouds were still lighted up with a rosy and golden splendour,	でもどの雲もまだ、ばら色にも金色にもかがやいていました。
and the evening star sparkled in the soft pink sky,	そうして、ほの赤い空に、よいの明星（みょうじょう）が、それはうつくしくきらきら光っていました。
the air was mild and fresh, and the sea as calm as a millpond.	空気はなごやかに澄んでいて、海はすっかりないでいました。
A big three-masted ship lay close by with only a single sail set,	そこに三本マストの大きな船が横たわっていました。
for there was not a breath of wind, and the sailors were sitting about the rigging, on the cross-trees, and at the mast-heads.	そよとも風がないので、一本だけに帆が上げてあって、それをとりまいて、水夫たちが、帆綱（ほづな）や帆げたに腰をおろしていました。
There was music and singing on board,	そのうち、音楽と唱歌の声がして来ました。
and as the evening closed in hundreds of gaily coloured lanterns were lighted--they looked like the flags of all nations waving in the air.	やがて夕やみがせまってくると、なん百とない色がわりのランプに火がともって、それは各国の国旗が、風になびいているように見えました。
The little mermaid swam right up to the cabin windows,	人魚のひいさまは、その船室の窓の所までずんずんおよいでいきました。
and every time she was lifted by the swell she could see through the transparent panes crowds of gaily dressed people.	波にゆり上げられるたんびに、ひいさまは、水晶のようにすきとおった窓ガラスをすかして、なかをのぞくことができました。
The handsomest of them all was the young prince with large dark eyes;	そこには、おおぜい、晴着（はれぎ）を着かざった人がいました、でも、そのなかで目立ってひとりうつくしいのは、大きな黒目をしたわかい王子でした。
he could not be much more than sixteen,	王子はまだ満十六歳より上にはなっていません。
and all these festivities were in honour of his birthday.	ちょうどきょうがおたん生日で、このとおりさかんなお祝をしているしだいでした。
The sailors danced on deck,	水夫たちは、甲板でおどっていました。
and when the prince appeared among them hundreds of rockets were let off making it as light as day, and frightening the little mermaid so much that she had to dive under the water.	そこへ、わかい王子がでてくると、なん百とない花火が打ち上げられて、これがひるまのようにかがやいたので、ひいさまはびっくりして、いったん水のなかにしずみました。
She soon ventured up again, and it was just as if all the stars of heaven were falling in showers round about her.	けれどまたすぐ首をだすと、もうまるで大空の星が、いちどにおちかかってくるようにおもわれました。
She had never seen such magic fires.	こんな花火なんというものを、まだみたことはありませんでした。
Great suns whirled round,	大きなお日さまがいくつもいくつも、しゅうしゅういいながらまわりました。
gorgeous fire-fish hung in the blue air,	すばらしくきれいな火魚が青い中空（なかそら）にはね上がりました。
and all was reflected in the calm and glassy sea.	そうして、それがみんな鏡のようにたいらな海の上にうつりました。
It was so light on board the ship that every little rope could be seen, and the people still better.	それよりか船の上はとてもあかるくて、甲板の上の帆綱（ほづな）が、ごくほそいのまで一本一本わかるくらいだ、とみんなはいっていました。
Oh, how handsome the prince was!	でも、まあ、わかい王子のほんとうにりっぱなこと。
how he laughed and smiled as he greeted his guests,	王子はたれとも握手（あくしゅ）をかわして、にぎやかに、またにこやかにわらっていました。
while the music rang out in the quiet night.	そのあいだも、音楽は、この晴れがましい夜室にひびきつづけました。
It got quite late,	夜がふけていきました。
but the little mermaid could not take her eyes off the ship and the beautiful prince.	それでも、人魚のひいさまは、船からも、そこのうつくしい王子からも、目をはなそうとはしませんでした。
The coloured lanterns were put out, no more rockets were sent up,	色ランプは、とうに消され、花火ももう上がらなくなりました。
and the cannon had ceased its thunder,	祝砲もとどろかなくなりました。
but deep down in the sea there was a dull murmuring and moaning sound.	ただ、海の底で、ぶつぶつごそごそ、ささやくような音がしていました。
Meanwhile she was rocked up and down on the waves, so that she could look into the cabin;	ひいさまは、やはり水の上にのっかって、上に下にゆられながら、船室のなかをのぞこうとしていました。
but the ship got more and more way on, sail after sail was filled by the wind,	でも、船はだんだんはやくなり、帆は一枚一枚はられました。
the waves grew stronger, great clouds gathered,	するうち、波が高くなって来て、大きな黒雲がわきだしました。
and it lightened in the distance.	遠くでいなづまが、光りはじめました。
Oh, there was going to be a fearful storm!	やれやれ、おそろしいあらしになりそうです。
and soon the sailors had to shorten sail.	それで水夫たちはおどろいて、帆をまき上げました。
The great ship rocked and rolled as she dashed over the angry sea,	大きな船は、荒れる海の上をゆられゆられ、とぶように走りました。
the black waves rose like mountains, high enough to overwhelm her,	うしおが大きな黒山のようにたかくなって、マストの上にのしかかろうとしました。
but she dived like a swan through them and rose again and again on their towering crests.	けれど、船は高い波と波のあいだを、はくちょう［＃「はくちょう」は底本では「はくちょう」］のようにふかくくぐるかとおもうと、またもりあがる高潮の上につき上げられてでて来ました。
The little mermaid thought it a most amusing race, but not so the sailors.	これは海おとめの身にすると、なかなかおもしろい見ものでしたが、船の人たちはどうしてそれどころではありません。
The ship creaked and groaned;	船はぎいぎいがたがた鳴りました。
the mighty timbers bulged and bent under the heavy blows;	さしもがんじょうな船板も、ひどく横腹を当てられて曲りました。
the water broke over the decks, snapping the main mast like a reed;	マストはまんなかからぽっきりと、まるであしかなんぞのようにもろく折れました。
she heeled over on her side, and the water rushed into the hold.	船は横たおしになって、うしおがどどっと、所かまわず船にながれ込みました。
Now the little mermaid saw that they were in danger,	ここではじめて、人魚のひいさまも、船の人たちの身の上のあぶないことが分かりました。
and she had for her own sake to beware of the floating beams and wreckage.	そればかりかじぶんも、水の上におしながされた船のはりや板きれにぶつからない用心しなければなりませんでした。
One moment it was so pitch dark that she could not see at all,	ふと一時、すみをながしたようなやみ夜になって、まるでものがみえなくなりました。
but when the lightning flashed it became so light that she could see all on board.	するうち、いなびかりがしはじめるとまたあかるくなって、船の上のようすが手にとるようにわかりました。
Every man was looking out for his own safety as best he could;	みんなどうにかして助かろうとしてあがいていました。
but she more particularly followed the young prince with her eyes, and when the ship went down she saw him sink in the deep sea.	わかい王子のすがたを、ひいさまはさがしもとめて、それがちらりと目にはいったとたん、船がふたつにわれて、王子も海のそこふかくしずんでいきました。
At first she was quite delighted, for now he was coming to be with her,	はじめのうち、ひいさまはこれで王子がじぶんの所へ来てくれるとおもって、すっかりたのしくなりました。
but then she remembered that human beings could not live under water,	でも、すぐと、水のなかでは、人間が生きていけないことをおもいだしました。
and that only if he were dead could he go to her father's palace.	そうすると、この王子も死んで、おとうさまの御殿にいきつくほかはないとおもいました。
No! he must not die;	まあ、この人を死なせるなんて、とんでもないことです。
so she swam towards him all among the drifting beams and planks, quite forgetting that they might crush her.	そこで、波のうえにただようはりや板きれをかきわけかきわけ、万一、ぶつかってつぶされることなぞわすれて、夢中でおよいでいきました。
She dived deep down under the water, and came up again through the waves, and at last reached the young prince just as he was becoming unable to swim any further in the stormy sea.	で、いったん水のそこふかくしずんで、またたかく波のあいだに浮きあがったりして、やっと、わかい王子の所までおよいでいけましたが、王子は、もうとうに荒れくるう海のなかで、およぐ力がなくなっていて、
His limbs were numbed, his beautiful eyes were closing,	うつくしい目もとじていました。
and he must have died if the little mermaid had not come to the rescue.	人魚のひいさまが、そこへ来てくれなかったら、それなり死ぬところだったでしょう。
She held his head above the water and let the waves drive them whithersoever they would.	ひいさまは、王子のあたまを水の上にたかくささげて、あとは、波が、じぶんと王子とを、好きな所へはこぶままにまかせました。
By daybreak all the storm was over,	そのあけがた、ひどいあらしもやみました。
of the ship not a trace was to be seen;	船のものは、木（こ）ッぱひときれのこってはいませんでした。
the sun rose from the water in radiant brilliance, and his rosy beams seemed to cast a glow of life into the prince's cheeks,	お日さまが、まっかにかがやきながら、たかだかと海のうえにおのぼりになりますと、それといっしょに、王子のほおにもさっと血の気がさしてきたようにおもわれました。
but his eyes remained closed.	でも、目はとじたままでした。
The mermaid kissed his fair and lofty brow, and stroked back the dripping hair;	人魚のひいさまは、王子のたかい、りっぱなひたいにほおをつけて、ぬれた髪の毛をかき上げました。
it seemed to her that he was like the marble statue in her little garden;	こうして見ると、海のそこの、あのかわいい花壇にすえた大理石の像に似ていました。
she kissed him again and longed that he might live.	ひいさまは、もういっぺんほおづけして、どうかいのちのありますようにとねがっていました。
At last she saw dry land before her, high blue mountains on whose summits the white snow glistened as if a flock of swans had settled there;	たかい、青い山山のいただきに、ふんわり雪がつもって、きらきら光っているのが、ちょうどはくちょうが寝ているようでした。
down by the shore were beautiful green woods, and in the foreground a church or temple, she did not quite know which, but it was a building of some sort.	そのふもとの浜ぞいには、みどりみどりした、うつくしい森がしげっていて、森をうしろに、お寺か、修道院（しゅうどういん）かよくわからないながら、建物がひとつ立っていました。
Lemon and orange trees grew in the garden, and lofty palms stood by the gate.	レモンとオレンジの木が、そこの園にしげっていて、門の前には、せいのたかいしゅろの木が立っていました。
At this point the sea formed a little bay where the water was quite calm, but very deep, right up to the cliffs; at their foot was a strip of fine white sand	海の水はそこで、ちいさな入江をつくっていて、それは鏡のようにたいらなまま、ずっとふかく、すのところまで入りこんでいて、そこにまっしろに、こまかい砂が、もり上がっていました。
to which she swam with the beautiful prince, and laid him down on it,	ひいさまは、王子をだいてそこまでおよいでいって、ことに、あたまの所をたかくして、砂の上にねかせました。
taking great care that his head should rest high up in the warm sunshine.	これはあたたかいお日さまの光のよくあたるようにという、やさしい心づかいからでした。
The bells now began to ring in the great white building,	そのとき、そこの大きな白い建てもののなかから、鐘がなりだしました。
and a number of young maidens came into the garden.	そうして、その園をとおって、わかい少女たちがおおぜい、そこへでて来ました。
Then the little mermaid swam further off behind some high rocks and covered her hair and breast with foam,	そこで、人魚のひいさまは、ずっとうしろの水の上に、いくつか岩の突き出ている所までおよいでいって、その陰にかくれました。
so that no one should see her little face,	たれにも顔のみえないように、髪の毛にも胸にも、海のあわをかぶりました。
and then she watched to see who would discover the poor prince.	こうしてきのどくな王子のそばへ、たれがまずやってくるか、気をつけてみていました。
It was not long before one of the maidens came up to him.	もうまもなく、ひとりのわかいむすめが、そこへ来ました。
At first she seemed quite frightened, but only for a moment, and then she fetched several others,	むすめはたいへんおどろいたようでしたが、ほんのちょっとのあいだで、すぐとほかの人たちをつれて来ました。
and the mermaid saw that the prince was coming to life, and that he smiled at all those around him,	人魚のひいさまがみていますと、王子はとうとういのちをとりとめたらしく、まわりをとりまいているひとたちに、にんまりほほえみかけました。
but he never smiled at her.	けれど、ひいさまのほうへは笑顔（えがお）をみせませんでした。
You see he did not know that she had saved him.	ひいさまにたすけてもらったことも、王子はまるで知りませんでした。
She felt so sad	ひいさまは、ずいぶんかなしくおもいました。
that when he was led away into the great building she dived sorrowfully into the water and made her way home to her father's palace.	そのうち、王子は、大きな建てもののなかへはこばれていってしまうと、ひいさまも、せつないおもいをしながら水にしずんで、そのまま、おとうさまの御殿へかえっていきました。
Always silent and thoughtful, she became more so now than ever.	いったいに、いつもものしずかな、ふかくおもい込むたちのひいさまでしたけれど、これからは、それがよけいひどくなりました。
Her sisters often asked her what she had seen on her first visit to the surface, but she never would tell them anything.	おねえさまたちは、この妹が、海の上ではじめてみて来たものがなんであったか、たずねましたが、ちょっぴりともその話はしませんでした。
Many an evening and many a morning she would rise to the place where she had left the prince.	晩に、朝に、いくたびとなく、このひいさまは、王子をおいて来た浜ちかく上がっていってみました。
She saw the fruit in the garden ripen, and then gathered,	園のくだものが実のって、やがてもがれるのもみました。
she saw the snow melt on the mountain-tops,	山山のいただきに、雪の消えるのもみました。
but she never saw the prince,	けれども、ひいさまは、もう王子のすがたをみることはありませんでした。
so she always went home still sadder than before.	そうして、そのたんびに、いつもよけいせつないおもいでかえって来ました。
At home her only consolation was to sit in her little garden with her arms twined round the handsome marble statue which reminded her of the prince.	こうなると、ただひとつのたのしみは、れいのちいさな花壇のなかで、うつくしい王子に似た大理石の像に、両腕をかけることでした。
It was all in gloomy shade now, as she had ceased to tend her flowers, and the garden had become a neglected wilderness of long stalks and leaves entangled with the branches of the tree.	けれども花壇の花にはもうかまわなくなりました。
At last she could not bear it any longer,	とうとう、いつまでもこうしているのが、ひいさまにはたえられなくなりました。
so she told one of her sisters, and from her it soon spread to the others,	それで、ひとりのおねえさまにうちあけますと、やがて、ほかのおねえさまたちの耳にもはいりました。
but to no one else except to one or two other mermaids who only told their dearest friends.	でも、このひいさまたちと、そのほかに二、三人の、海おとめたちのほかたれ知るものはなく、そのおとめたちも、ただごく仲のいいお友だちのあいだでその話をしただけでした。
One of these knew all about the prince;	ところで、そのお友だちのうちに、ひとり、王子を知っているむすめがありました。
she had also seen the festivities on the ship;	それから、あの晩、船の上でお祝のあったこともみていました。
she knew where he came from and where his kingdom was situated.	そのむすめは、王子がどこから来たひとで、その王国がどこにあるかということまで知っていました。
'Come, little sister!'	「さあ、いってみましょうよ。」
said the other princesses,	と、おねえさまたちは、いちばん下のちいさい妹をさそいました。
and, throwing their arms round each other's shoulders, they rose from the water in a long line,	そうして、おたがい腕を肩にかけて、ながい列を組んで、海の上にうき上がりました。
just in front of the prince's palace.	そこは王子の御殿のあるときいた所でした。
It was built of light yellow glistening stone, with great marble staircases, one of which led into the garden.	その御殿は、クリーム色に光をもった石で建てたものでしたが、そこのいくつかある大理石の階段のうち、ひとつはすぐと海へおりるようになっていました。
Magnificent gilded cupolas rose above the roof, and the spaces between the columns	平屋根の上には、一だんたかく、金めっきしたりっぱな円屋根（まるやね）がそびえていました。
which encircled the building were filled with life-like marble statues.	建物のぐるりをかこむ円柱（まるばしら）のあいだに、いくつもいくつも大理石の像が、生きた人のようにならんでいました。
Through the clear glass of the lofty windows you could see gorgeous halls	たかい窓にはめ込んだあかるいガラスをすかすと、なかのりっぱな広間がみえました。
adorned with costly silken hangings,	その広間の壁には、高価な絹のとばりや壁かけがかかっていました。
and the pictures on the walls were a sight worth seeing.	壁という壁は、名作の画でかざられていて、みるひとの目をたのしませました。
In the midst of the central hall a large fountain played, throwing its jets of spray upwards to a glass dome in the roof, through which the sunbeams lighted up the water and the beautiful plants which grew in the great basin.	こういう広間のいくつかあるなかの、いちばんの大広間のまんなかに、大きな噴水がふきだしていて、そのしぶきは、ガラスの円天井（まるてんじょう）まで上がっていましたが、その天井からは、お日さまがさしこんで、噴水の水と大水盤（すいばん）のなかにういている、うつくしい水草の上にきらきらしていました。
She knew now where he lived, and often used to go there in the evenings and by night over the water.	こうして王子のすみかがわかると、それからは、もう夕方から夜にかけて、毎晩のように、そこの水の上に、妹のひいさまはでてみました。
She swam much nearer the land than any of the others dared;	もうほかの人魚たちのいきえない丘ちかくの所までも、およいでいきました。
she even ventured right up the narrow channel under the splendid marble terrace which threw a long shadow over the water.	ついには、せまい水道のなかにまでくぐって、そのながい影を水の上に投げている大理石の露台（ろだい）の下までもいってみました。
She used to sit here looking at the young prince, who thought he was quite alone in the clear moonlight.	そこにじいっといて、みあげると、わかい王子が、じぶんひとりいるつもりで、あかるいお月さまの光のなかに立っていました。
She saw him many an evening sailing about in his beautiful boat, with flags waving and music playing;	夕方、たびたび、王子はうつくしいヨットに帆をはって、音楽をのせて、風に旗を吹きなびかせながら、海の上を走らせるところを、ひいさまは見ました。
she used to peep through the green rushes,	ひいさまは、それを青青としげったあしの葉のあいだからすきみしました。
and if the wind happened to catch her long silvery veil	すると風が来て、ひいさまの銀いろしたながいヴェールをひらひらさせました。
and any one saw it, they only thought it was a swan flapping its wings.	たまにそれを見たものは、はくちょうがつばさをひろげたのだとおもいました。
Many a night she heard the fishermen, who were fishing by torchlight, talking over the good deeds of the young prince;	夜な夜な、船にかがりをたいて、りょうに出るりょうしたちからも、ひいさまはたびたび、わかい王子のいいうわさをききました。
and she was happy to think that she had saved his life when he was drifting about on the waves, half dead,	そうして、そんなにもほめものになっているひとが波の上に死にかけてただよっているところを、じぶんがすくったのだとおもってうれしくなりました。
and she could not forget how closely his head had pressed her breast, and how passionately she had kissed him;	それから、あのとき、あの方のおつむりは、なんておだやかにあたしの胸のうえにのっていたことかしら、それをあたしはどんなに心をこめて、ほおずりしてあげたことかしらとおもっていました。
but he knew nothing of all this,	そのくせ、王子のほうでは、むろんそういうことをまるで知りませんでした。
and never saw her even in his dreams.	つい、夢にすらみてはくれないのです。
She became fonder and fonder of mankind,	だんだんに、だんだんに、人間というものが、とうとくおもわれて来ました。
and longed more and more to be able to live among them;	だんだんに、だんだんに、どうぞして人間のなかまにはいっていきたいと、ねがうようになりました。
their world seemed so infinitely bigger than hers;	人間の世界は、人魚の世界にくらべて、はるかに大きくおもわれました。
with their ships they could scour the ocean, they could ascend the mountains high above the clouds,	人間は、船にのって海の上をとびかけることもできますし、雲よりもたかい山にのぼることもできました。
and their wooded, grass-grown lands extended further than her eye could reach.	人間のいる国ぐにには森も畑もあって、それは人魚の目のとどかないとおくまではてしなくひろがっていました。
There was so much that she wanted to know, but her sisters could not give an answer to all her questions,	そこで、このひいさまの知りたいことは山ほどあっても、おねえさまたちのちからでは、そののこらずにこたえることはできません。
so she asked her old grandmother,	ですから、おばあさまにうかがうことにしました。
who knew the upper world well,	このあばあさまはさすがに、上の世界のことをずっとよく知っておいでになりました。
and rightly called it the country above the sea.	上の世界というのは、このおばあさまが、まことにうまく、海の上の国ぐにに名づけたものでした。
'If men are not drowned,'	「ねえ、おばあさま、人間は、水におぼれさえしなければね、」
asked the little mermaid,	と、ひいさまはたずねました。
'do they live for ever?	「それはいつまででも生きられるのでしょう。
Do they not die as we do down here in the sea?'	あたしたち海のそこのもののようには死なないのでしょう。」
'Yes,'	「どうしてさ。」
said the old lady,	と、おばあさまは、おっしゃいました。
'they have to die too,	「人間だって、やはり死ぬのですよ。
and their lifetime is even shorter than ours.	わたしたちよりも、かえって寿命（じゅみょう）はみじかいくらいです。
We may live here for three hundred years,	わたしたちは三百年まで生きられます。
but when we cease to exist we become mere foam on the water and do not have so much as a grave among our dear ones.	ただ、いったん、それがおわると、それなり、水の上のあわになって、おたがいむつまじくして来たひとたちのなかに、お墓ひとつのこしては行けません。
We have no immortal souls;	わたしたちには、死なないたましいというものがないのだよ。
we have no future life;	またの世にうまれかわるということがないのだよ。
we are just like the green sea-weed, which, once cut down, can never revive again!	いわば、あのみどり色したあしのようなもので、いちど刈りとられると、もう二どと青くなることがない。
Men, on the other hand, have a soul which lives for ever, lives after the body has become dust;	そこへいくと、人間にはたましいというものがあって、それがいつまででも生きている、からだが土にかえってしまったあとでも、たましいは生きている。
it rises through the clear air, up to the shining stars!	それが、澄んだ大空の上にのぼって、あのきらきら光るお星さまの所へまでものぼって行くのです。
Just as we rise from the water to see the land of mortals, so they rise up to unknown beautiful regions which we shall never see.'	ちょうど、わたしたちが、海の上にうき上がって、人間の国をながめるように、人間のたましいは、わたしたちにとても見られない、知らない神さまのお国へうかび上がっていくのです。」
'Why have we no immortal souls?'	「なぜ、あたしたち、死なないたましいをさずからなかったの。」
asked the little mermaid sadly.	と、人魚のひいさまは、かなしそうにいいました。
'I would give all my three hundred years	「あたし、なん百年の寿命なんてみんなやってしまってもいいわ。
to be a human being for one day, and afterwards to have a share in the heavenly kingdom.'	そのかわり、たった一日でも人間になれて、死んだあとで、その天国とやらの世界へのぼるしあわせをわけてもらえるならね。」
'You must not be thinking about that,'	「まあ、そんなことをおもうものではないよ。」
said the grandmother;	と、おばあさまはおっしゃいました。
'we are much better off and happier than human beings.'	「わたしたちは、あの上の世界の人間なんかより、ずっとしあわせだし、ずっといいものなのだからね。」
'Then I shall have to die and to float as foam on the water, and never hear the music of the waves or see the beautiful flowers or the red sun!	「でも、あたし、やはり死んであわになって、海の上にういて、もう波の音楽もきかれないし、もうきれいな花もみられないし、赤いお日さまもみられなくなるのですもの。
Is there nothing I can do to gain an immortal soul?'	どうにかして、ながいいのちのたましいを、さずかるくふうってないものかしら。」
'No,'	「それはあるまいよ。」
said the grandmother;	と、おばあさまはいいました。
'only if	「だがね、こういうことはあるそうだよ。
a human being so loved you	ここにひとり人間があってね、あなたひとりが好きになる。
that you were more to him than father or mother,	そう、その人間にとっては、あなたというものが、おとうさまやおかあさまよりもいいものになるのだね。
if all his thoughts and all his love were so centred in you	そうして、それこそありったけのまごころとなさけで、あなたひとりのことをおもってくれる。
that he would let the priest join your hands and would vow to be faithful to you here, and to all eternity;	そこで、お坊さまが来て、その人間の右の手をあなたの右の手にのせて、この世も、ながいながいのちの世もかわらない、かたい約束を立てさせる。
then your body would become infused with his soul.	そうなると、その人間のたましいがあなたのからだのなかにながれこんで、
Thus, and only thus, could you gain a share in the felicity of mankind.	その人間のしあわせを分けてもらえることになる。
He would give you a soul while yet keeping his own.	しかも、その人間はあなたにたましいを分けても、じぶんのたましいはやはりなくさずにもっているというのさ。
But that can never happen!	だが、そんなことはけっしてありっこないよ。
That which is your greatest beauty in the sea, your fish's tail, is thought hideous up on earth,	だって、この海のそこの世界でなによりうつくしいものにしているおさかなのしっぽを、地の上ではみにくいものにしているというのだもの。
so little do they understand about it; to be pretty there you must have two clumsy supports which they call legs!'	それだけのよしあしすら、むこうはわからないものだから、むりに二本、ぶきような、つっかい棒みたいなものを、かわりにつかって、それに足という名をつけて、それでいいつもりでいるのだよ。」
Then the little mermaid sighed and looked sadly at her fish's tail.	そういわれて、人魚のひいさまも、いまさらため息しながら、じぶんのおさかなの尾にいじらしくながめ入りました。
'Let us be happy,'	「さあ、陽気になりましょう。」
said the grandmother;	と、おばあさまはいいました。
'we will hop and skip during our three hundred years of life;	「せっかくさずかることになっている三百年の寿命です。
it is surely a long enough time;	それだけでもずいぶんながい一生ですよ。
and after it is over we shall rest all the better in our graves.	それだけに、あとはきれいさっぱり、安心して休めるというものだ。
There is to be a court ball to-night.'	今夜は宮中舞踏会（ぶとうかい）をやりましょう。」
This was a much more splendid affair than we ever see on earth.	さて、この舞踏会が、なるほど、地の上の世界では見られないごうかなものでした。
The walls and the ceiling of the great ballroom were of thick but transparent glass.	大きな舞踏の間の壁と天井（てんじょう）とは、あつぼったい、そのくせ、よくすきとおったガラスで張りめぐらされていました。
Several hundreds of colossal mussel shells, rose red and grass green, were ranged in order round the sides holding blue lights,	ばら色や草みどり色した大きな貝がらが、なん百としれず、四方の壁にかけつらねてあって、そのひとつひとつに、青いほのおの火がともっていました。
which illuminated the whole room and shone through the walls, so that the sea outside was quite lit up.	それが広間をくまなくてらした上、壁のそとへながれだす光が、すっかり海をあかるくしました。
You could see countless fish, great and small, swimming towards the glass walls,	ですから、大も小もなく、それこそかぞえきれないほどのさかなが、ガラスの壁にむかっておよいでくるのが、手にとるようにみえました。
some with shining scales of crimson hue,	うろこをむらさき紅の色に光らせてくるのもありました。
while others were golden and silvery.	銀と金の色にかがやいてくるものもありました。
In the middle of the room was a broad stream of running water, and on this the mermaids and mermen danced to their own beautiful singing.	――ちょうど、広間のまん中のところを、ひとすじ、大きくゆるやかな海のながれがつらぬいている、その上で、男の人魚たちと女の人魚たちとが、人魚だけのもっているやさしい歌のふしでおどっていました。
No earthly beings have such lovely voices.	こんなうつくしい歌声が、地の上の人間にあるでしょうか。
The little mermaid sang more sweetly than any of them,	あのいちばん下の人魚のひいさまは、そのなかでも、たれおよぶもののないうつくしい声でうたいました。
and they all applauded her.	みんないちどに手をたたいて、その歌をほめそやしました。
For a moment she felt glad at heart,	そのせつな、さすがにこのひいさまも心がうかれました。
for she knew that she had the finest voice either in the sea or on land.	それは、地の上はもちろん、海のなかにもまたふたりとないうつくしい声を、じぶんがもっていることが分かったからでした。
But she soon began to think again about the upper world,	でも、すぐとまた、上の世界のことをかんがえるいつものくせに引きこまれました。
she could not forget the handsome prince and her sorrow in not possessing, like him, an immortal soul.	あのうつくしい王子のことをわすれることはできませんし、あのひととおなじに、死なないたましいをもっていないことが心をくるしめました。
Therefore she stole out of her father's palace,	そこで、こっそり、ひいさまは、おとうさまの御殿をぬけだしました。
and while all within was joy and merriment, she sat sadly in her little garden.	そうして、たれもそこで、歌って、陽気にうかれているまに、しぶんひとり、れいのちいさい花壇のなかに、しょんぼりすわっていました。
Suddenly she heard the sound of a horn through the water,	そのとき、ひとこえ角笛（つのぶえ）のひびきが、海の水をわたって来ました。
and she thought,	その音（ね）をききながら、ひいさまはおもいました。
'Now he is out sailing up there;	「まあ、いまごろ、あの方きっと、帆船（ほぶね）をはしらせていらっしゃるのね。
he whom I love more than father or mother, he to whom my thoughts cling and to whose hands I am ready to commit the happiness of my life.	ほんとうに、おとうさまよりもおかあさまよりももっと好きなあの方が、しじゅうあたしのこころからはなれないあの方が、そのお手にあたしの一生の幸福をささげようとねがっているあの方が、あそこにいらっしゃるのね。
I will dare anything to win him and to gain an immortal soul!	あたし、どうぞして［＃「どうぞして」は底本では「とうぞして」］、死なないたましいが手にはいるものなら、どんなことでもしてみるわ。
While my sisters are dancing in my father's palace I will go to the sea-witch,	そうだ、おねえさまたちが、御殿でおどっていらっしゃるうち、あたし、海の魔女（まじょ）の所へ行ってみよう。
of whom I have always been very much afraid; she will perhaps be able to advise and help me!'	いつもはずいぶんこわいのだけれど、でもきっと、あの女なら相談相手になって、いいちえをかしてくれるでしょう。」
Thereupon the little mermaid left the garden and went towards the roaring whirlpools	そこで、人魚のひいさまは、花園をでて、ぶつぶつあわ立つうず巻の流れのなかへむかっていきました。
at the back of which the witch lived.	このうず巻のむこうに、魔女のすまいがありました。
She had never been that way before;	こんな道をとおるのははじめてのことでした。
no flowers grew there, no seaweed,	そこには花も咲いていず、藻草（もぐさ）も生えていません。
only the bare grey sands, stretched towards the whirlpools, which like rushing mill-wheels swirled round,	ただむきだしな灰いろの砂地が、うずのながれの所までつづいていて、そのながれはうなりを立てて、水車の車輪のようにくるりくるりまわっていました。
dragging everything that came within reach down to the depths.	そうして、このうず巻のなかにはいってくるものは、なんでもつかまえて、こなごなにくだいて、ふかいふちに引きこみました。
She had to pass between these boiling eddies to reach the witch's domain, and for a long way the only path led over warm bubbling mud,	このはげしいうずのながれの、しかもまん中をとおって行くほかに海の魔女の領分（りょうぶん）にはいる道はありませんし、それも、ながいあいだ、ぶつぶつ煮えて、あわだっているどろ沼をわたって行くよりほかに道はないのです。
which the witch called her 'peat bog.'	この沼を、［＃「、」は底本では「。」］じぶんのすくも田という名で魔女はよんでいました。
Her house stood behind this in the midst of a weird forest.	これを行きつくした奥に、きみのわるい森が茂っていて、そのなかに魔女の住居はありました。
All the trees and bushes were polyps, half animal and half plant; they looked like hundred-headed snakes growing out of the sand,	その森のなかの木立（こだち）もやぶも、半分は動物、半分は植物というさんご虫なかまで、それはいわば、百あたまのあるへびが、地のなかから、にょろにょろわき出ているようなものでした。
the branches were long slimy arms,  with tentacles like wriggling worms,	その一本一本の枝が、ながい、ねばねばした腕で、くなくなと、さなだ虫のような指が出ていました。
every joint of which, from the root to the outermost tip, was in constant motion.	そうして下の根もとから枝のずっとさきまで、ふしぶしが自由にうごきました。
They wound themselves tightly round whatever they could lay hold of and never let it escape.	ですから、海のなかで手につかめるものは、なんでもつかんで、しっかりとそれにからみついて放そうとはしません。
The little mermaid standing outside was quite frightened,	人魚のひいさまは、すっかりおびえて、そのまえに立ちすくみました。
her heart beat fast with terror and she nearly turned back,	もうおそろしくて、心臓（しんぞう）がどきどき波をうって、なんべんもそこから引きかえそうとおもいました。
but then she remembered the prince and the immortal soul of mankind and took courage.	でもまた王子のことと、人間のたましいのことをおもうと、勇気がでました。
She bound her long flowing hair tightly round her head, so that the polyps should not seize her by it,	ひいさまは、そこでまず、うるさくまつわるながい髪の毛を、しっかりあたまにまきつけて、さんご虫につかまらないようにしました。
folded her hands over her breast, and darted like a fish through the water, in between the hideous polyps, which stretched out their sensitive arms and tentacles towards her.	それから、両手を胸の上で重ねて、おさかなが水のなかをつういとつっきるように、いやらしいさんご虫どもが、くなくなした指と腕とをのばそうとしているなかをつっきって行きました。
She could see that every one of them had something or other, which they had grasped with their hundred arms, and which they held as if in iron bands.	まあ、このいやな虫は、みると、そのひとつひとつが、そのつかんだものを、まるでつよい鉄の帯でしめつけるように、そのなん百とないちいさな腕で、ぎりぎりつかまえていました［＃「いました」は底本では「いましに」］。
The bleached bones of men who had perished at sea and sunk below peeped forth from the arms of some,	海でおぼれて、このふかい底までしずんだ人間が、白骨になって、さんご虫の腕のあいだにちらちらみえていました。
while others clutched rudders and sea-chests,	船のかいや箱のようなものまでも、さんご虫はしっかりつかまえていました。
or the skeleton of some land animal; and most horrible of all, a little mermaid whom they had caught and suffocated.	おかの動物のがい骨もありましたが、人魚のむすめがひとり、つかまってしめころされているのが、なかでもおそろしいことにおもわれました。
Then she came to a large opening in the wood where the ground was all slimy,	やがて、ひいさまは、森のなかの広場のぬるぬるすべる沼のような所へ来ました。
and where some huge fat water snakes were gambolling about.	そこには脂ぶとりにふとった水へびが、くねくねといやらしい白茶（しらちゃ）けた腹をみせていました［＃「いました」は底本では「いましだ」］。
In the middle of this opening was a house built of the bones of the wrecked;	この沼のまんなかに、難船した人たちの白骨でできた家がありました。
there sat the witch, letting a toad eat out of her mouth, just as mortals let a little canary eat sugar.	その家に、海の魔女はすわっていて、一ぴきのひきがえるに、口うつしでたべさせているところでしたが、そのようすは、人間がカナリヤのひなにお砂糖をつつかせるのに似ていました。
She called the hideous water snakes her little chickens, and allowed them to crawl about on her unsightly bosom.	あのいやらしく、肥ぶとりした水へびを、魔女はまた、うちのひよっ子と名をつけて、じぶんのぶよぶよ大きな胸の上で、かってにのたくらせていました。
'I know very well what you have come here for,'	「ご用むきはわかっているよ。」
said the witch.	と、海の魔女はいいました。
'It is very foolish of you!	「ばかなことかんがえているね。
all the same you shall have your way, because it will lead you into misfortune,	だが、まあ、したいようにするほかはあるまい、そのかわり、べっぴんのおひいさん、その男ではさぞつらいめをみることだろうよ。
my fine princess.	おまえさん。
You want to get rid of your fish's tail, and instead to have two stumps to walk about upon like human beings,	そのおさかなのしっぽなんかどけて、かわりに二本のつっかい棒をくっつけて、人間のようなかっこうであるきたいのだろう。
so that the young prince may fall in love with you, and that you may win him and an immortal soul.'	それでわかい王子をつって、ついでに死なないたましいまで、手に入れようってのだろう。」
Saying this, she gave such a loud hideous laugh	こういって、魔女はとんきょうな声をたてて、うすきみわるくわらいました。
that the toad and the snakes fell to the ground and wriggled about there.	そのひびきで、かえるもへびも、ころころところげおちて、のたくりまわっていました。
'You are just in the nick of time,'	「おまえさん、ちょうどいいときに来なすったよ。」
wsaid the witch;	と、魔女はいいました。
'after sunrise to-morrow I should not be able to help you until another year had run its course.	「あしたの朝、日が出てしまうと、もうそのあとでは、また一年まわってくるまで、どうにもしてあげられないところだったよ。
I will make you a potion, and before sunrise you must swim ashore with it, seat yourself on the beach and drink it;	では、くすりを調合（ちょうごう）してあげるから、それをもって、日の出る前、おかの所までおよいでいって、岸に上がって、それをのむのだよ。
then your tail will divide and shrivel up to what men call beautiful legs.	すると、おまえさんのそのしっぽが消えてなくなって、人間がかわいい足と、名をつけているものにちぢまる。
But it hurts;	だが、ずいぶん痛かろうよ。
it is as if a sharp sword were running through you.	それはちょうど、するどいつるぎを、からだにつッこまれるようだろうよ。
All who see you will say that you are the most beautiful child of man they have ever seen.	さて、出あったものは、たれだって［＃「たれだって」は底本では「だれたって」］、おまえさんのことを、こんなきれいな人間のむすめを見たことがないというだろう。
You will keep your gliding gait, no dancer will rival you,	おまえさんが浮くようにかるく足をはこぶところは、人間の踊り子にまねもできまい。
but every step you take will be as if you were treading upon sharp knives, so sharp as to draw blood.	ただ、ひと足ごとに、おまえさん、するどい刄物をふむようで、いまにも血がながれるかとおもうほどだろうよ。
If you are willing to suffer all this I am ready to help you!'	それをみんながまんするつもりなら、相談にのって上げる。」
'Yes!'	「ええ、しますわ。」
said the little princess with a trembling voice,	と、人魚のひいさまは、声をふるわせていいました。
thinking of the prince and of winning an undying soul.	そうして、王子のことと、それから、死なないたましいのことを、しっかりとおもっていました。
'But remember,'	「でも、おぼえておいで。」
said the witch,	と、魔女はいいました。
'when once you have received a human form, you can never be a mermaid again;	「おまえさんは、いちど人間のかたちをうけると、もう二どと人魚にはなれないのだよ。
you will never again be able to dive down through the water to your sisters and to your father's palace.	海のなかをくぐって、きょうだいたちのところへも、おとうさんの御殿へもかえることはできないし、
And if you do not succeed in winning the prince's love, so that for your sake he will forget father and mother, cleave to you with his whole heart, let the priest join your hands and make you man and wife, you will gain no immortal soul!	それから王子の愛情にしても、もうおまえさんのためには、おとうさんのこともおかあさんのこともわすれて、あけてもくれてもおまえさんのことばかりを、かんがえていて、もうこの上は、お坊さんにたのんで、王子とおまえさんとふたりの手をつないで、晴れてめおととよばせることにするほかない、というところまでいかなければ、やはり、死なないたましいは、おまえさんのものにはならないのだよ。
The first morning after his marriage with another your heart will break, and you will turn into foam of the sea.'	それがもしかちがって、王子がほかの女と結婚するようなことになると、もうそのあくる朝、お前さんの心臓（しんぞう）はやぶれて、おまえさんはあわになって海の上にうくのだよ。」
'I will do it,'	「かまいません。」
said the little mermaid	と、人魚のひいさまはいいました。
as pale as death.	けれど、その顔は死人のように青ざめていました。
'But you will have to pay me, too,'	「ところで、おまえさん、お礼もたっぷりもらわなきゃならないよ。」
said the witch,	と、魔女はいいました。
'and it is no trifle that I demand.	「どうして、わたしののぞむお礼は、お軽少（けいしょう）なことではないよ。
You have the most beautiful voice of any at the bottom of the sea,	おまえさんは、この海の底で、だれひとりおよぶもののないうつくしい声をもっておいでだね。
and I daresay that you think you will fascinate him with it;	その声で、たぶん、王子をまよわそうとおもっているのだろう。
but you must give me that voice;	ところが、その声をわたしはもらいたいのだよ。
I will have the best you possess in return for my precious potion!	そのおまえさんのもっているいちばんいいものを、わたしのだいじな秘薬（ひやく）とひきかえにしようというのさ。
I have to mingle my own blood with it	なにしろそのくすりには、わたしだって、じぶんの血をまぜなくてはならないのだからね。
so as to make it as sharp as a two-edged sword.'	それで、くすりにも、もろ刄のつるぎのようなするどいききめがあらわれようというものさ。」
'But if you take my voice,'	「でも、あたし、声をあげてしまったら、」
said the little mermaid,	と、ひいさまは、いいました。
'what have I left?'	「あとになにがのこるのでしょう。」
'Your beautiful form,'	「なあに、まだ、そのうつくしいすがたが、」
said the witch,	と、魔女はいいました。
'your gliding gait, and your speaking eyes;	「それから、そのかるい、うくようなあるきつきが、それから、そのものをいう目があるさ。
with these you ought surely to be able to bewitch a human heart.	それだけで、りっぱに人間のこころをたぶらかすことはできようというものだ。
Well! have you lost courage?	はてね、勇気がなくなったかね。
Put out your little tongue, and I will cut it off	さあ、その舌をお出し、それを代金にはらってもらう。
in payment for the powerful draught.'	そのかわり、よくきくくすりをさし上げるよ。」
'Let it be done,'	「ええ、そうしてください。」
said the little mermaid,	と、人魚のひいさまはいいました。
and the witch put on her caldron to brew the magic potion.	そこで、魔女は、おなべを火にかけて、魔法ののみぐすりを煮はじめました。
'There is nothing like cleanliness,'	「ものをきれいにするのは、いいことさ。」
said she, as she scoured the pot with a bundle of snakes;	と、魔女はいって、へびをくるくるとむすびこぶにまるめて、それでおなべをみがきました。
then she punctured her breast and let the black blood drop into the caldron,	それからじぶんの胸をひっかいて、黒い血をだして、そのなかへたらしこみました。
and the steam took the most weird shapes, enough to frighten any one.	その湯気が、なんともいえないふしぎなきみのわるい形で、むくむくと立って、身の毛もよだつようでした。
Every moment the witch threw new ingredients into the pot,	魔女はしじゅうそれからそれと、なにくれとおなべのなかへ投げ込んでいました。
and when it boiled the bubbling was like the sound of crocodiles weeping.	やがて、ぼこぼこ煮え立ってくると、それが＊わにの泣き声に似た音を立てました。
At last the potion was ready and it looked like the clearest water.	とうとう、のみぐすりが煮え上がりましたが、それはただ、すみ切った水のようにみえました。
'There it is,'	「さあ、できましたよ。」
said the witch,	と、魔女はいいました。
said the witch, and thereupon she cut off the tongue of the little mermaid,	そこで、のみぐすりをわたして、代りにひいさまの舌を切りました。
who was dumb now and could neither sing nor speak.	もうこれで、ものもいえず、歌もうたえない、おしになったのです。
'If the polyps should seize you, when you go back through my wood,'	「もしか、かえりみちに、森のなかをとおって、さんご虫どもにつかまりそうになったらね。」
said the witch,	と、魔女はいいました。
'just drop a single drop of this liquid on them, and their arms and fingers will burst into a thousand pieces.'	「このくすりをたった一てきでいい、たらしておやり、そうすると、やつら、腕も指もばらばらになってとんでしまう。」
But the little mermaid had no need to do this,	けれど人魚のひいさまは、そんなことをしないでもすみました。
for at the mere sight of the bright liquid, which sparkled in her hand like a shining star, they drew back in terror.	さんご虫は、ひいさんの手のなかで、星のようにきらきらするのみぐすりをみただけで、おじけて引っこみました、
So she soon got past the wood, the bog, and the eddying whirlpools.	それで、苦もなく、森もぬけ、すくも田もとおって、うずまきの流れもくぐってかえりました。
She saw her father's palace;	そこに、おとうさまの御殿がみえました。
the lights were all out in the great ballroom,	大きな舞踏（ぶとう）の間（ま）も、もうあかりが消えていました。
and no doubt all the household was asleep,	きっともう、みんな寝たのでしょう。
but she did not dare to go in now that she was dumb and about to leave her home for ever.	けれど、ひいさまも、いまはもうおしでしたし、このまま、ながいおわかれをしようというところでしたから、おねえさまたちを、さがしにはいっていこうとはしませんでした。
She felt as if her heart would break with grief.	もう、せつなくて、胸がはりさけるようでした。
She stole into the garden and plucked a flower from each of her sisters' plots, wafted with her hand countless kisses towards the palace, and then rose up through the dark blue water.	そっと、花園にはいって、おねえさまたちの花壇から、めいあいに、ひとつずつ花をつみとって、御殿のほうへ、指で、もうなんべんとしれないほど、おわかれのキッスをなげたのち、くらいあい色の海をぬけて、上へ上がっていきました。
The sun had not risen when she came in sight of the prince's palace and landed at the beautiful marble steps.	ひいさまが、王子のお城をみつけて、そこのりっぱな階段を上がっていったとき、お日さまはまだのぼっていませんでした。
The moon was shining bright and clear.	お月さまだけが、うつくしくさえていました。
The little mermaid drank the burning, stinging draught,	人魚のひいさまは、やきつくように、つんとつよいくすりをのみました。
and it was like a sharp, two-edged sword running through her tender frame; she fainted away and lay as if she were dead.	すると、きゃしゃなふしぶしに、するどいもろ刄のつるぎを、きりきり突きとおされたようにかんじて、それなり気がとおくなり、死んだようになってたおれました。
When the sun rose on the sea she woke up	やがて、お日さまの光が、海の上にかがやきだしたとき、ひいさまは目がさめました。
and became conscious of a sharp pang,	とたんに、切りさかれるような痛みをかんじました。
but just in front of her stood the handsome young prince,	けれど、もうそのとき、すぐ目のまえには、うつくしいわかい王子が立っていました。
fixing his coal black eyes on her;	王子は、うるしのような黒い目でじっとひいさまをみつめていました。
she cast hers down	はっとして、ひいさまは目を伏せました。
and saw that her fish's tail was gone, and that she had the prettiest little white legs any maiden could desire;	すると、あのおさかなのしっぽは、きれいになくなっていて、わかいむすめだけしかないような、それはそれはかわいらしい、まっ白な二本の足とかわっているのが、目にはいりました。
but she was quite naked, so she wrapped her long thick hair around her.	でも、まるっきり、からだをおおうものがないので、ひいさまは、ふっさりとこくながい髪の毛で、それをかくしました。
The prince asked who she was and how she came there.	王子はそのとき、いったい、あなたはたれかどこから来たのかといって、たずねました。
She looked at him tenderly and with a sad expression in her dark blue eyes,	ひいさまは、王子の顔を、やさしく、でも、あくまでかなしそうに、そのこいあい色の目でみあげました。
but could not speak.	もう、口をききたくもきけないのです。
Then he took her by the hand and led her into the palace.	そこで、王子はひいさまの手をとって、お城のなかへつれていきました。
Every step she took was, as the witch had warned her beforehand, as if she were treading on sharp knives and spikes, but she bore it gladly;	なるほど、魔女があらかじめいいきかせていたように、ひいさまは、ひと足ごとに、とがった針か、するどい刄ものの上をふんであるくようでしたが、いさんで、それをこらえました。
led by the prince, she moved as lightly as a bubble,	王子の手にすがって、ひいさまは、それこそシャボン玉のようにかるく上がっていきました。
and he and every one else marvelled at her graceful gliding gait.	すると、王子もおつきの人たちもみんな、ひいさまのしなやかな、かるい足どりをふしぎそうに見ました。
Clothed in the costliest silks and muslins	さて、ひいさまは、絹とモスリンの高価な着物をいただいて着ました。
she was the greatest beauty in the palace,	お城のなかでは、たれひとりおよぶもののないうつくしさでした。
but she was dumb, and could neither sing nor speak.	けれど、おしで、歌をうたうことも、ものをいうこともできません。
Beautiful slaves clad in silks and gold came forward and sang to the prince and his royal parents;	絹に金のぬいとりした着物を着かざったうつくしい女のどれいたちがでて来て、王子と、王子のご両親の王さま、お妃（きさき）さまのご前で歌をうたいました。
one of them sang better than all the others, and the prince clapped his hands and smiled at her;	そのなかでひとり、たれよりもひときわじょうずによくうたう女があったので、王子は手をたたいてやって、そのほうへにっこりわらいかけました。
that made the little mermaid very sad, for she knew that she used to sing far better herself.	でも、人魚のひいさまは、じぶんなら、はるかずっといい声でうたえるのにとおもって、かなしくなりました。
She thought,	そこで、
'Oh! if he only knew that for the sake of being with him I had given up my voice for ever!'	「ああ、王子さまのおそばに来たいばかりに、あたしは、みらいえいごう、声をひとにやってしまったのです。
Now the slaves began to dance, graceful undulating dances to enchanting music;	こんどは、女のどれいたちが、それはけっこうな音楽にあわせて、しとやかに、かるい足どりで、おどりました。
thereupon the little mermaid, lifting her beautiful white arms and raising herself on tiptoe, glided on the floor with a grace which none of the other dancers had yet attained.	すると、人魚のひいさまも、うつくしい白い腕をあげて、つま先立ちして、たれにもまねのならないかるい身のこなしで、ゆかの上をすべるようにおどりあるきました。
With every motion her grace and beauty became more apparent,	ひとつひとつ、しぐさをかさねるにしたがって、この人魚のひいさまの世にないうつくしさが、いよいよ目に立ちました。
and her eyes appealed more deeply to the heart than the songs of the slaves.	その目のはたらきは、どれいたちの女の歌とくらべものにならない、ふかいいみを、見る人びとのこころに語っていました。
Every one was delighted with it,	そこにいた人たちは、たれも、酔ったようになっていました。
especially the prince, who called her his little foundling;	とりわけ、王子は、ひいさまの名を「かわいいひろいむすめさん」とつけてよろこんでいました。
and she danced on and on,	ひいさまは、いくらでもおどりつづけました。
notwithstanding that every time her foot touched the ground it was like treading on sharp knives.	そのくせ地に足がふれるたんびに、するどい刄ものの上をふむようでした。
The prince said that she should always be near him, and she was allowed to sleep outside his door on a velvet cushion.	王子は、いつまでもじぶんの所にいるようにといって、すぐじぶんのへやのまえの、びろうどのしとねにねることをゆるしました。
He had a man's dress made for her, so that she could ride about with him.	王子は、ひいさまを馬にのせてつれてあるけるように、男のお小姓（こしょう）の着る服をこしらえてやりました。
They used to ride through scented woods,	ふたりは、いいにおいのする森のなかを、馬であるきました。
where the green branches brushed her shoulders, and little birds sang among the fresh leaves.	すると、みどりのこい木の枝が、ふたりの肩にさわったり、小鳥たちが、みすみずしい葉かげで歌をうたいました。
She climbed up the highest mountains with the prince,	ひいさまは、王子について、たかい山にものぼりました。
and although her delicate feet bled so that others saw it, she only laughed	そんなとき、きゃしゃな［＃「きゃしゃな」は底本では「きゃしな」］足から血がながれて、ほかのひとたちの目につくほどになっても、ひいさまはわらっていました。
and followed him until they saw the clouds sailing below them like a flock of birds, taking flight to distant lands.	そうして、どこまでも王子にくっついていって、雲が、よその国へわたっていく鳥のむれのように、とんでいるところを、はるか目のしたにながめました。
At home in the prince's palace, when at night the others were asleep, she used to go out on to the marble steps;	うちで、王子のお城のなかにいるとき、夜な夜な、ほかのひとたちのねむっているあいだに、ひいさまは、大理石の階段のうえに出ました。
it cooled her burning feet to stand in the cold sea-water,	そうして、もえるような足を、つめたい海の水にひたしました。
and at such times she used to think of those she had left in the deep.	そうしているうち、はるか下の海のそこの、わかれて来たひとたちのことが、こころにうかんで来ました。
One night her sisters came arm in arm;	そういう夜のつづいているとき、ある晩、夜ぶかく、人魚のおねえさまたちが、手をつなぎあってでて来ました。
they sang so sorrowfully as they swam on the water	波のうえにうきながら、おねえさまたちは、かなしそうにうたいました。
that she beckoned to them, and they recognised her, and told her how she had grieved them all.	ひいさまが手まねきして知らせると、むこうでもみつけて、あちらでは、みんな、どんなにさびしがっているか話してきかせました。
After that they visited her every night,	それからは、毎晩のように、このおねえさまたちはでて来ました。
and one night she saw, a long way out, her old grandmother (who for many years had not been above the water),	いちどなどは、もう何年とないひさしい前から、海の上にでておいでにならなかつたおばあさまの姿を、とおくでみつけました。
and the Merman King with his crown on his head;	かんむりをおつむりにのせたおとうさまの人魚の王さまも、ごいっしょのようでした。
they stretched out their hands towards her, but did not venture so close to land as her sisters.	おばあさまも、おとうさまも、ひいさまのほうへ手をさしのべましたが、おねえさまたちのようには、おもいきっておか近くへ寄りませんでした。
Day by day she became dearer to the prince;	日がたつにつれて、王子はだんだん人魚のひいさまが好きになりました。
he loved her as one loves a good sweet child,	王子は、心のすなおな、かわいいこどもをかわいがるように、ひいさまをかわいがりました。
but it never entered his head to make her his queen;	けれど、このひいさまを、お妃（きさき）がしようなんということは、まるっきりこころにうかんだことがありません。
yet unless she became his wife she would never win an everlasting soul,	でも、ひいさまとしては、どうしても王子のおよめにしていただかなければ［＃「いただかなければ」は底本では「いただなければ」］、もう死なないたましいのさずかるみちはありません。
but on his wedding morning would turn to sea-foam.	そうして、王子がほかのお妃をむかえた次の朝、海のあわになってきえなければなりませんでした。
'Am I not dearer to you than any of them?'	「わたくしを、だれよりもいちばんかわいいとはおおもいにならなくて。」
the little mermaid's eyes seemed to say when he took her in his arms and kissed her beautiful brow.	と、王子が人魚のひいさまを腕にかかえて、そのうつくしいひたえにほおをよせるとき、ひいさまの目は、そうたずねているようにみえました。
'Yes, you are the dearest one to me,'	「そうとも、いちばんかわいいとも。」
said the prince,	と、王子はいいました。
'for you have the best heart of them all, and you are fondest of me;	「だって、おまえはだれよりもいちばんやさしい心をもっているし、いちばん、ぼくをだいじにしてつかえてくれる。
you are also like a young girl I once saw, but whom I never expect to see again.	それに、ぼくがいつかあったことがあって、それなりもう二どとはあえまいとおもうむすめによく似ているのだよ。
I was on board a ship which was wrecked; I was driven on shore by the waves close to a holy Temple	ぼくはあるとき、船にのって、難破（なんぱ）したことがあった、波がぼくを、あるとうといお寺のちかくの浜にうち上げてくれた。
where several young girls were ministering at a service;	そのお寺にはおおぜい、わかいむすめたちが、おつとめしていた。
the youngest of them found me on the beach and saved my life;	そのなかでいちばんわかい子が、ぼくを浜でみつけて、いのちをたすけてくれた。
I saw her but twice.	ぼくは、その子を二どみただけだった。
She was the only person I could love in this world,	その子だけが、ぼくのこの世の中で好きだとおもったただひとりのむすめだった。
but you are like her,	ところで、おまえがそのむすめに生きうつしなのだ。
you almost drive her image out of my heart.	あまり似ているので、ぼくの心にのこっていたせんのむすめのすがたが、いまではどうやらとおくにおしのけられそうだ。
She belongs to the holy Temple, and therefore by good fortune you have been sent to me;	そのむすめは、とうといお寺につかえているむすめだから、ぼくの幸運の神さまが、その子のかわりに、おまえをぼくのところへよこしてくれたのだ。
we will never part!'	いつまでもいっしょにいようね。」――
'Alas! he does not know that it was I who saved his life,'	「ああ、あの方は、あの方のおいのちをたすけてあげたのは、このあたしだということをお知りにならないのね。」
thought the little mermaid.	と、人魚のひいさまはおもいました。
'I bore him over the sea to the wood where the Temple stands.	「あたし、あの方をかかえて海の上を、お寺のある森の所まではこんであげたのだわ。
I sat behind the foam and watched to see if any one would come.	あたし、そのとき、あわのかげにかくれて、たれかひとは来ないかみていたのだわ。
I saw the pretty girl he loves better than me.'	あの方が、あたしよりもっと好きだとおっしゃるそのうつくしいむすめも、みて知っている。」
And the mermaid heaved a bitter sigh,	と、ここまでかんがえて、人魚のひいさまは、ふかいため息をしました。
for she could not weep.	人魚は泣きたくも泣けないのです。
'The girl belongs to the holy Temple, he has said; she will never return to the world,	「でも、そのむすめさんは、とうといお寺につかえている身だから、世の中へでてくることはないと、あの方はおっしゃった。
they will never meet again.	おふたりのあうことはきっともうないのね。
I am here with him;	あたしはこうしてあの方のおそばにいる。
I see him every day.	まいにち、あの方のお顔をみている。
Yes! I will tend him,	あたし、あの方をよくいたわってあげよう。
love him, and give up my life to him.'	あの方にやさしくしよう、あたしのいのちを、あの方にささげよう。」
But now the rumour ran that the prince was to be married to the beautiful daughter of a neighbouring king,	ところが、そのうちに、王子がいよいよ結婚することになった、おとなりの王国のきれいなお姫さまをお妃（きさき）にむかえることになった、といううわさが立ちました。
and for that reason was fitting out a splendid ship.	そのために、王子さまは、りっぱな船を一そう、おしたてさせになったともいいました。
It was given out that the prince was going on a voyage to see the adjoining countries, but it was without doubt to see the king's daughter;	こんどの王子の旅行は、おもてむき、おとなりの王国を見学（けんがく）にいかれるということになっているけれど、じつは王さまのお姫さまにあいにいくのだということでした。
he was to have a great suite with him.	たくさんのおともの人数（にんず）もきまっていました。
But the little mermaid shook her head and laughed; 	でも、人魚のひいさまは、つむりをふって、にっこりしていました。
she knew the prince's intentions much better than any of the others.	王子の心は、たれよりもよく、このひいさまに分かっているはずでした。
'I must take this voyage,'	「ぼくは旅をしなければならないよ。」
he had said to her;	と、王子は人魚のひいさまにいいました。
'I must go and see the beautiful princess;	「きれいな王女のお姫さまにあいにいくのさ。
my parents demand that,	おとうさまとおかあさまのおのぞみでね。
but they will never force me to bring her home as my bride;	だが、ぜひともそのお姫さまをぼくのおよめにもらって来いというのではないよ。
I can never love her!	だが、ぼくはそのお姫さまが好きにはなれまいよ。
She will not be like the lovely girl in the Temple whom you resemble.	おまえがそれにそっくりだといった、あのお寺のきれいなむすめには似ていないだろうからね。
If ever I had to choose a bride it would sooner be you	そのうち、どうしてもおよめえらびをしなければならなくなったら、ぼくはいっそおまえをえらぶよ。
with your speaking eyes, my sweet, dumb foundling!'	口はきけないかわり、ものをいう目をもっている、ひろいむすめのおまえをね。」
And he kissed her rosy mouth,	こういって、王子は、ひいさまのあかいくちびるにくちをつけました。
played with her long hair, and laid his head upon her heart,	それからながい髪の毛をいじって、その胸に顔をおしつけました。
which already dreamt of human joys and an immortal soul.	それだけでもうひいさまのこころには、人間にうまれた幸福と、死なないたましいのことが、夢のようにうかびました。
'You are not frightened of the sea, I suppose, my dumb child?'	「でも、おしのひろいむすめさんは、海をこわがりはしないだろうね。」
he said,	と、王子はいいました。
as they stood on the proud ship which was to carry them to the country of the neighbouring king;	そのとき、ふたりは、おとなりの王さまの国へ行くはずのりっぱな船の上にいました。
and he told her about storms and calms, about curious fish in the deep, and the marvels seen by divers;	それから王子に、海のしけとなぎのこと、海のそこのふしぎな魚のこと、そこで潜水夫（せんすいふ）のみて来ていることなどを、なにくれと話しました。
and she smiled at his tales,	でも、話のなかで、ひいさまはついほほえみかけました。
for she knew all about the bottom of the sea much better than any one else.	そうでしょう、海のそこのことなら、たれがなんといったって、このひいさまにかなうものはないでしょうから。
At night, in the moonlight, when all were asleep, except the steersman who stood at the helm,	月のいい晩で、舵（かじ）の所に立っている舵とりひとりのこして、船のなかの人たちはみんな寝しずまっていました。
she sat at the side of the ship trying to pierce the clear water with her eyes,	人魚のひいさまは、船のへりに腰をかけて、澄んだ水のなかを、じっとながめていました。
and fancied she saw her father's palace,	おとうさまの御殿が、そこにみえているようにおもわれました。
and above it her old grandmother with her silver crown on her head, looking up through the cross currents towards the keel of the ship.	御殿のいちばんの高殿（たかどの）には、おつむりに銀のかんむりをのせたおばあさまが立っていらしって、はやいうしおの流れをすかして、じいっとこちらの船の竜骨（りゅうこつ）をみ上げておいでになるようです。
Then her sisters rose above the water;	するうち、おねえさまたちが、波の上に出て来ました。
they gazed sadly at her, wringing their white hands.	そうして、かなしそうな顔で、こちらをみて、その白い手を、せつなそうにこすりました。
She beckoned to them, smiled, and was about to tell them that all was going well and happily with her, when the cabin-boy approached, and the sisters dived down,	ひいさまは、おねえさまたちにあいずして、にっこりわらいかけて、こちらは不足なくしあわせにしている話をしようとすると、そこへ、船のボーイがふしんらしく寄って来たので、おねえさまたちは水にもぐりました。
but he supposed that the white objects he had seen were nothing but flakes of foam.	それで、ボーイも、いま、ちらと白いものがみえたのは、海のあわであったかとおもって、それなりにしてしまいました。
The next morning the ship entered the harbour of the neighbouring king's magnificent city.	そのあくる朝、船はおとなりの王さまの国の、きらびやかな都の港にはいっていきました。
The church bells rang	町のお寺の鐘が、いっせいに鳴りだしました。
and trumpets were sounded from every lofty tower,	そこここのたかい塔で、大らっぱを吹きたてました。
while the soldiers paraded with flags flying and glittering bayonets.	そのなかで兵隊が、旗を立てて、銃剣をひからせて行列しました。
there was a succession of balls, and receptions followed one after the other,	舞踏会（ぶとうかい）だの、宴会だの、それからそれとつづきました。
but the princess was not yet present;	でも王さまのお姫さまは、まだすがたをみせません。
she was being brought up a long way off, in a holy Temple they said, and was learning all the royal virtues.	うわさでは、どこかとおい所の、あるとうといお寺にあずけられていて、そこで王妃たるべき人のいっさいの道を、修めておいでになるということでした。
At last she came.	するうち、そのお姫さまもやっとおかえりになりました。
The little mermaid stood eager to see her beauty, and she was obliged to confess that a lovelier creature she had never beheld.	人魚のひいさまも、いったいどんなにうつくしいのか、はやくそのひとをみたいものだと、気にかかっていましたが、いまみて、いかにも人がらの優美（ゆうび）なのに、かんしんしずにはいられませんでした。
Her complexion was exquisitely pure and delicate, and her trustful eyes of the deepest blue shone through their dark lashes.	はだはうつくしく透（す）きとおるようですし、ながいまっ黒なまつ毛の奥には、ふかい青みをもった、貞実（ていじつ）な目がやさしく笑（え）みかけていました。
'It is you,'	「あなたでしたよ。」
said the prince,	と、王子はいいました。
'you	「［＃「「」は底本では欠落］そう、あなたでした。
who saved me when I lay almost lifeless on the beach?'	ぼくが死がいも同様で海岸にうち上げられていたとき、すくってくださったのは。」
and he clasped his blushing bride to his heart.	こう、王子はいつて、顔をあからめている花よめを、しっかり胸にかかえました。
'Oh!	「ああ、
I am too happy!'	ぼくはあんまり幸福すぎるよ。」
he exclaimed to the little mermaid.	と、王子は、人魚のひいさまにいいました。
'A greater joy than I had dared to hope for has come to pass.	「最上の望みが、しょせん望んでもむだだと［＃「むだだと」は底本では「むただと」］あきらめていたそれが、みごとかなったのだもの、
You will rejoice at my joy, for you love me better than any one.'	おまえ、ぼくの幸福をよろこんでくれるだろう、だっておまえは、どのだれにもまさって、ぼくのことをしんみにおもっていてくれたのだもの。」
Then the little mermaid kissed his hand, and felt as if her heart were broken already.	こういわれて、人魚のひいさまは、王子の手にくちびるをあてましたが、心臓（しんぞう）はいまにもやぶれるかとおもいました。
His wedding morn would bring death to her and change her to foam.	ふたりのご婚礼のあるあくる朝は、このひいさまが死んで、あわになって、海の上にうく日でしたものね。
All the church bells pealed	［＃空白は底本では欠落］のこらずのお寺の鐘が、かんかん鳴りわたりました。
and heralds rode through the town proclaiming the nuptials.	先ぶれは町じゅう馬をはしらせて、ご婚約（こんやく）のことを知らせました。
Upon every altar throughout the land fragrant oil was burnt in costly silver lamps.	あるかぎりの祭壇（さいだん）には香油（こうゆ）が、もったないような銀のランプのなかでもえていました。
Amidst the swinging of censers by the priests the bride and bridegroom joined hands and received the bishop's blessing.	坊さんたちが香炉（こうろ）をゆすっているなかで、花よめ花むこは手をとりかわして、大僧正（だいそうじょう）の祝福をうけました。
The little mermaid dressed in silk and gold stood holding the bride's train,	人魚のひいさまは、絹に金糸の晴れの衣裳（いしょう）で、花よめのながいすそをささげてもちました。
but her ears were deaf to the festal strains,	でも、お祝の音楽もきこえません。
her eyes saw nothing of the sacred ceremony;	儀式も目にうつりません。
she was thinking of her coming death	ひいさまは、うわの空で、いちずに、くらい死の影を追いました。
and of all that she had lost in this world.	いっさいこの世でなくしてしまったもののことをおもいました。
That same evening the bride and bridegroom embarked,	もうその夕方、花よめ花むこは、船にのって海へ出ました。
amidst the roar of cannon and the waving of banners.	大砲がなりとどろいて、あるだけの旗がひるがえりました。
A royal tent of purple and gold softly cushioned was raised amidships	船のまん中には、王家ご用の金とむらさきの天幕（てんまく）が張れて、うつくしいしとねがしけていました。
where the bridal pair were to repose during the calm cool night.	花よめ花むこが、そこですずしい、しずかなひと夜をおすごしになるはずでした。
The sails swelled in the wind and the ship skimmed lightly and almost without motion over the transparent sea.	帆は風でふくれて、船は、鏡のように平らな海の上を、かるく、なめらかにすべって行きました。
At dusk lanterns of many colours were lighted and the sailors danced merrily on deck.	くらくなると、さまざまな色ランプがともされて、水夫たちは、甲板にでて、おどけた踊をおどりました。
The little mermaid could not help thinking of the first time she came up from the sea and saw the same splendour and gaiety;	人魚のひいさまも、はじめて海からでて来て、この晩のような華（はな）やかな、たのしいありさまを目にみたときのことを、おもいうかべずにはいられませんでした。
and she now threw herself among the dancers,	それで、ひいさまもついなかまにまじって、おどりくるいたくなりました。
whirling, as a swallow skims through the air when pursued.	ひいさまは、それはまるで、つばめが追われて、身をひるがえして逃げるときのような身がるさでおどりまわりました。
The onlookers cheered her in amazement,	そのみごとな踊りぶりを、みんなやんやとさわいでほめました。
never had she danced so divinely;	姫にしてもこれほどみごとに踊ったのははじめてです。
her delicate feet pained her as if they were cut with knives,	おどりながら、きゃしゃな足は、するどい刄もので切りさかれるようにかんじました。
but she did not feel it,	けれどそれを痛いともおもいません。
for the pain at her heart was much sharper.	それよりか、胸を切りさかれる痛みをせつなくおもいました。
She knew that it was the last night that she would breathe the same air as he, and would look upon the mighty deep, and the blue starry heavens;	ほんとうに、そのひととおなじ空気を吸っていて、ふかい海と星月夜の空をながめるのも、これがさいごの夜になりました。
an endless night without thought and without dreams awaited her, who neither had a soul, nor could win one.	この一夜すぎれば、ものをおもうことも、夢をみることもない、ながいながいやみが、たましいをもたず、ついもつことのできなかった、このひいさまを待っていました。
The joy and revelry on board lasted till long past midnight;	船の上では、でも、たれも陽気にたのしくうかれて、真夜中（まよなか）すぎまでもすごしました。
she went on laughing and dancing with the thought of death all the time in her heart.	そのなかで、ひいさまは、こころでは、死ぬことをおもいながら、いっしょにわらっておどりました。
The prince caressed his lovely bride and she played with his raven locks,	王子がうつくしい花よめにくちびるをつけると、王女は王子の黒い髪をいじっていました。
and with their arms entwined they retired to the gorgeous tent.	そうして、手をとりあって、きらびやかな天幕（てんまく）のなかへはいりました。
All became hushed and still on board the ship, only the steersman stood at the helm;	船の上は、ひっそり人音もなくなりました、ただ、舵（かじ）とりだけが、あいかわらず、舵をひかえて立っていました。
the little mermaid laid her white arms on the gunwale and looked eastwards for the pink-tinted dawn;	人魚のひいさまは、船のへりにその白い腕をのせて、赤らんでくる東の空をじっとながめていました。
the first sunbeam, she knew, would be her death.	そのはじめてのお日さまの光が、じぶんをころすのだ、とひいさまはおもいました。
Then she saw her sisters rise from the water; they were as pale as she was;	そのときふと、おねえさまたちが、波のなかから出てくるのがみえましたが、たれもひいさまとおなじように、青い顔をしていました。
their beautiful long hair no longer floated on the breeze,	しかも、そのうつくしい髪の毛も、風になびかしてはいませんでした。
for it had been cut off.	それはきれいに切りとられていました。
'We have given it to the witch to obtain her help,	「あたしたち、髪を魔女にやってしまったのよ、あなたをたすけてもらおうとおもってね。
so that you may not die to-night!	なんでもあなたを今夜かぎり死なせたくないのだもの。
She has given us a knife;	すると魔女が、ほらこのとおり、短刀をくれましたの。
here it is, look how sharp it is!	ごらん、ずいぶんよく切れそうでしょう。
Before the sun rises, you must plunge it into the prince's heart, and when his warm blood sprinkles your feet they will join together and grow into a tail,	お日さまののぼらないうち、これで王子の胸をぐさりとやれば、そのあたたかい血が足にかかって、それがひとつになって、おさかなの尾になるの。
and you will once more be a mermaid; you will be able to come down into the water to us, and to live out your three hundred years before you are turned into dead, salt sea-foam.	するち、あんたはまたもとの人魚のむすめになって、海のそこのあたしたちの所にかえれて、このまま死んで塩からい海のあわになるかわりに、このさき三百年生きられるでしょう。
Make haste!	さあ、はやくしてね。
you or he must die before sunrise!	王子が死ぬかあんたが死ぬか、お日さまののぼるまでに、どちらかにきめなくてはならないのよ。
Our old grandmother is so full of grief that her white hair has fallen off	おばあさまは、あまりおなげきになったので、白いお髪（ぐし）がぬけおちておしまいになったわ。
as ours fell under the witch's scissors.	あたしたちの髪の毛が魔女のはさみで切りとられてしまったようにね。
Slay the prince and come back to us!	王子をころして、かえっておいでなさい。
Quick! Quick!	早くしてね。
do you not see the rosy streak in the sky?	ほらもう、あのとおり空に赤みがさして来たわ。
In a few minutes the sun will rise	もうすぐ、お日さまがおあがりになるわ。
and then you must die!'	すると、いやでも死ななくてはならないのよ。」
saying this they heaved a wondrous deep sigh and sank among the waves.	こういって、おねえさまたちは、いかにもせつなそうにため息をつくと、波のなかにすがたをかくしました。
The little mermaid drew aside the purple curtain from the tent	人魚のひいさまは、天幕（てんまく）にたれたむらさきのとばりをあけました。
and looked at the beautiful bride asleep with her head on the prince's breast.	うつくしい花よめは、王子の胸にあたまをのせて、休んでいました。
She bent over him and kissed his fair brow,	ひいさまは、腰をかがめて、王子のうつくしいひたいに、そっとくちびるをつけました。
looked at the sky where the dawn was spreading fast,	東の空をみると、もうあけ方のあかね色がだんだんはっきりして来ました。
looked at the sharp knife, and again fixed her eyes on the prince,	ひいさまは、そのとき、するどい短刀のきっさきをじっとみて、その目をふたたび王子の上にうつしました。
who, in his dream called his bride by name.	王子は夢をみながら、花よめの名をよびました。
Yes! she alone was in his thoughts!	王子のこころのなかには、花よめのことだけしかありません。
For a moment the knife quivered in her grasp,	短刀は、人魚のひいさまの手のなかでふるえました。
then she threw it far out among the waves,	――でも、そのとき、ひいさまは短刀を波間（なみま）とおく投げ入れました。
now rosy in the morning light, and where it fell the water bubbled up like drops of blood.	投げた所に赤い光がして、そこから血のしずくがふきだしたようにおもわれました。
Once more she looked at the prince, with her eyes already dimmed by death, then dashed overboard and fell,	もういちど、ひいさまは、もう半分うつろな目で、王子をみました、そのせつな、身をおどらせて、海のなかへとび込みました。
her body dissolving into foam.	そうしてみるみる、からだがあわになってとけていくようにおもいました。
Now the sun rose from the sea	いま、お日さまは、海の上にのぼりました。
and with its kindly beams warmed the deadly cold foam,	その光は、やわらかに、あたたかに、死のようにつめたいあわの上にさしました。
so that the little mermaid did not feel the chill of death.	人魚のひいさまは、まるで死んで行くような気がしませんでした。
She saw the bright sun,	あかるいお日さまの方を仰ぎました。
and above her floated hundreds of beauteous ethereal beings,	すると、空の上に、なん百となく、すきとおるような神神（こうごう）しいもののかたちがみえました。
through which she could see the white ship and the rosy heavens;	そのすきとおるもののむこうに、船の白い帆や、空のあかい雲をみました。
their voices were melodious, but so spirit-like that no human ear could hear them,	空のその声はそのままに歌のふしでしたが、でもそれはたましいの声で、人間の耳にはきこえません。
any more than earthly eye could see their forms.	そのすがたもやはり人間の目ではみえません。
Light as bubbles they floated through the air without the aid of wings.	それは、つばさがなくても、しぜんとかるいからだで、ふうわり空をただよいながら上がって行くのです。
The little mermaid perceived that she had a form like theirs; it gradually took shape out of the foam.	人魚のひいさまも、やはりそれとおなじものになって目にはみえないながら、ただよう気息（いき）のようなものが、あわのなかから出て、だんだん空の上へあがって行くのがわかりました。
'To whom am I coming?'	「どこへ、あたし、いくのでしょうね。」
said she,	と、人魚のひいさまは、そのときたずねました。
and her voice sounded like that of the other beings, so unearthly in its beauty that no music of ours could reproduce it.	その声は、もうそこらにうきただよう気息（いき）のなかまらしく、人間の音楽にうつしようのない、たましいのひびきのようになっていました。
'To the daughters of the air!'	すると、
answered the others;	「大空のむすめたちのところへね。」
'a mermaid has no undying soul,	「人魚のむすめに死なないたましいはありません。
and can never gain one without winning the love of a human being.	人間の愛情をうけないかぎり、それをじぶんのものにすることはできません。
Her eternal life must depend upon an unknown power.	かぎりないいのちをうけるには、ほかの力にたよるほかありません。
Nor have the daughters of the air an everlasting soul, but by their own good deeds they may create one for themselves.	大空のむすめたちもながく生きるたましいをもたないかわり、よい行いによって、じぶんでそれをもつこともできるのです。
We fly to the tropics where mankind is the victim of hot and pestilent winds;	（あたしたちは、あつい国へいきますが、そこは人間なら、むんむとする熱病の毒気で死ぬような所です。
there we bring cooling breezes.	そこへすずしい風をあたしたちはもっていきます。
We diffuse the scent of flowers all around, and bring refreshment and healing in our train.	空のなかに花のにおいをふりまいて、ものをさわやかにまたすこやかにする力をはこびます。
When, for three hundred years, we have laboured to do all the good in our power, we gain an undying soul and take a part in the everlasting joys of mankind.	こうして、三百年のあいだつとめて、あたしたちの力のおよぶかぎりのいい行いをしつくしたあと、死なないたましいをさずかり、人間のながい幸福をわけてもらうことになるのです。
You, poor little mermaid, have with your whole heart struggled for the same thing as we have struggled for.	お気のどくな人魚のひいさま、あなたもやはりあたしたち同様まごころこめて、おなじ道におつとめになったのね。
You have suffered and endured,	よくも苦みをおこらえなさったのね。
raised yourself to the spirit-world of the air,	それで、いま、大空の気息（いき）の世界へ、ごじぶんを引き上げるまでになったのてすよ。
and now, by your own good deeds you may, in the course of three hundred years, work out for yourself an undying soul.'	あと三百年、よい行いのちからで、やがて死ぬことのないたましいがさずかることになるでしょう。」
Then the little mermaid lifted her transparent arms towards God's sun, and for the first time shed tears.	そのとき、人魚のひいさまは、神さまのお日さまにむかって、光る手をさしのべて、生まれてはじめての涙を目にかんじました。
On board ship all was again life and bustle.	――そのとき、船の上は、またもがやがやしはじめました。
She saw the prince with his lovely bride searching for her;	王子と花よめがじぶんをさがしているのを、ひいさまはみました。
they looked sadly at the bubbling foam,	ふたりは、かなしそうに、わき立つ海のあわをながめました。
as if they knew that she had thrown herself into the waves.	ひいさまが海にはいってそれがあわになったことを知っているもののようでした。
Unseen she kissed the bride on her brow, smiled at the prince,	目にはみえないながら、ひいさまは、花よめのひたいにせっぷんをおくって、王子にほほえみかけました。
and rose aloft with the other spirits of the air to the rosy clouds which sailed above.	さて、ほかの大空のむすめたちとともども、そらのなかにながれてくるばら色の雲にまぎれて、たかくのぼって行きました。
'In three hundred years we shall thus float into Paradise.'	「すると、三百年たてば、あたしたち、こうしてただよいながら、やがて神さまのお国までものぼって行けるのね。」
'We might reach it sooner,'	「いいえ、そう待たないでも、いけるかもしれませんの。」
whispered one.	と、大空のむすめのひとりがささやいてくれました。
'Unseen we flit into those homes of men where there are children,	「目にはみえないけれど、あたしたちは、こどもたちのいるところなら、どの人間の家にもただよっています。
and for every day that we find a good child who gives pleasure to its parents and deserves their love God shortens our time of probation.	そこで毎日、その親たちをよろこばせ、その愛（いつく）しみをうけているいい子をみつけるたんびに、そのためしのときがみじかくなります。
The child does not know when we fly through the room,	こどもは、いつ、あたしたちがへやのなかへはとんで行くかしらないのです。
and when we smile with pleasure at it one year of our three hundred is taken away.	でも、あたしたちが、いいこどもをみて、ついよろこんでほほえみかけるとき、三百年が一年へります。
But if we see a naughty or badly disposed child, we cannot help shedding tears of sorrow, and every tear adds a day to the time of our probation.'	けれど、そのかわり、いたずらな、またはいけないこどもをみて、かなしみの涙をながさせられると、そのひとしずくのために、あたしたちのためしのときも、一日だけのびることになるのですよ。」
