The Adventuer of Charles Augustus Milverton	チャールズ・オーガスタス・ミルヴァートン
Arthur Conan Doyle	アーサー・コナン・ドイル
It is years since the incidents of which I speak took place,	私がこれからお話する事件が起きてから何年か経つ。
and yet it is with diffidence that I allude to them.	それでもまだ口外するにあたり気後れしないわけにはいかない。
For a long time, even with the utmost discretion and reticence, it would have been impossible to make the facts public,	長い間、どれほど配慮した書き方をしようとも、この事件を公にすることはかなり難しかったであろう。
but now the principal person concerned  is beyond the reach of human law, and with due suppression the story may be told  in such fashion as to injure no one.	だが、主要な関係者は人間の法律のおよばないところにいるのだから、適切に手心を加えておけば、だれひとり傷つけないようなやり方でお聞かせできるかもしれない。
It records an absolutely unique experience in the career both of Mr. Sherlock Holmes and of myself.	これは、ミスター・シャーロック・ホームズと私の双方の経歴にしるされた、まったくユニークな経験の記録である。
The reader will excuse me if I conceal the date or any other fact by which he might trace the actual occurrence.	私は日付などの事実を隠す。
We had been out for one of our evening rambles, Holmes and I, and had returned about six o'clock on a cold, frosty winter's evening.	ホームズと私は夕方の散歩に出かけ、6時に、凍てつくような冬の夕暮れからもどってきた。
As Holmes turned up the lamp the light fell upon a card on the table.	ホームズがランプに火をつけると、テーブルのうえに1枚のカードが載っていた。
He glanced at it, and then, with an ejaculation of disgust, threw it on the floor.	それに目を通したホームズは、悪態とともに床に投げ捨てた。
I picked it up and read:	私が拾いあげて読んでみると――
CHARLES AUGUSTUS MILVERTON,	代理業
Appledore Towers, Hampstead.	チャールズ・オーガスタス・ミルヴァートン
Agent.	ハムステッド、アップルドア・タワーズ
``Who is he?''	「誰？」
I asked.	と私はたずねた。
``The worst man in London,''	「ロンドン1の悪党」
Holmes answered, as he sat down and stretched his legs before the fire.	と、ホームズは腰かけて足を暖炉の方に伸ばしながら答えた。
``Is anything on the back of the card?''	「裏にはなにか？」
I turned it over.	名刺を裏返してみた。
``Will call at 6:30	「6:30に伺う
I read.	私はそれを読み上げた。
``Hum!	「ほう！
He's about due.	もうそろそろだな。
Do you feel a creeping, shrinking sensation, Watson, when you stand before the serpents in the Zoo, and see the slithery, gliding, venomous creatures,	ワトスン、動物園でけばけばしい毒蛇なんかを見たときにさ、薄気味の悪い、ぞっとするような感じがするだろ？
with their deadly eyes and wicked, flattened faces?	あのおぞましい目やおそろしげなのっぺりした顔を見ると。
Well, that's how Milverton impresses me.	ミルヴァートンを見るとちょうどそんな気分になるんだよ。
I've had to do with fifty murderers in my career, but the worst of them never gave me the repulsion which I have for this fellow.	ぼくはこれまで山ほど殺人犯と渡り合ってきたけど、あの男ほどむかむかするやつはいなかったね。
And yet I can't get out of doing business with him	けれども、あいつとの取引は避けられない
-- indeed, he is here at my invitation.''	――実はね、やつをここに呼んだのはぼくなんだ」
``But who is he?''	「でも誰なんだ、そいつは？」
``I'll tell you, Watson.	「教えてやるとも、ワトスン。
He is the king of all the blackmailers.	こいつはあらゆる強請屋（ゆすり）の王者だよ。
Heaven help the man, and still more the woman, whose secret and reputation come into the power of Milverton!	ミルヴァートンに秘密を握られてしまった男はね、まあ女のほうが多いんだけど、もうどうにもならないんだ。
With a smiling face and a heart of marble,	顔は笑っていても心は無慈悲そのもの。
he will squeeze and squeeze until he has drained them dry.	そういう態度で被害者をしぼりにしぼり、干物にしてしまう。
The fellow is a genius in his way, and would have made his mark in some more savoury trade.	その道にかけては天才だよ、もっとまともなことをやってても名をあげてたと思うね。
His method is as follows:	そのやりくちはというと、
He allows it to be known that he is prepared to pay very high sums for letters which compromise people of wealth and position.	まず富や地位のある人々が書いた手紙に大金を支払う用意があるって噂を流す。
He receives these wares not only from treacherous valets or maids, but frequently from genteel ruffians, who have gained the confidence and affection of trusting women.	そういう手紙は、不実な付添人とかメイドとかからでてくることもあるけれど、その女性が信頼と愛情を注いでいる当のえせ紳士からでてくることも多いんだな。
He deals with no niggard hand.	やつは金を出し惜しんだりはしない。
I happen to know that he paid seven hundred pounds to a footman for a note two lines in length,	偶然知ったことだけど、たった2行の走り書きを持ちこんできた従僕に700ポンドもだしてやったこともある。
and that the ruin of a noble family was the result.	結果、ある名家が破滅した。
Everything which is in the market goes to Milverton,	金でなんとかなるものならなんだってミルヴァートンのもとに転がり込むようになっててね。
and there are hundreds in this great city who turn white at his name.	この大都市でミルヴァートンの名を聞いただけで真っ青になる人間は3桁にのぼるだろうな。
No one knows where his grip may fall,	次はどこに手を伸ばしてくるか、分かったもんじゃない。
for he is far too rich and far too cunning to work from hand to mouth.	だって、やつは金にはまったく困ってないし、すぐに足がつくようなまねはしないしね。
He will hold a card back for years in order to play it at the moment when the stake is best worth winning.	手にしたカードを何年もふせておいて、ここいちばんというときになって切ってくるんだ。
I have said that he is the worst man in London, and I would ask you how could one compare the ruffian, who in hot blood bludgeons his mate, with this man,	さっき、ぼくはやつをロンドン1の悪党と言ったけど、かっとなって仲間を殴りたおしてしまうようなチンピラとは比べものにならないだろう？
who methodically and at his leisure tortures the soul and wrings the nerves in order to add to his already swollen money-bags?''	やつは金を唸らせているくせに、暇つぶしみたいなつもりで、計画的に人を苦しめるんだからね」
I had seldom heard my friend speak with such intensity of feeling.	ホームズのこれほどに感情的な喋り方を聞くのは珍しいことだった。
``But surely,'' said I, ``the fellow must be within the grasp of the law?''	「でもきっとさ、法律の力でなんとかなるんじゃないのか？」
``Technically, no doubt,	「理屈ではまったくそのとおり。
but practically not.	でも現実的には無理だ。
What would it profit a woman, for example, to get him a few months' imprisonment if her own ruin must immediately follow?	やつをほんの何ヶ月か牢にぶちこんでみても、たとえばある女性にとってはだな、やつが刑期を終えたとたん破滅するのは目に見えているじゃないか。
His victims dare not hit back.	被害者には反撃する気力もないよ。
If ever he blackmailed an innocent person, then indeed we should have him,	もしもやつが罪のない人間をゆすってくれれば、ぼくらにも手のうちようがある。
but he is as cunning as the Evil One.	でも、悪魔みたいにずるがしこいからね、そんなことはあるまいよ。
No, no, we must find other ways to fight him.''	だめだな、ぼくらはなにか違う手を探さないと」
``And why is he here?''	「で、なんでまたここに？」
``Because an illustrious client has placed her piteous case in my hands.	「それはね、ある高名な依頼人からこの件を任せられたからだよ。
It is the Lady Eva Blackwell, the most beautiful debutante of last season.	依頼人はレディ・エヴァ・ブラックウェル、昨シーズンに社交界にデビューした人の中ではいちばんきれいなひとだね。
She is to be married in a fortnight to the Earl of Dovercourt.	ドーヴァーコート伯爵と2週間後に結婚することになってる。
This fiend has several imprudent letters	ミルヴァートンのやつ、依頼人の軽率な手紙をいくつかおさえててね。
-- imprudent, Watson, nothing worse	軽率という程度にすぎないものなんだけど
-- which were written to an impecunious young squire in the country.	――無一文の若い田舎地主にあてた手紙なんだ。
They would suffice to break off the match.	婚約を破談にもちこむには十分だろう。
Milverton will send the letters to the Earl unless a large sum of money is paid him.	ミルヴァートンはその手紙を伯爵に送りつけるつもりなんだ、それがいやなら大金を支払え、とおどしをかけている。
I have been commissioned to meet him, and -- to make the best terms I can.''	ぼくはやつに会って、できるだけよい条件を引出すようにと言いつかったってわけだ」
At that instant there was a clatter and a rattle in the street below.	そのとき、下の通りからひづめとわだちの音が聞こえてきた。
Looking down I saw a stately carriage and pair, the brilliant lamps gleaming on the glossy haunches of the noble chestnuts.	見下ろしてみると二頭立ての立派な馬車が止まっており、街灯に明るく照らされて、みごとな栗毛の馬がつややかに輝いていた。
A footman opened the door, and a small, stout man in a shaggy astrakhan overcoat descended.	馬丁がドアを開けると、もこもこしたアストラカンコートを着こんだがっしりとした体つきの小男がおりてきた。
A minute later he was in the room.	そしてすぐに、その男が部屋に通されてきた。
Charles Augustus Milverton was a man of fifty, with a large, intellectual head,	チャールズ・オーガスタス・ミルヴァートンは50代の男で、その知能の高さを思わせる大きな頭の持ち主だ。
a round, plump, hairless face,	ふっくらとした丸顔で、はげあがっている。
a perpetual frozen smile, and two keen gray eyes, which gleamed brightly from behind broad, gold-rimmed glasses.	凍りついてしまったみたいにずっと笑顔を絶やさず、両の灰色の瞳は、金縁の大きな眼鏡の奥で明るくきらめいている。
There was something of Mr. Pickwick's benevolence in his appearance,	外見的にはなんとなくピクウィック氏（チャールズ・ディケンズ「ピクウィック・ペーパーズ」の主人公）の福々しさがあった。
marred only by the insincerity of the fixed smile and by the hard glitter of those restless and penetrating eyes.	凍りついたほほえみとあちこちと探るようにうごきまわる目つきがそれを裏切っていたが。
His voice was as smooth and suave as his countenance, as he advanced with a plump little hand extended, murmuring his regret for having missed us at his first visit.	顔つきと同じくものやわらかな声音で、先に訪問したときに会えなかったのは残念でしたとかなんとか言いながら、小さくてふっくりとした手をさしだした。
Holmes disregarded the outstretched hand and looked at him with a face of granite.	ホームズはその手を無視して、無表情にミルヴァートンの顔を見つめた。
Milverton's smile broadened, he shrugged his shoulders, removed his overcoat, folded it with great deliberation over the back of a chair,	ミルヴァートンはいっそうにこやかになり、肩をすくめ、脱いだコードを丁寧にたたんで椅子の背にかけた。
and then took a seat.	そして、自分も腰をおろした。
``This gentleman?''	「そちらのかたは？」
said he, with a wave in my direction.	と私のほうをみぶりで示しながら言う。
``Is it discreet? Is it right?''	「だいじょうぶなのですか？」
``Dr. Watson is my friend and partner.''	「ドクター・ワトスンは私の友人であり、パートナーでもあります」
``Very good, Mr. Holmes.	「けっこうです、ミスター・ホームズ。
It is only in your client's interests that I protested.	あなたの依頼人の利益のことを思っただけですよ。
The matter is so very delicate -- ''	ことはじつに微妙なところがありまして――」
``Dr. Watson has already heard of it.''	「ドクター・ワトスンはすでに聞き及んでおります」
``Then we can proceed to business.	「ではさっそくビジネスを進めましょう。
You say that you are acting for Lady Eva.	レディ・エヴァのために動いておられるということでしたね。
Has she empowered you to accept my terms?''	こちらの条件をのむ権限は任せられておられるのですか？」
``What are your terms?''	「そちらの条件とは？」
``Seven thousand pounds.''	「7,000ポンド」
``And the alternative?''	「さもなくば？」
``My dear sir, it is painful for me to discuss it,	「そうですな、そのことをお話するのは心苦しいばかりなのですが
but if the money is not paid on the 14th, there certainly will be no marriage on the 18th.''	――万一14日までにお支払い戴けなかった場合、18日の結婚式は中止になることでしょう」
His insufferable smile was more complacent than ever.	鼻持ちならない例のほほえみが、さらに得意そうに広がった。
Holmes thought for a little.	ホームズは少し考えてから答えた。
``You appear to me,'' he said, at last, ``to be taking matters too much for granted.	「どうやらそちらはことを大きく構えすぎておられるようですね。
I am, of course, familiar with the contents of these letters.	私は、もちろんその手紙の内容を存じております。
My client will certainly do what I may advise.	依頼人は、私のアドバイスどおりに行動することになるでしょう。
I shall counsel her to tell her future husband the whole story and to trust to his generosity.''	未来の夫に本当のことを打ち明けて、その寛大さにすがるように、とね」
Milverton chuckled.	ミルヴァートンはくすりと笑った。
``You evidently do not know the Earl,'' said he.	「なるほど、伯爵のことをご存知ないのですな」
From the baffled look upon Holmes's face, I could see clearly that he did.	ホームズの顔に影が差したのを見ると、明らかにホームズは知っているようだ。
``What harm is there in the letters?'' he asked.	「そんな手紙になんの危険がありましょうか」
``They are sprightly	「快活な
-- very sprightly,''	――たいへん快活な手紙ですからね」
Milverton answered.	ミルヴァートンは答えた。
``The lady was a charming correspondent.	「レディ・エヴァは魅力的な文通相手ですな。
But I can assure you that the Earl of Dovercourt would fail to appreciate them.	ですが、ドーヴァーコート伯爵にはその魅力をご理解いただけないと思いますよ。
However, since you think otherwise, we will let it rest at that.	なんにせよ、そちらは違うふうに考えておられるのですし、お話はこのへんで切り上げるとしましょう。
It is purely a matter of business.	これは純粋なビジネスなんです。
If you think that it is in the best interests of your client that these letters should be placed in the hands of the Earl, then you would indeed be foolish to pay so large a sum of money to regain them.''	伯爵の手にこの手紙をのせるのがなによりも依頼人にとって得だとお考えなのでしたら、実際、かくも大金を支払って取り帰そうとするのは頭の悪いことですしね」
He rose and seized his astrakhan coat.	そう言うと、ミルヴァートンは立ち上がってコートに手を伸ばした。
Holmes was gray with anger and mortification.	ホームズは怒りと屈辱で青ざめていた。
``Wait a little,'' he said.	「ちょっと待ってください。
``You go too fast.	結論を急ぎすぎておられますよ。
We should certainly make every effort to avoid scandal in so delicate a matter.''	こういう微妙なことがらについては、スキャンダルを防ぐために全力を尽すようにしたいものです」
Milverton relapsed into his chair.	ミルヴァートンはふたたび椅子に収まった。
``I was sure that you would see it in that light,''	「分かっていただけると確信しておりましたよ」
he purred.	と、ミルヴァートンは満足げに言った。
``At the same time,''	「と、同時に」
Holmes continued,	と、ホームズが続けて、
``Lady Eva is not a wealthy woman.	「レディ・エヴァが豊かな女性でないというのも間違いないことです。
I assure you that two thousand pounds would be a drain upon her resources,	お断りしておきますが、彼女の力では2,000ポンドが限界ですね。
and that the sum you name is utterly beyond her power.	ご指定の金額はそれをはるかに上回っております。
I beg, therefore, that you will moderate your demands, and that you will return the letters at the price I indicate,	そういうわけですから、すこし譲っていただいて、先に申し上げた額で手紙を渡していただけませんか。
which is, I assure you, the highest that you can get.''	お断りしておきますが、それ以上の額を手にするのは無理な望みというものですよ」
Milverton's smile broadened and his eyes twinkled humorously.	ミルヴァートンのほほえみが広がり、愉快そうに目をきらめかせた。
``I am aware that what you say is true about the lady's resources,'' said he.	「分かっておりますよ、彼女の資力についてはおっしゃるとおりでしょう。
``At the same time you must admit that the occasion of a lady's marriage is a very suitable time for her friends and relatives to make some little effort upon her behalf.	と同時に、貴婦人の結婚というものは、新婦の友人縁者にとって、新婦のためを思って多少の骨折りをいとわない、そんな機会だということもお忘れなく。
They may hesitate as to an acceptable wedding present.	結婚記念の贈り物にはなにがいちばんいいか、いろいろ気苦労があることでしょう。
Let me assure them that this little bundle of letters would give more joy than all the candelabra and butter-dishes in London.''	みなさんに、この手紙の束こそが、ロンドン中のどんな燭台とかバター皿よりも喜ばれるものだとお知らせしてもいいんですよ」
``It is impossible,''	「無茶をおっしゃらないでください」
said Holmes.	とホームズは言った。
``Dear me, dear me, how unfortunate!''	「いやはや、不幸なことです！」
cried Milverton, taking out a bulky pocketbook.	ミルヴァートンは叫びながら、膨らんだノートを取り出した。
``I cannot help thinking that ladies are ill-advised in not making an effort.	「ロンドンの貴婦人方は、努力を放棄せよという誤ったアドバイスを受けていると考えずにはいられませんな。
Look at this!''	これをごらんください！」
He held up a little note with a coat-of-arms upon the envelope.	と、封筒に紋章が入った短信を掲げて見せる。
``That belongs to well,	「この手紙は
perhaps it is hardly fair to tell the name until to-morrow morning.	――いや、明日の朝まで名前は伏せておいたほうがフェアというものかもしれませんな。
But at that time it will be in the hands of the lady's husband.	でも、そのときにはこの方のご主人の手にわたっているわけです。
And all because she will not find a beggarly sum which she could get by turning her diamonds into paste.	それもすべて、この貴婦人が自分のダイアモンドをひとつ、模造品にかえればすむくらいのはした金を準備しようとしないせいですよ。
It is such a pity!	まったく残念なことですな。
Now, you remember the sudden end of the engagement between the Honourable Miss Miles and Colonel Dorking?	ところで、ミス・マイルズ議員令嬢とドーキング大佐の婚約がとつぜん終わりを迎えたのは覚えておられますね？
Only two days before the wedding, there was a paragraph in the Morning Post to say that it was all off.	結婚式のほんの2日前のモーニングポストが、1段落ほどのスペースで扱っていましたが。
And why?	さて、なぜでしょう？
It is almost incredible, but the absurd sum of twelve hundred pounds would have settled the whole question.	おおよそ信じがたいことですが、200ポンドという馬鹿げた金額ですべて丸く収まっていたはずなのですよ。
Is it not pitiful?	残念なことではありませんか。
And here I find you, a man of sense, boggling about terms,	そしていまここで、あなたのような分別あるお方が条件についてぐずぐずしておられる。
when your client's future and honour are at stake.	依頼人の未来と名誉が危機にさらされているというのに。
You surprise me, Mr. Holmes.''	まったく驚きましたよ、ミスター・ホームズ」
``What I say is true,''	「ほんとうのことをお話しているのですがね」
Holmes answered.	とホームズは言った。
``The money cannot be found.	「そんな大金は用意できません。
Surely it is better for you to take the substantial sum which I offer	私が申し上げた金額で手を打たれたほうが賢明ではありませんか？
than to ruin this woman's career,	この女性の経歴に傷をつけるよりもね。
which can profit you in no way?''	そんなことをしてもなんの得にもなりません」
``There you make a mistake, Mr. Holmes.	「そこのところ、勘違いなさっておいでですな、ミスター・ホームズ。
An exposure would profit me indirectly to a considerable extent.	あるスキャンダルがあらわになったとします。
I have eight or ten similar cases maturing.	いま計画中の似たようなケースが8から10件ほどあります。
If it was circulated among them that I had made a severe example of the Lady Eva, I should find all of them much more open to reason.	私がレディ・エヴァに対して厳格な対応をしたという例が彼らの耳に入ってくれれば、私の仕事はもっともっとやりやすくなることでしょう。
You see my point?''	お分かりですか？」
Holmes sprang from his chair.	ホームズは椅子から飛びあがった。
``Get behind him, Watson!	「後ろにまわれ、ワトスン！
Don't let him out!	部屋から出すな！
Now, sir, let us see the contents of that notebook.''	さあ、そのノートを見せてもらいましょうか」
Milverton had glided as quick as a rat to the side of the room and stood with his back against the wall.	ミルヴァートンはねずみのようにすばしっこくたちまわり、壁を背にした。
``Mr. Holmes, Mr. Holmes,''	「ミスター・ホームズ、ミスター・ホームズ！」
he said, turning the front of his coat	ミルヴァートンは上着の前を返した。
and exhibiting the butt of a large revolver, which projected from the inside pocket.	内ポケットから大型のリボルバーがのぞいている。
``I have been expecting you to do something original.	「なにか独創的なことをやっていただけるものと期待しておったんですがね。
This has been done so often,	こんなのはありふれたやりくちですよ。
and what good has ever come from it?	うまくいきっこありませんて。
I assure you that I am armed to the teeth, and I am perfectly prepared to use my weapons,	私は完全武装ですし、遠慮なく武器を使わせていただきますよ。
knowing that the law will support me.	法律はこっちの味方ですからね。
Besides, your supposition that I would bring the letters here in a notebook is entirely mistaken.	それに、このノートに問題の手紙をはさんできたなんて、勘違いもはなはだしい。
I would do nothing so foolish.	そんな馬鹿なまねはしませんよ。
And now, gentlemen, I have one or two little interviews this evening, and it is a long drive to Hampstead.''	それではみなさん、今夜はまだ2、3約束がありますし、ハムステッドまでは遠い道のりですから、これで失礼いたしますよ」
He stepped forward, took up his coat, laid his hand on his revolver, and turned to the door.	ミルヴァートンは足を踏み出し、コートをとりあげて、リボルバーに手をかけたままドアの方に向き直った。
I picked up a chair, but Holmes shook his head, and I laid it down again.	私は椅子をすこし持ち上げたが、ホームズが首を横にふってみせたのでもとにもどした。
With a bow, a smile, and a twinkle, Milverton was out of the room,	ミルヴァートンは会釈し、微笑し、目をしばたかせると、部屋を出ていった。
and a few moments after we heard the slam of the carriage door and the rattle of the wheels as he drove away.	数分後、我々は彼の馬車が走り去っていくのを耳にした。
Holmes sat motionless by the fire,	ホームズは暖炉のそばにじっと座っていた。
his hands buried deep in his trouser pockets, his chin sunk upon his breast, his eyes fixed upon the glowing embers.	両手をズボンのボケットに深く突っこみ、あごを胸につけて、赤熱する燃えさしを見つめていた。
For half an hour he was silent and still.	半時間、そのまま何も言わずにいた。
Then, with the gesture of a man who has taken his decision, he sprang to his feet and passed into his bedroom.	それからなにかを心に決めたようなそぶりで椅子からはねおきると、ベッドルームに入っていった。
A little later a rakish young workman, with a goatee beard and a swagger, lit his clay pipe at the lamp before descending into the street.	その後すぐに、そこから、やぎひげをはやした小粋な若い労働者が出てきて、表に通じる階段を降りようとしたが、その前にランプでパイプに火をつけた。
``I'll be back some time, Watson,''	そして
said he, and vanished into the night.	「そのうちもどるよ、ワトスン」
I understood that he had opened his campaign against Charles Augustus Milverton,	ホームズはチャールズ・オーガスタス・ミルヴァートンに対する作戦を開始したのだ。
but I little dreamed the strange shape which that campaign was destined to take.	しかし、その作戦があのような形をとるとは夢にも思わなかった。
For some days Holmes came and went at all hours in this attire,	数日間、ホームズはいつ何時でもこの風体で出入りしていた。
but beyond a remark that his time was spent at Hampstead, and that it was not wasted, I knew nothing of what he was doing.	ハムステッドで活動していて、それがまったくの無駄ではなかったということは分かっていたが、それ以上はホームズが何をやっているのかまったく知らなかった。
At last, however, on a wild, tempestuous evening, when the wind screamed and rattled against the windows, he returned from his last expedition, and having removed his disguise he sat before the fire and laughed heartily	しかしながら、ついにあるひどい嵐の晩、風で窓ががたがたと音をたてていた晩に、ホームズは最後の遠征からもどってきて、変装を解いてしまってから暖炉の前に腰を下ろし、心から笑いだした。
in his silent inward fashion.	例の、静かで内向的なあの笑い方で。
``You would not call me a marrying man, Watson?''	「ぼくを結婚したがるような男だとは思ってなかっただろうね、ワトスン」
``No, indeed!''	「そりゃそうだよ！」
``You'll be interested to hear	「おもしろいと思わないか？
that I'm engaged.''	ぼくは婚約したんだよ」
``My dear fellow!	「なんとまあ！
I congrat -- ''	いや、おめで――」
``To Milverton's housemaid.''	「ミルヴァートンのメイドとね」
``Good heavens, Holmes!''	「なんだって、ホームズ！」
``I wanted information, Watson.''	「情報が欲しかったんだよ、ワトスン」
``Surely you have gone too far?''	「やりすぎだと思わないか？」
``It was a most necessary step.	「なにより必要なステップだったんだよ。
I am a plumber with a rising business,	ぼくは景気のいい配管工でね。
Escott, by name.	名前はエスコット。
I have walked out with her each evening, and I have talked with her.	毎晩彼女と散歩しておしゃべりしてたんだよ。
Good heavens, those talks!	まったく、あのおしゃべりときたら！
However, I have got all I wanted.	まあしかし、欲しかったものは揃った。
I know Milverton's house as I know the palm of my hand.''	ミルヴァートンの家のことはもう手に取るように分かっている」
``But the girl, Holmes?''	「けど、その娘はどうするんだね、ホームズ？」
He shrugged his shoulders.	ホームズは肩をすくめた。
``You can't help it, my dear Watson.	「やむをえないだろ、ワトスンくん。
You must play your cards as best you can when such a stake is on the table.	危機がこんなに迫っているときには最善の手を尽さないと。
However.	それにしても、
I rejoice to say that I have a hated rival, who will certainly cut me out the instant that my back is turned.	背を向けた瞬間に間違いなく切りつけてくるような憎らしい敵を相手にするのは楽しいものだね。
What a splendid night it is!''	今夜はじつにすばらしい夜だ！」
``You like this weather?''	「こんな天気が好きだっていうのか？」
``It suits my purpose.	「目的にあうからね。
Watson, I mean to burgle Milverton's house to-night.''	ワトスン、ぼくは今夜、ミルヴァートンの家に押し入るつもりだ」
I had a catching of the breath,	私は息を飲んだ。
and my skin went cold at the words, which were slowly uttered in a tone of concentrated resolution.	断固として決意した調子でゆっくりと紡ぎだされたその言葉を聞いたとたん、全身から血の気が引いていくのが分かった。
As a flash of lightning in the night shows up in an instant every detail of a wild landscape, so at one glance I seemed to see every possible result of such an action	稲光が広々とした景色を一瞬にして浮かび上がらせるように、その行為のもたらす結末がちらりと脳裏をかすめる
-- the detection, the capture, the honoured career ending in irreparable failure and disgrace, my friend himself lying at the mercy of the odious Milverton.	――発見され、捕らえられ、輝かしい経歴がとりかえしのつかない失敗と屈辱で幕を閉じ、ホームズ自身は憎むべきミルヴァートンのなすがままに横たわっている。
``For heaven's sake, Holmes, think what you are doing,''	「頼むからホームズ、何をやろうとしているのか考えてみてくれよ！」
I cried.	と私は叫んだ。
``My dear fellow, I have given it every consideration.	「ねえ、あらゆることを考えてみてのことなんだよ。
I am never precipitate in my actions, nor would I adopt so energetic and, indeed, so dangerous a course, if any other were possible.	ぼくはけっして軽率に動いたりはしないし、他に手があるんだったらこんな、疲れる上にまちがいなく危険だと分かっているような真似をしやしない。
Let us look at the matter clearly and fairly.	ことを偏りなくしっかりと検討してみよう。
I suppose that you will admit that the action is morally justifiable,	きみだって、これが道徳的に正しいことだとみとめてくれるよな。
though technically criminal.	理屈では犯罪だとしてもね。
To burgle his house is no more than to forcibly take his pocketbook	やつの家に押し入るといっても、あの手帳を奪ってくるだけのことなんだ
-- an action in which you were prepared to aid me.''	――あのとき、きみが手伝ってくれようとしたことだよ」
I turned it over in my mind.	私はそれを頭の中で検討してみた。
``Yes,'' I said,	「そうだね。
``it is morally justifiable	道徳的には正しい。
so long as our object is to take no articles save those which are used for an illegal purpose.''	ただ不正な目的に使われるものだけを持ち出すんであれば」
``Exactly.	「そのとおり。
Since it is morally justifiable, I have only to consider the question of personal risk.	道徳的に正しいことだからこそ、個人的に危険を冒してでもやってやろうと考えた。
Surely a gentleman should not lay much stress upon this, when a lady is in most desperate need of his help?''	淑女から切実に助けを求められているというのに、紳士たるもの傍観してていいわけないじゃないか？」
``You will be in such a false position.''	「それにしても、立場上まずいことになるぞ」
``Well, that is part of the risk.	「まあ、それも冒すべき危険のひとつだよ。
There is no other possible way of regaining these letters.	あの手紙をとりかえすにはそれしかないんだから。
The unfortunate lady has not the money, and there are none of her people in whom she could confide.	レディ・エヴァはあんな大金を持っていないし、相談できる相手もいない。
To-morrow is the last day of grace,	残された時間はあと1日。
and unless we can get the letters to-night, this villain will be as good as his word and will bring about her ruin.	今夜中に手紙が手に入らなければ、あの悪人は言葉どおりのことをやって依頼人を破滅させるだろう。
I must, therefore, abandon my client to her fate or I must play this last card.	というわけで、ぼくは依頼人をその運命の手に委ねるか、さもなくば最後のカードを切るしかない。
Between ourselves, Watson, it's a sporting duel between this fellow Milverton and me.	これはね、ワトスン、ミルヴァートンのやつとぼくとの堂々たる決闘なんだよ。
He had, as you saw, the best of the first exchanges,	きみが見たとおり、最初の手合わせでは向こうが完勝した。
but my self-respect and my reputation are concerned to fight it to a finish.''	でも、ぼくのプライドと名にかけて、最後まで戦いぬいてみせる」
``Well, I don't like it,	「うーん、あまり気に入らないけど。
but I suppose it must be,'' said I.	しかたなさそうだな。
``When do we start?''	いつからでかけようか？」
``You are not coming.''	「君はこなくていい」
``Then you are not going,'' said I.	「じゃあ、君は行かなくていい。
``I give you my word of honour -- and I never broke it in my life	――いままで一度だって破ったことはない
-- that I will take a cab straight to the police-station and give you away, unless you let me share this adventure with you.''	――この冒険をともにできないというのなら、ぼくは馬車をつかまえ警察署に駈けこんで、なにもかもしゃべってやる」
``You can't help me.''	「役に立ってもらえそうにないんだよ」
``How do you know that?	「どうしてそう言える？
You can't tell what may happen.	何が起きるかわからないじゃないか。
Anyway, my resolution is taken.	とにかく、ぼくはゆずらないよ。
Other people besides you have self-respect, and even reputations.''	プライドと名を重んじるのはきみだけじゃない」
Holmes had looked annoyed, but his brow cleared, and he clapped me on the shoulder.	ホームズは悩んだ目つきをしていたが、やがて眉を開いて私の肩を叩いた。
``Well, well, my dear fellow, be it so.	「わかったわかったワトスンくん、そうしよう。
We have shared this same room for some years, and it would be amusing if we ended by sharing the same cell.	何年か同じ部屋で暮らしてきた仲だ、同じ檻で果てるのも一興かもな。
You know, Watson, I don't mind confessing to you that I have always had an idea that I would have made a highly efficient criminal.	ねえワトスン、ここだけの話、ぼくはきわめて腕のいい犯罪者にだってなれたといつも思ってたんだ。
This is the chance of my lifetime in that direction.	その方面でのぼくの生き様をお目にかけるいい機会だよ。
See here!''	ほらこれ！」
He took a neat little leather case out of a drawer, and opening it he exhibited a number of shining instruments.	ホームズは引きだしから皮製のこぎれいな小型ケースを取りだすと、蓋をあけ、中のきらめく道具の数々を見せてくれた。
``This is a first-class, up-to-date burgling kit,	「第一級の最新式泥棒道具だよ。
with nickel-plated jemmy, diamond-tipped glass-cutter, adaptable keys,	ニッケル箔の金梃子に、ダイアモンドのガラス切りに、万能鍵。
and every modern improvement which the march of civilization demands.	文明の進歩にしたがって改良されてきた道具が他にもたくさん。
Here, too, is my dark lantern.	ぼくの覆いのついたランタンもここにある。
Everything is in order.	準備万端だ。
Have you a pair of silent shoes?''	てごろな靴はあるかい？
``I have rubber-soled tennis shoes.''	「ゴム底のテニスシューズがあるよ」
``Excellent!	「完璧だ。
And a mask?''	マスクは？」
``I can make a couple out of black silk.''	「黒絹から1組作れるよ」
``I can see that you have a strong, natural turn for this sort of thing.	「この種のことにはけっこう素質があるらしいね。
Very good, do you make the masks.	わかったよ、マスクを作っておいてくれ。
We shall have some cold supper before we start.	出かけるまえに軽く冷たい食事をとることにしよう。
It is now nine-thirty.	今9時30分だ。
At eleven we shall drive as far as Church Row.	11時にはチャーチ街につくようにする。
It is a quarter of an hour's walk from there to Appledore Towers.	そこからアップルドア・タワーズまで徒歩15分。
We shall be at work before midnight.	0時までには仕事にとりかかりたい。
Milverton is a heavy sleeper, and retires punctually at ten-thirty.	ミルヴァートンは眠りの深いたちで、きまって10時30分に部屋にさがる。
With any luck we should be back here by two,	うまくいけば、2時までにはここにもどってこれるはずだ。
with the Lady Eva's letters in my pocket.''	レディ・エヴァの手紙をこのポケットに収めてね」
Holmes and I put on our dress-clothes,	私とホームズは礼装した。
so that we might appear to be two theatre-goers homeward bound.	2人の芝居客が帰宅途中といったふうを装うためだ。
In Oxford Street we picked up a hansom and drove to an address in Hampstead.	オックスフォード街で馬車を拾い、ハムステッドのとある番地に向かった。
Here we paid off our cab, and with our great coats buttoned up,	そこで辻馬車に運賃を支払い、大きなコートの前を閉じ合わせて下車した。
for it was bitterly cold, and the wind seemed to blow through us,	というのも、ものすごい寒さだったし、風も我々を吹き飛ばさんばかりのいきおいで吹いていたのだ。
we walked along the edge of the heath.	それから、ヒースの端にそって歩いていった。
``It's a business that needs delicate treatment,''	「微妙な取り扱いを要する仕事だ」
said Holmes.	と、ホームズが言った。
``These documents are contained in a safe in the fellow's study, and the study is the ante-room of his bed-chamber.	「手紙はやつの書斎にある金庫のなか、そして書斎はやつの寝室とつながっている。
On the other hand, like all these stout, little men who do themselves well, he is a plethoric sleeper.	そのいっぽう、ああいう暮らし向きのいいがっしりとした小男にはよくあることだけど、睡眠過多の気がある。
Agatha -- that's my fiancee -- says it is a joke in the servants' hall that it's impossible to wake the master.	アガサ――ぼくのフィアンセ――に言わせると、召使たちの間では、一度眠りについた主人を起こすのは不可能だと揶揄されているらしい。
He has a secretary who is devoted to his interests, and never budges from the study all day.	それから、やつの利益に忠実な秘書が一人いて、日中は書斎を離れない。
That's why we are going at night.	だからこそ夜を選んだわけだ。
Then he has a beast of a dog which roams the garden.	あとは、庭をうろついてる番犬が一匹。
I met Agatha late the last two evenings, and she locks the brute up so as to give me a clear run.	ぼくは2日前からアガサと夜会うようにしておいたから、ぼくが入りこめるように閉じ込めてくれているはずだ。
This is the house, this big one in its own grounds.	この家だ、この、庭付きのでかい家だよ。
Through the gate -- now to the right among the laurels.	門からはいって、この月桂樹の茂みを右だ。
We might put on our masks here, I think.	ここらへんでマスクをしておいた方がいいと思う。
You see, there is not a glimmer of light in any of the windows,	ほら、どの窓からも光が漏れてないだろう？
and everything is working splendidly.''	なにもかもうまくいっているよ」
With our black silk face-coverings, which turned us into two of the most truculent figures in London, we stole up to the silent, gloomy house.	マスクをつけてロンドンでもっとも野蛮な姿に変身した我々は、沈黙している薄暗い屋敷に忍び寄った。
A sort of tiled veranda extended along one side of it, lined by several windows and two doors.	家屋の片側にはタイル張りのベランダっぽいものがあり、いくつかの窓と2つのドアが並んでいた。
``That's his bedroom,''	「あれが寝室だよ」
Holmes whispered.	とホームズが囁いた。
``This door opens straight into the study.	「このドアをあければすぐ書斎だ。
It would suit us best, but it is bolted as well as locked,	いちばん都合のいい侵入口だけど、鍵がかかっているうえにかんぬきまでおりている。
and we should make too much noise getting in.	ここから入ったのでは物音を立てすぎてしまう。
Come round here.	こっちにまわろう。
There's a greenhouse which opens into the drawing-room.''	客間に通じる温室がある」
The place was locked, but Holmes removed a circle of glass and turned the key from the inside.	ここも鍵がかかっていたが、ホームズはガラスを丸く切りとって内側に手をいれ、鍵をはずした。
An instant afterwards he had closed the door behind us,	私につづいて入ってきたホームズがドアを後ろ手に閉める。
and we had become felons in the eyes of the law.	我々は法の下では犯罪者になったのだ。
The thick, warm air of the conservatory and the rich, choking fragrance of exotic plants took us by the throat.	温室のねっとりしたなまぬるい空気と、おびただしい異国の植物のむせかえるような香りが我々ののどをついた。
He seized my hand in the darkness and led me swiftly past banks of shrubs which brushed against our faces.	暗闇の中、ホームズは私の手をつかんだまま眼前にしげる潅木の垣をすばやく通りぬけた。
Holmes had remarkable powers, carefully cultivated, of seeing in the dark.	ホームズにはおどろくべき力があり、それに熱心に訓練したこともあって、暗闇でもものを見ることができるのだ。
Still holding my hand in one of his, he opened a door,	私の手をつかんだまま先ほどとは違うドアを開けた。
and I was vaguely conscious that we had entered a large room	大きな部屋に入ったのだと言うことがおぼろげに察せられた。
in which a cigar had been smoked not long before.	すこしまえまで、だれかが煙草をすっていたようだ。
He felt his way among the furniture, opened another door, and closed it behind us.	手探りで調度品の間を抜けたホームズは、別のドアを開け、私を中に入れてから後ろ手にそれを閉めた。
Putting out my hand I felt several coats hanging from the wall,	手を伸ばしてみると、壁に数着のコートがかかっているのがわかった。
and I understood that I was in a passage.	ここは廊下なのだ。
We passed along it, and Holmes very gently opened a door upon the right-hand side.	廊下を進んで右手にあったドアを、ホームズがそっと開く。
Something rushed out at us and my heart sprang into my mouth, but I could have laughed when I realized that it was the cat.	何かが飛び掛ってきたので一瞬心臓が止まるかと思ったが、それが猫だとわかったときには笑ってしまうところだった。
A fire was burning in this new room, and again the air was heavy with tobacco smoke.	この部屋では暖炉に火がいれてあり、また先とおなじく強い煙草のにおいがした。
Holmes entered on tiptoe, waited for me to follow, and then very gently closed the door.	ホームズはつま先だって部屋に入ると、私が中に入るのを待って、そっとそっとドアを閉めた。
We were in Milverton's study,	ここがミルヴァートンの書斎だ。
and a porti&egrave;re at the farther side showed the entrance to his bedroom.	奥にあるカーテンが寝室の入り口になっていた。
It was a good fire, and the room was illuminated by it.	火は十分におこっており、部屋中を明るく照らしていた。
Near the door I saw the gleam of an electric switch, but it was unnecessary, even if it had been safe, to turn it on.	ドアのそばには電灯のスイッチがほのかに光って見えたが、仮に安全だったとしても、使う必要はまったくなかった。
At one side of the fireplace was a heavy curtain which covered the bay window we had seen from outside.	暖炉の一方には厚いカーテンが下りており、先ほど外から見ていた出窓を覆っている。
On the other side was the door which communicated with the veranda.	もう一方にはベランダに続くドアがあった。
A desk stood in the centre, with a turning-chair of shining red leather.	中央には机が据えられていて、てかてかした赤い革張りの回転椅子がそえてあった。
Opposite was a large bookcase, with a marble bust of Athene on the top.	向かい正面には大きな本棚があり、上にアテネの大理石の胸像がのっている。
In the corner, between the bookcase and the wall, there stood a tall, green safe, the firelight flashing back from the polished brass knobs upon its face.	本棚の壁の間には背の高い緑色の金庫が置いてあり、その正面につけられた真鍮のノブが暖炉の光を反射していた。
Holmes stole across and looked at it.	ホームズは部屋を忍び足で横切り、それを見た。
Then he crept to the door of the bedroom, and stood with slanting head listening intently.	それから、ベッドルームへのドアに忍び寄って頭をよせ、じっと聞き耳を立てた。
No sound came from within.	なんの音も聞こえてこなかった。
Meanwhile it had struck me that it would be wise to secure our retreat through the outer door, so I examined it.	その間、退路を確保しておいた方が賢明だと思っていた私は、外にでるドアを試してみた。
To my amazement, it was neither locked nor bolted.	おどろいたことに、錠もかんぬきもおりていない！
I touched Holmes on the arm, and he turned his masked face in that direction.	ホームズの腕に触って注意を促すと、ホームズはマスクをしたその顔を私が試してみたドアのほうに向けた。
I saw him start,	そしてはっとした。
and he was evidently as surprised as I.	明らかに、私と同じく彼にとっても意外だったのだ。
``I don't like it,''	「気にくわない」
he whispered, putting his lips to my very ear.	ホームズが耳元で囁いた。
``I can't quite make it out.	「まったくわけがわからんよ。
Anyhow, we have no time to lose.''	まあいい、あまり時間がないし」
``Can I do anything?''	「何かできることはないかな？」
``Yes,	「ある。
stand by the door.	そのドアのそばに立っていてくれ。
If you hear anyone come, bolt it on the inside,	誰かがやってくる音がしたら内側からかんぬきをすること。
and we can get away as we came.	そうすればいまきたところからひきかえせる。
If they come the other way, we can get through the door if our job is done,	逆にあっちからきたときは、仕事が終わっていればそのドアから外にでる。
or hide behind these window curtains if it is not.	終わってなければ、窓のところのカーテンに隠れる。
Do you understand?''	いいね？」
I nodded, and stood by the door.	私はうなずいて、ドアのそばに立った。
My first feeling of fear had passed away, and I thrilled now with a keener zest	最初に感じた恐怖感はもう消えうせ、研ぎ澄まされた情熱をともなったスリル感を味わっていた。
than I had ever enjoyed when we were the defenders of the law instead of its defiers.	それは、今のような法の侵犯者でなく法の守護者だったときには感じたことのないものだった。
The high object of our mission,	この作戦の高潔な目的。
the consciousness that it was unselfish and chivalrous,	非利己的で騎士道精神溢れる心。
the villainous character of our opponent,	敵手のあくどい人格。
all added to the sporting interest of the adventure.	すべてがこの冒険の正当さを高めていた。
Far from feeling guilty, I rejoiced and exulted in our dangers.	罪の意識はほとんどなく、我々が危険な状態にあると言うことが、むしろ喜びであり嬉しくもあった。
With a glow of admiration I watched Holmes unrolling his case of instruments and choosing his tool with the calm, scientific accuracy of a surgeon who performs a delicate operation.	賛嘆の思いに体を火照らせながら、ホームズがあのケースをひらき、微妙な手術をとりおこなおうとしている外科医のような技術的で精密な手つきで工具を選ぶ、その落ちついた姿を見つめていた。
I knew that the opening of safes was a particular hobby with him, and I understood the joy which it gave him to be confronted with this green and gold monster, the dragon which held in its maw the reputations of many fair ladies.	私は、金庫破りがホームズにとって格別の趣味だったことを知っていたし、このグリーンとゴールドのモンスター、その臓腑に数多くの淑女たちの名誉をたくわえこんでいるドラゴンに立ち向かうホームズの喜びも理解できた。
Turning up the cuffs of his dress-coat	礼服の袖をまくりあげると
-- he had placed his overcoat on a chair	――コートは椅子にのせてあった
-- Holmes laid out two drills, a jemmy, and several skeleton keys.	――ドリルをふたつ、金梃子、万能鍵のたばを取りだした。
I stood at the centre door with my eyes glancing at each of the others, ready for any emergency,	私はまんなかのドアのところに立って、他のドアにも目を配りながら、緊急事態に備えていた。
though, indeed, my plans were somewhat vague as to what I should do if we were interrupted.	もっとも実際には、邪魔が入ったときにはどうしたらよいか、ばくぜんとしか頭に浮かばなかったが。
For half an hour, Holmes worked with concentrated energy,	30分ほど、ホームズは根を詰めて作業していた。
laying down one tool, picking up another, handling each with the strength and delicacy of the trained mechanic.	道具をとっかえひっかえ、熟練のメカニックが持つ強靭さと繊細さでひとつひとつをあつかいながら。
Finally I heard a click, the broad green door swung open,	やがてかちりという音がして、大きな緑色のドアが開いた。
and inside I had a glimpse of a number of paper packets, each tied, sealed,	中を見ると、たくさんの紙包みが、それぞれ結わえられ、封をされた状態で山とつまれていた。
and inscribed.	表には何か文字が書いてある。
Holmes picked one out, but it was hard to read by the flickering fire, and he drew out his little dark lantern,	ホームズはそこから1束抜きとってみたが、ちらちらとゆらめく炎の光では読み取ることができず、自分のランタンを引き寄せた。
for it was too dangerous, with Milverton in the next room, to switch on the electric light.	隣の部屋にミルヴァートンがいる以上、電灯をつけるのはあまりにも危険すぎたからだ。
Suddenly I saw him halt, listen intently,	不意に、ホームズはぴたりと動きをとめて聞き耳をたてた。
and then in an instant he had swung the door of the safe to, picked up his coat, stuffed his tools into the pockets, and darted behind the window curtain, motioning me to do the same.	あっというまに金庫のドアを閉めてコートをとりあげ、道具をポケットに押しこむと、私についてくるよう合図しながら出窓のカーテンの後ろに飛びこんだ。
It was only when I had joined him there that I heard what had alarmed his quicker senses.	ホームズにしたがってカーテンの陰にもぐりこんだとき、ようやく、私にもホームズの鋭敏な感覚が捕らえたものが聞こえてきた。
There was a noise somewhere within the house.	家の中のどこかで物音がしているのだ。
A door slammed in the distance.	遠くでドアがばたんと閉まった。
Then a confused, dull murmur broke itself into the measured thud of heavy footsteps rapidly approaching.	それから判別不可能な、くぐもったつぶやき声が聞こえ、重々しい足音が急ぎ足で近づいてきた。
They were in the passage outside the room.	この部屋の外側にある廊下を歩いているのだ。
They paused at the door.	ドアの前で止まる。
The door opened.	ドアが開いた。
There was a sharp snick as the electric light was turned on.	かちっという音がして、電灯がついた。
The door closed once more, and the pungent reek of a strong cigar was borne to our nostrils.	ドアがもとどおりに閉められ、ぷんとくる強い煙草の臭いが鼻をついた。
Then the footsteps continued backward and forward, backward and forward, within a few yards of us.	それから、我々から1メートルと離れていないところを、足音がいったりきたりした。
Finally there was a creak from a chair, and the footsteps ceased.	やがて椅子がきしる音がして、足音はやんだ。
Then a key clicked in a lock, and I heard the rustle of papers.	それから鍵をまわす音がし、続いて紙のかさかさとすれあう音がした。
So far I had not dared to look out, but now I gently parted the division of the curtains in front of me and peeped through.	そのときまでは覗き見る勇気がなかった私だが、このとき、目の前のカーテンの境目をそっと広げてようすをうかがってみた。
From the pressure of Holmes's shoulder against mine, I knew that he was sharing my observations.	肩にホームズの肩がのしかかってくるあたり、ホームズも私と同じところからのぞきこんでいるのであろう。
Right in front of us, and almost within our reach, was the broad, rounded back of Milverton.	我々の右側、手を伸ばせば届きそうなところに、ミルヴァートンの広くて丸っこい肩があった。
It was evident that we had entirely miscalculated his movements,	ミルヴァートンの今夜の行動について、我々は完全な誤算をしていたわけだ。
that he had never been to his bedroom,	彼は寝室には行かなかった。
but that he had been sitting up in some smoking or billiard room in the farther wing of the house, the windows of which we had not seen.	喫煙室なりビリヤードルームなり、この家のはるかな翼にあるせいで我々には窓の明かりが見えなかった部屋にいたのだ。
His broad, grizzled head, with its shining patch of baldness,	白髪交じりの髪がわずかに残された禿げ頭がつややかに輝いている。
was in the immediate foreground of our vision.	それが目の前に見えた。
He was leaning far back in the red leather chair, his legs outstretched, a long, black cigar projecting at an angle from his mouth.	赤い革をはった椅子に深く腰掛けて足を伸ばし、長くて黒い葉巻を、あの角度からして、口元にくわえているのであろう。
He wore a semi-military smoking jacket, claret-coloured, with a black velvet collar.	準軍隊様式の喫煙服はワイン色で、黒いビロードのカラーをつけている。
In his hand he held a long, legal document which he was reading in an indolent fashion, blowing rings of tobacco smoke from his lips as he did so.	手にした長い法律関係の書類をめんどくさそうに読みながら、ぷかぷかと煙を吐き出している。
There was no promise of a speedy departure in his composed bearing and his comfortable attitude.	どうにもこのくつろいだ態度からするとすぐにはでていきそうにない。
I felt Holmes's hand steal into mine and give me a reassuring shake,	ホームズの手が私の手をそっとゆすった。
as if to say that the situation was within his powers, and that he was easy in his mind.	まるで、自分は落ちついている、この状況をどうにかする自信もある、と言わんとするかのように。
I was not sure whether he had seen what was only too obvious from my position, that the door of the safe was imperfectly closed,	ちょうど私の位置からは、金庫のドアが完全には閉まっていないのが明らかすぎるほどはっきりと見えていた。
and that Milverton might at any moment observe it.	ミルヴァートンがいつそれに気づいてもおかしくない。
In my own mind I had determined that if I were sure, from the rigidity of his gaze, that it had caught his eye, I would at once spring out, throw my great coat over his head, pinion him, and leave the rest to Holmes.	もし、ミルヴァートンの目つきがこわばったりして、金庫のことに気付かれたとわかったときは、飛び出していって、自分のコートを頭にかぶせ羽交い締めにし、あとはホームズに任せようと心に決めた。
But Milverton never looked up.	だが、ミルヴァートンはまったく顔をあげなかった。
He was languidly interested by the papers in his hand, and page after page was turned as he followed the argument of the lawyer.	彼のけだるそうな興味は手もとの書類に向けられており、弁護士の議論を追って次から次にページをめくっている。
At least, I thought, when he has finished the document and the cigar he will go to his room,	長くとも、その書類を読み終えて葉巻を吸いきれば、部屋を出ていくだろうと思っていた。
but before he had reached the end of either, there came a remarkable development which turned our thoughts into quite another channel.	だが書類も葉巻も健在のうちに、驚くべきことが起こり、我々は頭を切り替えなければならなかった。
Several times I had observed that Milverton looked at his watch,	私は何度か、ミルヴァートンが時計を取り出すところを目にしていた。
and once he had risen and sat down again, with a gesture of impatience.	一度など、何かが我慢ならないといったしぐさで椅子から立ち、また座りなおしたこともあった。
The idea, however, that he might have an appointment at so strange an hour never occurred to me until a faint sound reached my ears from the veranda outside.	とはいえ、それが誰かを待っているがためのものだという考えは、やがてベランダからかすかな音が聞こえてくるまで、まったく思い浮かばなかった。
Milverton dropped his papers and sat rigid in his chair.	ミルヴァートンは書類を投げ出し、椅子にいかめしく座りなおした。
The sound was repeated, and then there came a gentle tap at the door.	ふたたび音がして、そっとドアがノックされた。
Milverton rose and opened it.	ミルヴァートンが立ちあがってドアを開ける。
``Well,''	「さて」
said he, curtly,	と、ミルヴァートンはぶっきらぼうに言った。
``you are nearly half an hour late.''	「30分近く遅れましたな」
So this was the explanation of the unlocked door and of the nocturnal vigil of Milverton.	これで、ドアがロックされておらず、ミルヴァートンが夜まで寝ずにいたことの説明がついた。
There was the gentle rustle of a woman's dress.	女ものの服の衣擦れの音がした。
I had closed the slit between the curtains as Milverton's face had turned in our direction, but now I ventured very carefully to open it once more.	ミルヴァートンの顔がこちらを向いているときはカーテンの隙間を閉ざしていた我々も、いまふたたび、慎重に開きなおした。
He had resumed his seat, the cigar still projecting at an insolent angle from the corner of his mouth.	ミルヴァートンは先ほどと同じ椅子に座り、葉巻を、角度的にいって、突きあげるように口にくわえているようだ。
In front of him, in the full glare of the electric light, there stood a tall, slim, dark woman,	彼の正面には、電灯のまばゆい光に照らされて、背が高くてスリムな、黒づくめの女性が立っていた。
a veil over her face, a mantle drawn round her chin.	ヴェールが顔をおおっていて、マントがあごのあたりにまで巻きつけられている。
Her breath came quick and fast, and every inch of the lithe figure was quivering with strong emotion.	呼吸がひどくあらく、全身くまなく感情的に震えていた。
``Well,''	「さて」
said Milverton,	とミルヴァートンが言った。
``you made me lose a good night's rest, my dear.	「ほんとうならもうぐっすり眠っている時間なんですよ、私は。
I hope you'll prove worth it.	それだけの価値があるよう願いたいものです。
You couldn't come any other time -- eh?''	もっと別の時間にこられたんじゃありませんか？」
The woman shook her head.	その女性はかぶりをふった。
``Well, if you couldn't you couldn't.	「まあ、無理なものは無理ですからね。
If the Countess is a hard mistress, you have your chance to get level with her now.	伯爵婦人がひどいご主人だというのでしたら、いまこそ仕返しをするチャンスというものです。
Bless the girl, what are you shivering about?	おやおや、いったいなにをそんなに震えているのです？
That's right.	だいじょうぶ、
Pull yourself together.	しっかりなさい！
Now, let us get down to business.''	さ、ビジネスの話にうつりましょう」
He took a notebook from the drawer of his desk.	そう言うと、ミルヴァートンは机の引出しからノートを1冊とりだした。
``You say that you have five letters which compromise the Countess d'Albert.	「5通、ダルベール伯爵婦人が書いた手紙をお持ちということでした。
You want to sell them.	あなたはそれを売りたい。
I want to buy them.	私はそれを買いたい。
So far so good.	ここまではけっこう。
It only remains to fix a price.	あとは値段を決めるだけです。
I should want to inspect the letters, of course.	もちろん、手紙の内容はチェックさせてくださいますね。
If they are really good specimens	もしそれがほんとうに役にたつようであれば
-- Great heavens, is it you?''	――なッ、あなたは！」
The woman, without a word, had raised her veil and dropped the mantle from her chin.	その女性は黙ってヴェールをあげ、マントをおろした。
It was a dark, handsome, clear-cut face which confronted Milverton	浅黒いが美しい、目鼻立ちのはっきりとした顔が現れて、ミルヴァートンと向かい合った。
-- a face with a curved nose, strong, dark eyebrows shading hard, glittering eyes, and a straight, thin-lipped mouth	優美な鼻、黒々とした力強い眉、その眉が作る影の中でぎらりと輝く瞳、一文字に結ばれた唇の薄い口。
set in a dangerous smile.	物騒な微笑を浮かべている。
``It is I,'' she said,	「そう、わたくし。
``the woman whose life you have ruined.''	おまえのせいで人生をめちゃくちゃにされてしまった女」
Milverton laughed, but fear vibrated in his voice.	ミルヴァートンは笑い飛ばしたが、その声は恐怖に震えていた。
``You were so very obstinate,'' said he.	「そちらが頑固すぎたのですよ。
``Why did you drive me to such extremities?	なぜ私にあんな極端な真似をさせたんです？
I assure you I wouldn't hurt a fly of my own accord, but every man has his business,	言っておきますが、私はひとりじゃハエ1匹殺せませんけれども、人間には仕事があるんです。
and what was I to do?	私に何ができたというのです？
I put the price well within your means.	私はちゃんと、そちらの手の届く範囲で値段をおつけしました。
You would not pay.''	あなたはお支払いになろうとしませんでした」
``So you sent the letters to my husband,	「そこでおまえは夫にあの手紙を送りつけました。
and he -- the noblest gentleman that ever lived, a man whose boots I was never worthy to lace	夫は、わたくしなど靴紐を結んでさしあげるほどの価値もない、りっぱなりっぱな紳士でした。
-- he broke his gallant heart and died.	手紙を受け取った夫は心痛のあまり亡くなりました。
You remember that last night, when I came through that door, I begged and prayed you for mercy,	おぼえていますね、あの最後の晩、あそこのドアを通ってここにきたわたくしが、おまえの慈悲をこいもとめ、すがりついたときのことを。
and you laughed in my face	おまえは笑った。
as you are trying to laugh now,	いまも同じように笑おうとしている。
only your coward heart cannot keep your lips from twitching.	いくじのないせいでひどく唇がゆがんでいますけどね？
Yes, you never thought to see me here again,	ええ、わたくしとこうしてまた会おうとはまったく思いもよらなかったことでしょうからね。
but it was that night which taught me how I could meet you face to face, and alone.	けれどもあの晩、どうすればおまえと一対一で会えるものか、教えられたのよ。
Well, Charles Milverton, what have you to say?''	さあチャールズ・ミルヴァートン、何か言いたいことはありまして？」
``Don't imagine that you can bully me,''	「私に手を出せるなんて思わないことです」
said he, rising to his feet.	と言ってミルヴァートンは立ちあがった。
``I have only to raise my voice, and I could call my servants and have you arrested.	「ただ声をあげるだけで召使いがやってきてあなたを捕まえてくれましょうから。
But I will make allowance for your natural anger.	ですが、そちらのお怒りもごもっともです。
Leave the room at once as you came,	許してあげますから、さっさと今きたところからでておゆきなさい。
and I will say no more.''	あとは黙っておきましょう」
The woman stood with her hand buried in her bosom, and the same deadly smile on her thin lips.	女は胸元に手を入れて立ちあがり、先ほどと同じ恐ろしい微笑を口元にうかべた。
``You will ruin no more lives as you have ruined mine.	「おまえにはもう他人の人生をめちゃくちゃにさせはしない。
You will wring no more hearts as you wrung mine.	わたくしの二の舞にさせはしない。
I will free the world of a poisonous thing.	世界を害虫から守るのだ。
Take that, you hound	これでもくらえ、犬め、これでもか！
-- and that! -- and that!	――これでもか！
-- and that! -- and that!''	――これでもか！」
She had drawn a little gleaming revolver, and emptied barrel after barrel into Milverton's body,	女は底光りする小さなリボルバーをとりだすと、ミルヴァートンの体に次々と弾丸をうちこんだ。
the muzzle within two feet of his shirt front.	銃口からミルヴァートンのシャツまで60センチ足らずであったろう。
He shrank away and then fell forward upon the table, coughing furiously and clawing among the papers.	ミルヴァートンはたじろぎ、はげしくせきこみながら前のめりになって机のうえに倒れこみ、書類をかきむしった。
Then he staggered to his feet, received another shot, and rolled upon the floor.	それからよろめきながら立ちあがったところでもう一発受け、床に転がった。
``You've done me,''	そして
he cried, and lay still.	と叫んだきり、静かに横たわった。
The woman looked at him intently, and ground her heel into his upturned face.	女はじっとミルヴァートンを見つめていたが、やがてあおむけの顔をかかとでふみにじった。
She looked again, but there was no sound or movement.	そしてふたたび見おろしたが、ミルヴァートンはもはやうめきもせず、ぴくりとも動かなかった。
I heard a sharp rustle, the night air blew into the heated room,	するどい衣擦れの音がして、熱い室内に夜風が吹きこむ。
and the avenger was gone.	そして、復讐者は去った。
No interference upon our part could have saved the man from his fate,	我々がどう割ってはいってもあの男を悲運から救うことはできなかったであろう。
but, as the woman poured bullet after bullet into Milverton's shrinking body I was about to spring out,	だが私は、女がミルヴァートンのよろめいたところにたてつづけに弾丸を撃ちこんだときには、飛び出していこうとした。
when I felt Holmes's cold, strong grasp upon my wrist.	そんな私の手首を、ホームズの冷たい手が握りしめた。
I understood the whole argument of that firm, restraining grip	そのしっかりとした握り方が言わんとすることすべてを私は理解した
-- that it was no affair of ours, that justice had overtaken a villain, that we had our own duties and our own objects, which were not to be lost sight of .	――つまりそれは我々に関係のないことであり、つまりそれは悪に裁きがくだされたということであり、つまりそれは我々には我々の見失ってはならない義務と目的があるということだった。
But hardly had the woman rushed from the room when Holmes, with swift, silent steps, was over at the other door.	だが女が部屋を飛び出したとたんホームズは、すばやくしずかな足取りで廊下へのドアに飛びつき、
He turned the key in the lock.	鍵をかけた。
At the same instant we heard voices in the house and the sound of hurrying feet.	その瞬間、家の中から声が聞こえ、急ぎ足で向かってくる足音がした。
The revolver shots had roused the household.	銃声が家のものを起こしてしまったのだ。
With perfect coolness Holmes slipped across to the safe, filled his two arms with bundles of letters, and poured them all into the fire.	非のうちどころのない冷静さで、ホームズは金庫にすりより、手紙の束を腕一杯に抱えこんでからそれを暖炉に放りこんだ。
Again and again he did it, until the safe was empty.	くりかえしくりかえし、金庫が空になるまで。
Someone turned the handle and beat upon the outside of the door.	だれかがノブをがちゃがちゃ回し、ドアを外から叩いている。
Holmes looked swiftly round.	ホームズがすばやくあたりを見まわした。
The letter which had been the messenger of death for Milverton lay, all mottled with his blood, upon the table.	ミルヴァートンにとって死神のメッセージとなった手紙が、血まみれになって机のうえに残されていた。
Holmes tossed it in among the blazing papers.	ホームズはその手紙も燃え盛る手紙の山に投げこんだ。
Then he drew the key from the outer door, passed through after me, and locked it on the outside.	それから外にでるドアの鍵をとりあげると、私につづいてそのドアをくぐり、外側から鍵をかけた。
``This way, Watson,'' said he,	「こっちだ、ワトスン。
``we can scale the garden wall in this direction.''	こっちのほうにある庭の壁はよじのぼれる」
I could not have believed that an alarm could have spread so swiftly.	警報は信じられないスピードで広まっていた。
Looking back, the huge house was one blaze of light.	ふりかえると、巨大な家中の明かりがともっている。
The front door was open, and figures were rushing down the drive.	正面玄関は開け放たれ、複数の人影が私道を駆けおりていた。
The whole garden was alive with people, and one fellow raised a view-halloa as we emerged from the veranda and followed hard at our heels.	庭中人だらけで、我々がベランダから飛び出すと、そのうちの一人が「いたぞ！」という叫びをあげて追いかけてきた。
Holmes seemed to know the grounds perfectly, and he threaded his way swiftly among a plantation of small trees,	ホームズはこの庭のことを完璧に把握しているらしく、すばやく低木の植えこみの間を縫って走った。
I close at his heels,	私もその後をぴったりと追った。
and our foremost pursuer panting behind us.	追っ手も我々の背後で息を弾ませていた。
It was a six-foot wall which barred our path, but he sprang to the top and over.	目的の壁は2メートルほどあったが、ホームズはその上に飛びつき、向こう側に飛び降りた。
As I did the same I felt the hand of the man behind me grab at my ankle,	続いて私が飛ぼうとすると、追っ手に足首をつかまれてしまった。
but I kicked myself free and scrambled over a grass-strewn coping.	だがそれを蹴り飛ばして振りほどき、苔むした塀から身をおどらせた。
I fell upon my face among some bushes, but Holmes had me on my feet in an instant,	なにかの茂みに顔をつっこんでしまったが、すぐにホームズが立ちあがらせてくれた。
and together we dashed away across the huge expanse of Hampstead Heath.	それから2人一緒に広大なハムステッド・ヒースを全力で走った。
We had run two miles, I suppose, before Holmes at last halted and listened intently.	たぶん2マイルほどいったところだったと思う、ホームズはついに立ち止まり、聞き耳を立てた。
All was absolute silence behind us.	背後は完全な静寂に包まれていた。
We had shaken off our pursuers and were safe.	追っ手は振りきった、もう安全だ。
We had breakfasted and were smoking our morning pipe on the day after the remarkable experience which I have recorded, when Mr. Lestrade, of Scotland Yard, very solemn and impressive, was ushered into our modest sitting-room.	ここに記録した冒険の翌朝、朝食をすませた我々がパイプをたのしんでいるところに、スコットランドヤードのミスター・レストレイドが、たいへん重々しくいかめしい態度で我々の質素な部屋に通されてきた。
``Good-morning, Mr. Holmes,'' said he; 	「おはようございます、ミスター・ホームズ。
``good-morning.	おはようございます。
May I ask if you are very busy just now?''	お忙しいところすみませんが、お時間をよろしいでしょうか？」
``Not too busy to listen to you.''	「きみの話を聞いていられないほど忙しくはないよ」
``I thought that, perhaps, if you had nothing particular on hand, you might care to assist us in a most remarkable case,	「もしいま手が空いておられるのでしたら、たぶん、私どものほうを手伝ってもらえないかと思ったものですから。
which occurred only last night at Hampstead.''	ちょうど昨晩、ハムステッドでこのうえなく異常な事件が起きましてね」
``Dear me!''	「おやおや！」
said Holmes.	とホームズ。
``What was that?''	「いったいどんな？」
``A murder	「殺しです
-- a most dramatic and remarkable murder.	――このうえなく劇的かつ異常な殺しですよ。
I know how keen you are upon these things,	この手の事件には目がないですからね、ホームズさんは。
and I would take it as a great favour if you would step down to Appledore Towers, and give us the benefit of your advice.	それで、アップルドア・タワーズまでご足労いただいて、なにか有益なアドバイスをしていただけるととてもありがたいのですが。
It is no ordinary crime.	並大抵の事件じゃないですよ。
We have had our eyes upon this Mr. Milverton for some time, and, between ourselves, he was a bit of a villain.	我々もこのミスター・ミルヴァートンにはここしばらく目をつけてましてね、我々の間ではちょっとした悪人ということになっていました。
He is known to have held papers which he used for blackmailing purposes.	いろんな書類を握っては、それを使って強請っていたようです。
These papers have all been burned by the murderers.	その書類も、いまはぜんぶ犯人どもに焼かれてしまいました。
No article of value was taken,	貴重品類に手をつけたあとはありません。
as it is probable that the criminals were men of good position,	おそらく地位のあるやつらですな。
whose sole object was to prevent social exposure.''	社会的失墜を防ぐというただそれだけのために凶行に及んだのでしょう」
``Criminals?''	「犯人ども、ね！」
said Holmes.	とホームズが言った。
``Plural?''	「複数か！」
``Yes, there were two of them.	「ええ、2人組でした。
They were as nearly as possible captured red-handed.	あとちょっとで現行犯逮捕してやれたんですがね。
We have their footmarks, we have their description,	足跡もとってありますし、風体もわかっています。
it's ten to one that we trace them.	十中八九、つきとめてやれますよ。
The first fellow was a bit too active, but the second was caught by the under-gardener, and only got away after a struggle.	第一の男はすばしっこくてどうにもならんかったのですが、2人めは園丁の助手に追いつかれてですな、格闘のすえ、逃げていきました。
He was a middle-sized, strongly built man	中背の、がっしりした男で
-- square jaw, thick neck, moustache, a mask over his eyes.''	――角張ったあご、太い首、くちひげ、目はマスクで隠されていたということです」
``That's rather vague,''	「いまいち曖昧だな」
said Sherlock Holmes.	と、シャーロック・ホームズは言う。
``Why, it might be a description of Watson!''	「だってそれじゃあ、ワトスンのことかもしれないぞ！」
``It's true,''	「そうなんですよ」
``It's true,'' said the inspector, with amusement.	と警部はたいへん愉快そうに言う。
``It might be a description of Watson.''	「これはドクターのことかもしれませんな」
``Well, I'm afraid I can't help you, Lestrade,'' said Holmes.	「ま、残念ながら手伝えないよ、レストレイド。
``The fact is that I knew this fellow Milverton,	実はさ、このミルヴァートンというやつのことを知っていてね。
that I considered him one of the most dangerous men in London, and that I think there are certain crimes which the law cannot touch,	ロンドンでいちばん危険な男のひとりだと思っていたし、ある種の犯罪は法の手をいれることができないとも思う。
and which therefore, to some extent, justify private revenge.	つまりだね、ある程度は、個人的な復讐というのもありだと思うんだよ。
No, it's no use arguing.	いや、議論は無用だ。
I have made up my mind.	ぼくの心はもう決まっている。
My sympathies are with the criminals rather than with the victim, and I will not handle this case.''	どちらかというと被害者よりも加害者の方に同情してるからね、この事件を扱うつもりはない」
Holmes had not said one word to me about the tragedy which we had witnessed, but I observed all the morning that he was in his most thoughtful mood,	我々が目撃した悲劇についてホームズはひとことも言ってくれなかったが、よく見れば、ホームズもその朝ずっと物思いにふけっていた。
and he gave me the impression, from his vacant eyes and his abstracted manner, of a man who is striving to recall something to his memory.	ぼんやりとした瞳や、身の入っていない仕草からして、何かを思い出そうとしているのだと思われた。
We were in the middle of our lunch, when he suddenly sprang to his feet.	昼食中、ホームズはとつぜん席からとびあがって
``By Jove, Watson, I've got it!''	「わかったぞ、ワトスン、わかった！」
he cried.	と叫んだ。
``Take your hat!	「さあ帽子をかぶって
Come with me!''	ついてくるんだ！」
He hurried at his top speed down Baker Street and along Oxford Street, until we had almost reached Regent Circus.	全力疾走でベイカー街からオックスフォード街に入り、まもなくリージェント街というところまできた。
Here, on the left hand, there stands a shop window filled with photographs of the celebrities and beauties of the day.	そこの左手には当代の貴顕麗人の写真を並べたショーウィンドウがある。
I saw the picture of a regal and stately lady in Court dress, with a high diamond tiara upon her noble head.	その中に、宮廷服を身につけた貴婦人がいて、ダイアモンドをあしらったティアラが品のよい顔を飾っていた。
I looked at that delicately curved nose, at the marked eyebrows, at the straight mouth, and the strong little chin beneath it.	優美な鼻、くっきりとした眉、まっすぐの口元、ほっそりしていながら力強いあご。
Then I caught my breath as I read the time-honoured title of the great nobleman and statesman whose wife she had been.	彼女の夫の、偉大な貴族であり政治家であったことを示す華やかな肩書きを読んで私は息をのんだ。
My eyes met those of Holmes, and he put his finger to his lips	ホームズは私と視線を交わすと、唇に指をあてた。
as we turned away from the window.	そして、我々はそのウィンドウから離れていったのであった。
Milverton」	原文：「The Return of Sherlock Holmes」所収「The Adventure of Charles Augustus
Arthur Conan Doyle 1904, expired. Copyright &copy; Kareha 2000-2001, waived.	翻訳：枯葉<domasa@db3.so-net.ne.jp>
