What the Moon Saw	絵のない絵本
Hans Christian Andersen	クリスチャン・アンデルセン
FIRST EVENING	第一夜
"Last night"	「昨晩」、
- I am quoting the Moon's own words -	わたしはお月さまが口にしたままを書いています。
"last night I was gliding through the cloudless Indian sky.	「昨晩、私はインドの雲ひとつない空にいて、
My face was mirrored in the waters of the Ganges,	私の顔がガンジス河の水面に映し出されていました。
and my beams strove to pierce through the thick intertwining boughs of the bananas, arching beneath me like the tortoise's shell.	私の光は、下の方でまるでカメの甲羅みたいにこんもりしているバナナの太い絡み合う枝のあいだまで照らし出しました。
Forth from the thicket tripped a Hindoo maid, light as a gazelle, beautiful as Eve.	そのこんもりとしているところから、カモシカのように身軽でイブのように美しい、一人のインド人の娘が飛び出してきました。
Airy and etherial as a vision, and yet sharply defined amid the surrounding shadows, stood this daughter of Hindostan:	このヒンドゥーの娘は立ちすくんでいて、見た目は軽やかでとても美しく、それでいてまわりの闇からははっきりと目立ちました。
I could read on her delicate brow the thought that had brought her hither.	彼女の繊細な表情から、どうしてここにきたかを読み取ることが出来ます。
The thorny creeping plants tore her sandals, but for all that she came rapidly forward.	下をはう、とげだらけの植物が彼女のサンダルを破りましたが、そんなことには全然かまわず彼女は先へといそぎました。
The deer that had come down to the river to quench her thirst, sprang by with a startled bound, for in her hand the maiden bore a lighted lamp.	乾きをいやすために河へとやってきたシカは、彼女が手にもえさかる炎をもっていたので、びっくりして飛びのきます。
I could see the blood in her delicate finger tips, as she spread them for a screen before the dancing flame.	彼女はゆらぐ炎が消えないように手でおおっていましたから、その細い指先には血管がすけてみえました。
She came down to the stream, and set the lamp upon the water,	河のそばまで降りてくると、炎が水面に映りました。
and let it float away.	映った炎は河の流れにそって流れていきます。
The flame flickered to and fro, and seemed ready to expire;	炎は前後に大きくゆらいで、今にも消えてしまいそうでしたが、
but still the lamp burned on,	まだ燃えつづけてしました。
and the girl's black sparkling eyes, half veiled behind their long silken lashes, followed it with a gaze of earnest intensity.	少女の黒くかがやける瞳は、長いシルクのようなまつげで半分かくれていましたが、真剣なまなざしで河に映った炎を追っています。
She knew	彼女は知っていました。
that if the lamp continued to burn so long as she could keep it in sight, her betrothed was still alive;	もし見えている限り炎がもえつづけていれば、彼女のいいなづけはまだ生きているということを。
but if the lamp was suddenly extinguished, he was dead.	ただもし炎がとつぜん消えてしまえば、彼は死んでしまったと。
And the lamp burned bravely on, and she fell on her knees, and prayed.	炎はしっかり燃えつづけ、彼女はひざまづき祈りました。
Near her in the grass lay a speckled snake, but she heeded it not	すぐわきの草のなかには斑点のある蛇がいましたが、彼女はそんなことは気にかけません。
- she thought only of Bramah and of her betrothed.	彼女が考えていたのは、インドの神様といいなづけのことだけでした。
'He lives!'	「生きてる」
she shouted joyfully,	彼女はよろこびのあまり叫びました。
'he lives!'	「生きてるのよ」
And from the mountains the echo came back upon her,	山々からはこだまがかえってきます。
'he lives!'"	「生きてるのよ」
SECOND EVENING	第二夜
"Yesterday,"	「昨日」、
said the Moon to me,	お月さまはわたしに語りかけます。
"I looked down upon a small courtyard surrounded on all sides by houses.	「四方を家々にかこまれた小さな中庭を私は見下ろしていました。
In the courtyard sat a clucking hen with eleven chickens;	中庭には一匹のめんどりと十一匹のひよこがいます。
and a pretty little girl was running and jumping around them.	一人の小さなかわいい女の子が、そのまわりをとびはねながら走りまわっていました。
The hen was frightened, and screamed,	めんどりはびっくりして、鳴きさけびます。
and spread out her wings over the little brood.	そして羽をおおきくひろげ、ひよこたちをかばいました。
Then the girl's father came out and scolded her;	すると女の子の父親が家からでてきて、女の子をしかりつけました。
and I glided away and thought no more of the matter.	私は空を動き、それっきりそのことを忘れていました」
"But this evening, only a few minutes ago,	「でも今晩、数分前のことです。
I looked down into the same courtyard.	私は同じ中庭を見下ろしていました。
Everything was quiet.	あたりいちめん静まりかえっていましたが、
But presently the little girl came forth again,	とつぜんあの小さな女の子がまた出てきました。
crept quietly to the hen-house, pushed back the bolt, and slipped into the apartment of the hen and chickens.	しずかに鶏小屋にしのびよるとかんぬきをはずして、めんどりとひよこがいるところへと入っていきます。
They cried out loudly, and came fluttering down from their perches, and ran about in dismay,	めんどりとひよこは大声をあげて止まり木から飛び降り、びっくりぎょうてんして走り回っています。
and the little girl ran after them.	そして小さな女の子は、そのあとを追いかけまわしているのです。
I saw it quite plainly, for I looked through a hole in the hen-house wall.	私には、鶏小屋の壁の穴からこの光景がはっきりと見えました。
I was angry with the willful child, and felt glad when her father came out and scolded her more violently than yesterday, holding her roughly by the arm;	私はこのわがままな子供にすっかり腹をたてて、父親が家からでてきて昨日よりひどくしかりつけ、腕をきつくつかんだときには嬉しくおもったほどです。
she held down her head,	女の子はうなだれました。
and her blue eyes were full of large tears.	その青い目にはおおつぶの涙があふれています。
'What are you about here?'	「ここで何をしてたんだ」
he asked.	父親はたずねました。
She wept and said,	女の子は泣きじゃくりながら答えます。
'I wanted to kiss the hen and beg her pardon for frightening her yesterday;	「きのうおどかしたから、めんどりさんにキスしてあやまろうと思ったの。
but I was afraid to tell you.'	でもこわくて、お父さんにはいえなかったんだもの」
"And the father kissed the innocent child's forehead,	「父親は無垢な子供の額にキスをしてやりました。
and I kissed her on the mouth and eyes."	もちろん私もその子の目と口にキスをしましたとも」
THIRD EVENING	第三夜
"In the narrow street round the corner yonder- it is so narrow that my beams can only glide for a minute along the walls of the house, but in that minute I see enough to learn what the world is made of	「向こうの街角のせまい通りで、あんまりせまいので私の光も家の壁にそって一分ほどしかとどかないところなのですが、その一分でも私にはどんなことが起きているかをみるには十分です。
- in that narrow street I saw a woman.	そのせまい通りで、私はひとりの女性をみました。
Sixteen years ago that woman was a child, playing in the garden of the old parsonage, in the country.	十六年前にはその女性も子供で、田舎の古い牧師館の庭であそんでいました。
The hedges of rose-bush were old, and the flowers were faded.	バラのいけがきもかれ、花もしおれていましたが
They straggled wild over the paths, and the ragged branches grew up among the boughs of the apple trees;	小道まで生いしげり、とげのある枝をりんごの木々の枝にまでのばしていました。
here and there were a few roses still in bloom - not so fair as the queen of flowers generally appears,	あちこちでバラの花がいくつか咲いていましたが、よくいわれるところの花の女王というほどではありません。
but still they had colour and scent too.	ただ色と香りはなかなかのものでしたけど。
The clergyman's little daughter appeared to me a far lovelier rose,	牧師の小さな娘のほうが、私にとってはずっと愛らしいバラにおもえました。
as she sat on her stool under the straggling hedge, hugging and caressing her doll with the battered pasteboard cheeks.	その女の子はおいしげった生垣の下にこしかけて、使いふるされてぼろぼろになった人形にほおずりをしていました」
"Ten years afterwards I saw her again.	「十年後、ふたたび彼女をみました。
I beheld her in a splendid ballroom:	はなやかな舞踏室にいたのです。
she was the beautiful bride of a rich merchant.	お金持ちの商人の美しい花嫁となっていました。
I rejoiced at her happiness, and sought her on calm quiet evenings -	私も彼女の幸せを祝福し、静かでおだやかな晩には彼女のもとに訪れたものです。
ah, nobody thinks of my clear eye and my silent glance!	だれも私のすきとおった目としずかなまなざしに気づく人はいなかったのですが。
Alas! my rose ran wild, like the rose bushes in the garden of the parsonage.	それにあの牧師館の庭のバラのしげみのように、私のバラも伸び放題になっていました。
There are tragedies in every-day life,	日常生活にも悲劇はあります。
and tonight I saw the last act of one.	今晩その最後の一幕を私はみたのです」
"She was lying in bed in a house in that narrow street:	「そのせまい通りの一軒の家に彼女は横たわっていました。
she was sick unto death,	死にいたる病でした。
and the cruel landlord came up, and tore away the thin coverlet, her only protection against the cold.	冷酷な大家がやってきて、寒さから彼女を唯一守ってくれるうすい上布団をひきはがし、
'Get up!'	『起きろ』
said he;	といいました。
'your face is enough to frighten one.	『おまえの顔をみるとぞっとするくらいだ、
Get up and dress yourself, give me money,	さっさと起きて着飾って、おれのところに金をもってこい。
or I'll turn you out into the street!	じゃなきゃ道端にでもほうりだすぞ、
Quick - get up!'	いそげ、起きるんだ』
She answered,	彼女は答えました。
'Alas!	『あぁ、
death is gnawing at my heart.	死がわたしの胸をむしばんでるんです。
Let me rest.'	どうか休ませてください』
But he forced her to get up and bathe her face, and put a wreath of roses in her hair;	しかし大家は彼女を無理やり起し、化粧させ、髪にはバラのかざりをさし、
and he placed her in a chair at the window,	窓際の椅子にすわらせました。
with a candle burning beside her, and went away.	そしてそばにろうそくを一本ともして、出て行きました」
"I looked at her, and she was sitting motionless, with her hands in her lap.	「私は彼女をみましたが、両手をひざにのせ身動きひとつせず座っていました。
The wind caught the open window and shut it with a crash, so that a pane came clattering down in fragments;	風がふき、開いた窓が大きな音をたてて閉じ、窓ガラスが一枚こなごなにくだけました。
but still she never moved.	でも彼女はぴくりともしません。
The curtain caught fire, and the flames played about her face;	カーテンに火がもえうつり、炎が顔をてらしだします。
and I saw that she was dead.	私には彼女が死んでいるのがわかりました。
There at the open window sat the dead woman, preaching a sermon against sin	開いた窓の側に死んだ女性が座っていて、それは原罪にたいする説教になっています。
- my poor faded rose out of the parsonage garden!"	牧師館の庭から生えた私のかわいそうなしおれたバラ」
FOURTH EVENING	第四夜
"This evening I saw a German play acted,"	「今夜私はドイツ演劇が上演されるのをみました」
said the Moon.	お月さまはそう語りだしました。
"It was in a little town.	「そこは小さな町でした。
A stable had been turned into a theatre;	ある馬小屋が劇場になっていて、
that is to say, the stable had been left standing, and had been turned into private boxes,	そうです、馬がいるところもそのままで、特別見物室になっていました。
and all the timber work had been covered with coloured paper.	そして木でできていたところは全て色紙でおおわれています。
A little iron chandelier hung beneath the ceiling, and that it might be made to disappear into the ceiling, as it does in great theatres, when the ting-ting of the prompter's bell is heard, a great inverted tub has been placed just above it.	天井からは鉄でできた小さなシャンデリアがぶらさげられていて、豪華な劇場みたいに合図のベルが聞こえると、大きな逆さになった桶がシャンデリアの上にかぶさり、まるで天井に消えていくかのようにみせていました」
" 'Ting-ting!'	「チリン、チリン」
and the little iron chandelier suddenly rose at least half a yard and disappeared in the tub;	とベルがなりひびき、鉄でできた小さなシャンデリアはとつぜん半ヤードほども持ち上げられ、桶のなかに姿をけしました。
and that was the sign that the play was going to begin.	劇がまさにはじまろうとしている合図です。
A young nobleman and his lady, who happened to be passing through the little town, were present at the performance,	若く高貴な生まれの男とその妻が、たまたまその町をとおりかかって、観劇におとずれていました。
and consequently the house was crowded.	そのために小屋は人でいっぱいでした。
But under the chandelier was a vacant space like a little crater:	ただシャンデリアの下だけには、噴火口みたいにぽっかりとスペースができていましたが。
not a single soul sat there, for the tallow was dropping, drip, drip!	ろうがぽたり、ぽたりと落ちてくるので、誰もそこには座らなかったのです。
I saw everything, for it was so warm in there that every loophole had been opened.	小屋はあまりに暑苦しく、すべての小窓があけっぱなしになっていたので、私は全てを見とおすことができました。
The male and female servants stood outside, peeping through the chinks, although a real policeman was inside, threatening them with a stick.	男も女も召使たちは外にたっていましたが、すきまから覗きこもうとしては、中にいた本物の警官に警棒でおどされています。
Close by the orchestra could be seen the noble young couple in two old arm-chairs,	オーケストラの近くに高貴な若い二人のカップルが、古いひじかけいすに腰かけているのが見て取れました。
which were usually occupied by his worship the mayor and his lady;	その席はいつもならば、町長と奥さんに敬意を評して提供されているものでした。
but these latter were to-day obliged to content themselves with wooden forms, just as if they had been ordinary citizens;	でも町長夫妻は今日はまるでふつうの町民であるかのように、木製のベンチでがまんしなければなりません。
and the lady observed quietly to herself,	町長の奥さんは、しずかにひとりごちました
'One sees, now, that there is rank above rank;'	「上には上がいるってことを知らなくては」
and this incident gave an air of extra festivity to the whole proceedings.	そしてこのできごとが、全体のなりゆきにいっそうお祭りらしい雰囲気をもたらしていました。
The chandelier gave little leaps, the crowd got their knuckles rapped, and I, the Moon, was present at the performance from beginning to end."	シャンデリアが小さく動き、のぞいていた連中はこっぴどく怒られ、そして私も最初から最後まで劇をみましたとも」
FIFTH EVENING	第五夜
"Yesterday,"	「昨日」
began the Moon,	お月さまは話しはじめました。
"I looked down upon the turmoil of Paris.	「私はパリの大騒ぎを見下ろしていました。
My eye penetrated into an apartment of the Louvre.	私の目は、ルーブル宮殿のある部屋でとまりました。
An old grandmother, poorly clad - she belonged to the working class - was following one of the under-servants into the great empty throne-room,	一人の下層階級のぼろを身にまとった老婆が下働きのあとについて、広いがらんとした王座のある室へと入っていきます。
for this was the apartment she wanted to see - that she was resolved to see;	ここが老婆が見てみたいと思い、見ると心に決めていた部屋でした。
it had cost her many a little sacrifice, and many a coaxing word, to penetrate thus far.	この部屋にまでくるのには、ちょっとした贈り物やおべんちゃらをたくさんつかわなければなりませんでしたが。
She folded her thin hands, and looked round with an air of reverence, as if she had been in a church.	彼女は自分の細い手を組み合わせ、教会にでもいるかのように畏敬の念にうたれ、あたりをみまわしました」
"'Here it was!'	「ここ」
she said,	と言葉をもらすと
'here!'	「ここだったのね」
and she approached the throne,	と王座の方へ近づいていきました。
from which hung the rich velvet fringed with gold lace.	王座からは金のレースの縁取りのすばらしいビロードがたれさがっています。
'There,'	「そこ」
she exclaimed,	と彼女は感動をこめた声をもらしました。
'there!'	「そこなんだ」
and she knelt and kissed the purple carpet.	そしてひざまづき、紫のカーペットに口づけました。
I think she was actually weeping.	私は彼女は本当に泣いていたと思います。
"'But it was not this very velvet!'	「でもこれが当時のビロードだったわけじゃないぜ」
observed the footman, and a smile played about his mouth.	と召使は声をかけ、その口元には笑みがうかんでいました。
'True,	「そうなんでしょう。
but it was this very place,'	でもまさにここがその場所だったのね」
replied the woman,	老婆は答えました。
'and it must have looked just like this'.	「それにこんな感じだったにちがいないわ」
'It looked so, and yet it did not,'	「そうかもしれないし、そうじゃなかったかもしれない」
observed the man:	と召使。
'the windows were beaten in, and the doors were off their hinges, and there was blood upon the floor.'	「窓という窓は割られていて、ドアというドアはちょうつがいから壊され、床には血だまりができてたからな」
'But for all that you can say, my grandson died upon the throne of France.	「でもあなたがなんと言おうとも、わたしの孫はフランス王座で死んだのよ、
Died!'	そう死んだ」
mournfully repeated the old woman.	老婆は悲しげにくりかえしました。
I do not think another word was spoken,	私はそれ以上何かが語られたとはおもいません。
and they soon quitted the hall.	二人はホールをでていきました。
The evening twilight faded and my light shone doubly vivid upon the rich velvet that covered the throne of France.	たそがれは闇となり、私の光がフランス王座のすばらしいビロードをいっそう明るく照らし出しました。
"Now who do you think this poor woman was?	「さて、このかわいそうな老婆はだれだったと思いますか？
Listen, I will tell you a story.	聞いてください、これからそのお話をしますから」
"It happened, in the Revolution of July, on the evening of the most brilliantly victorious day,	「７月革命の、もっとも輝かしい勝利の日の夕方に起こったことです。
when every house was a fortress, every window a breastwork.	全ての家が要塞になり、全ての窓が胸壁となっていました。
The people stormed the Tuileries.	民衆はチュイルリー宮殿を急襲しました。
Even women and children were to be found among the combatants.	戦う人の中には女性や子供でさえみてとれました。
They penetrated into the apartments and halls of the palace.	かれらは宮殿の部屋やホールへとなだれこみます。
A poor half-grown boy in a ragged blouse fought among the older insurgents.	ぼろぼろの上着をきた貧しい少年が一人、大人の反乱軍にまじって戦っていました。
Mortally wounded with several bayonet thrusts, he sank down.	銃剣で何箇所にも傷をうけたのが致命傷になり、少年は倒れました。
This happened in the throne-room.	それは王座のある部屋でのことでした。
They laid the bleeding youth upon the throne of France,	群集は血まみれの少年を、フランス王座に横たわらせました。
wrapped the velvet around his wounds, and his blood streamed forth upon the imperial purple.	傷にビロードをまき、血が紫のカーペットにひろがり、
There was a picture!	そのありさまはまるで絵のようでした。
The splendid hall, the fighting groups!	豪奢なホールで、戦う人たち。
A torn flag upon the ground, the tricolor was waving above the bayonets,	床には引き裂かれた旗があり、三色旗が銃剣の先ではためいています。
and on the throne lay the poor lad with the pale glorified countenance, his eyes turned towards the sky, his limbs writhing in the death agony, his breast bare, and his poor tattered clothing half hidden by the rich velvet embroidered with silver lilies.	そして王座にはかわいそうな少年が青ざめた顔つきで、目は空をみつめ、四肢は死の苦しみでもだえ、胸をはだけ、そのみじめなぼろぼろの服は銀色の縁取り刺繍があるすばらしいビロードで半分覆われています。
At the boy's cradle a prophecy had been spoken:	少年のゆりかごでは、一つの予言がされていました
'He will die on the throne of France!'	『この子はフランス王座で死ぬことになるでしょう』
The mother's heart dreamt of a second Napoleon.	母親の胸には第二のナポレオンの夢が浮かんだことでしょう」
"My beams have kissed the wreath of immortelles on his grave,	「私の光は、その少年のお墓の花にキスをしました。
and this night they kissed the forehead of the old grandame, while in a dream the picture floated before her which thou mayest draw -	そして老婆の額にもキスをした今夜、夢の中では彼女の前にあなたが書いたかもしれない絵が浮かんだことでしょう。
the poor boy on the throne of France."	そうフランス王座にすわった貧しい少年の絵が」
SIXTH EVENING	第六夜
"I've been in Upsala,"	「私はウプサラにいたこともあります」
said the Moon:	お月さまは言いました。
"I looked down upon the great plain covered with coarse grass, and upon the barren fields.	「草もまばらな大平原と不毛の地を見下ろしていました。
I mirrored my face in the Tyris river, while the steamboat drove the fish into the rushes.	蒸気船が魚たちをけちらしているとき、自分の顔がチュリス川に映るのをみました。
Beneath me floated the waves, throwing long shadows on the so-called graves of Odin, Thor, and Friga.	私の下ではさざなみがたち、いわゆるオーディン、トール、フリーガの墓の上に長い影をなげかけました。
In the scanty turf that covers the hill-side names have been cut.	丘をおおうまばらな芝には、名前が書かれていました。
There is no monument here,	ここには記念碑はありません。
no memorial on which the traveller can have his name carved,	旅人が記念に自分の名前を刻むものもないのです。
no rocky wall on whose surface he can get it painted;	表面に名前が書けるような岩肌もありません。
so visitors have the turf cut away for that purpose.	したがって訪れた人たちはそのために芝生に名前を書くのです。
The naked earth peers through in the form of great letters and names;	地の肌が文字の形となって、名前となるわけです。
these form a network over the whole hill.	こうした名前は丘全体にみてとれました。
Here is an immortality,	これは永遠にのこるといってもいいでしょう。
which lasts till the fresh turf grows!	新しい芝生がはえてくるまでは」
"Up on the hill stood a man, a poet.	「丘の頂には、一人の男、詩人がたっていました。
He emptied the mead horn with the broad silver rim, and murmured a name.	広い銀の縁がついた杯ではちみつ酒をあおると、ある名前をつぶやきました。
He begged the winds not to betray him,	風に秘密にしておいてくれるよう詩人は頼みます。
but I heard the name.	でも私はその名前を聞いてしまいました。
I knew it.	私にはそれが誰だかわかりました。
A count's coronet sparkles above it,	伯爵の冠がその名前にはきらめいています。
and therefore he did not speak it out.	だから詩人はその名前を大きな声で口にしなかったのです。
I smiled, for I knew that a poet's crown adorns his own name.	私は詩人の冠がかれの名前をひきたてていることを知っていたので微笑みました。
The nobility of Eleanora d'Este is attached to the name of Tasso.	貴族のエレノラ・デストは、タッソの名前にむすびついています。
And I also know where the Rose of Beauty blooms!"	そして私はどこに美しきバラがさきほこるのかも知っていました」
Thus spake the Moon, and a cloud came between us.	そうしてお月さまがしゃべったとき、雲がひとつわたしたちの妨げになりました。
May no cloud separate the poet from the rose!	詩人とバラのあいだも雲がさまたげなければいいのですが。
SEVENTH EVENING	第七夜
"Along the margin of the shore stretches a forest of firs and beeches,	「波打ちぎわには延々と、ナラとブナの森がつづいていました。
and fresh and fragrant is this wood;	この森は生き生きとして、いい香りがしました。
hundreds of nightingales visit it every spring.	春になると何百羽のナイチンゲールがその場所を訪れます。
Close beside it is the sea, the ever-changing sea, and between the two is placed the broad high-road.	常に姿をかえる海にたいへん近くて、海と森のあいだには広い街道がはしっていました。
One carriage after another rolls over it;	馬車が次から次へと通っていきます。
but I did not follow them, for my eye loves best to rest upon one point.	ただ私はそれを追いかけることなく、視線は一点にくぎづけです。
A Hun's Grave lies there, and the sloe and blackthorn grow luxuriantly among the stones.	そこにはフン族の墓があり、スローやリンボクが岩々のあいだに生い茂り、
Here is true poetry in nature.	ここにこそ本物の詩が存在しているのです」
"And how do you think men appreciate this poetry?	「人々はいったいこの詩について、どう思っているのでしょう？
I will tell you what I heard there last evening and during the night.	昨晩、夜を通してここで語られ、私が耳にしたことをお話しましょう」
"First, two rich landed proprietors came driving by.	「最初に、たくさんの荷物をつんだ二人がやってきました。
'Those are glorious trees!'	『立派な木々だな』
said the first.	片われがいうと、
'Certainly;	『確かに、
there are ten loads of firewood in each,'	一本から十荷はたきぎがとれるな』
observed the other:	と相棒が答えました。
'it will be a hard winter, and last year we got fourteen dollars a load'	『今年の冬も寒そうだし、昨年は一荷十四ドルだっけ』
- and they were gone.	そして二人は去っていきました。
'The road here is wretched,'	『ここらの道はひどいね』
observed another man who drove past.	やってきた他の男がもらしました。
'That's the fault of those horrible trees,'	『まったくこういった木々のせいだよ』
replied his neighbour;	隣の席にすわっていたものが答えます。
'there is no free current of air;	『風がぬけていかないからな。
the wind can only come from the sea'	風は海のほうからしかこないんだ』、
- and they were gone.	そしてその二人も去っていきました。
The stage coach went rattling past.	駅馬車がガタガタ、音をたてながらやってきます。
All the passengers were asleep at this beautiful spot.	このような絶景の場所にさしかかっているのに全員寝ています。
The postillion blew his horn,	御者は警笛をふきました。
but he only thought,	ただこんなことを考えていたのです
'I can play capitally.	『おれはなんて笛をふくのが上手いんだろう。
It sounds well here.	それにこの場所ときたら一段といい響きだな。
I wonder if those in there like it?'	ここにいるやつらも気に入っただろう』
- and the stage coach vanished.	そして馬車の姿も見えなくなりました。
Then two young fellows came gallopping up on horseback.	それから二人の若い連中が馬にのってやってきました。
There's youth and spirit in the blood here! thought I;	血気盛んな若者たちだな、と私は思いました。
and, indeed, they looked with a smile at the moss-grown hill and thick forest.	そしてかれらは、モスグリーンの丘と深い森をみて笑みを浮かべます
'I should not dislike a walk here with the miller's Christine,'	『粉引小屋のクリスチーヌとここを歩くのも悪くはない』
said one -	片方がそう口にして、
and they flew past.	二人は疾風のごとく去っていきました。
"The flowers scented the air; every breath of air was hushed;	「花の香りが辺りにただよい、風もおちつき、
it seemed as if the sea were a part of the sky that stretched above the deep valley.	まるで海も深い谷の上に広がる空の一部になってしまったかのようです。
A carriage rolled by.	一台の馬車が通り過ぎ、
Six people were sitting in it.	6人が中にすわっていました。
Four of them were asleep;	4人は寝ていて、
the fifth was thinking of his new summer coat, which would suit him admirably;	5人目は自分の新しい夏の上着が自分にすばらしく似合うだろうなと考え、
the sixth turned to the coachman and asked him if there were anything remarkable connected with yonder heap of stones.	6人目は御者の方をむき、向こうに見える石が積んであるのは何かめずらしいものかと尋ねました。
'No,'	『いいや』
replied the coachman,	御者は答えました。
'it's only a heap of stones;	『ただ石が積み重ねてあるだけでさぁ、
but the trees are remarkable.'	あっちの木々は特別ですが』
'How so?'	『それはまたどうして？』
'Why I'll tell you how they are very remarkable.	『どうして特別か教えましょうや。
You see, in winter, when the snow lies very deep, and has hidden the whole road so that nothing is to be seen, those trees serve me for a landmark.	冬に雪がどっさりつもると、道がぜんぶ隠れて何もみえなくなって、その木々が目印として役立ってわけです。
I steer by them, so as not to drive into the sea;	あれを目印にするんで海につっこんでいかなくてすむってわけです。
and you see that is why the trees are remarkable.'	ほら、どうして特別かおわかりになったでしょう』」
"Now came a painter.	「それから、画家が一人やってきました。
He spoke not a word, but his eyes sparkled.	一言も話しませんでしたが、目は輝いていました。
He began to whistle.	画家が口笛をふくと、
At this the nightingales sang louder than ever.	ナイチンゲールたちも以前より大きくさえずりました。
'Hold your tongues!'	『静かに』
he cried testily;	怒ったようにいうと、
and he made accurate notes of all the colours	かれは全てのものの色と場所を正確に書きとめました。
and transitions - blue, and lilac, and dark brown.	青、薄紫、こげ茶。
'That will make a beautiful picture,'	『これはすばらしい絵になるぞ』
he said.	とふともらしました。
He took it in just as a mirror takes in a view;	画家は鏡に映ったかのようにその景色を描きます。
and as he worked he whistled a march of Rossini.	描いているあいだは、ロッシーニのマーチを口笛でふきました。
And last of all came a poor girl.	一番最後にやってきたのは貧しい少女です。
She laid aside the burden she carried, and sat down to rest upon the Hun's Grave.	運んできた荷物をおろして、フン族の墓のところで一休みしています。
Her pale handsome face was bent in a listening attitude towards the forest.	青白い整った顔で、森の方に耳を傾けています。
Her eyes brightened, she gazed earnestly at the sea and the sky,	目はきらきらと輝き、海と空を熱心にみつめていました。
her hands were folded, and I think she prayed,	両手を組み、お祈りをしていたように私は思いました。
'Our Father.'	『父なる神よ』。
She herself could not understand the feeling that swept through her,	彼女は自分でも自分の中にひろがる感情を理解できませんでした。
but I know that this minute, and the beautiful natural scene, will live within her memory for years,	ただ私は、その瞬間が、その美しい自然の風景が、彼女の記憶に何年ものあいだ生き続けることを知っていました。
far more vividly and more truly than the painter could portray it with his colours on paper.	それも画家がさまざまな色をつかって紙に描く絵よりも、もっと生き生きと、そしてもっと本物らしく。
My rays followed her till the morning dawn kissed her brow."	夜明けの光が彼女のまつげにキスをするまで、私の光は彼女を照らしつづけました」
EIGHTH EVENING	第八夜
Heavy clouds obscured the sky, and the Moon did not make his appearance at all.	どんよりした雲が夜空をおおい、お月さまはまったく姿をみせませんでした。
I stood in my little room, more lonely than ever, and looked up at the sky where he ought to have shown himself.	わたしは小さな部屋に一人たちつくし、前よりずっと寂しい想いにとらわれ、お月さまが姿をあらわすはずの夜空をながめていました。
My thoughts flew far away, up to my great friend, who every evening told me such pretty tales, and showed me pictures.	わたしの想いははるか遠く、毎晩わたしにすてきなお話をして、絵をみせてくれる親友のところまで至っていました。
Yes, he has had an experience indeed.	そうです、お月さまはなんでも知っているんです。
He glided over the waters of the Deluge, and smiled on Noah's ark just as he lately glanced down upon me,	ノアの洪水のときも世界を照らし、わたしに微笑みかけるようにノアの箱船にも微笑みかけました。
and brought comfort and promise of a new world that was to spring forth from the old.	そして旧世界からとびだした新世界に慰めと約束をもたらしたのです。
When the Children of Israel sat weeping by the waters of Babylon, he glanced mournfully upon the willows where hung the silent harps.	イスラエルの民がバビロン河のほとりで涙にくれていたとき、お月さまは柳の木々に鳴らない竪琴がかけられているのを悲しそうに見ていました。
When Romeo climbed the balcony, and the promise of true love fluttered like a cherub toward heaven, the round Moon hung, half hidden among the dark cypresses, in the lucid air.	ロミオがバルコニーにのぼり、天使が天国へいくように真実の愛がはばたくとき、まあるいお月さまは半分ヒノキに姿をかくしながら明るく照らし、見ていたのです。
He saw the captive giant at St. Helena, looking from the lonely rock across the wide ocean,	セントヘレナの有能で偉大な人物が、さびしげな岩の上から広い大海をみつめていたのも目にしていました。
while great thoughts swept through his soul.	そのときにも彼の魂の中には偉大なる考えがひしめいていたのですが。
Ah! what tales the Moon can tell.	あぁ、お月さまの語るお話のなんてすばらしいこと。
Human life is like a story to him.	人生とはお月さまにとってはお話です。
To-night I shall not see thee again,	今晩お月さまの姿はみえないでしょう。
old friend.	お月さま、
Tonight I can draw no picture of the memories of thy visit.	今晩、わたしはあなたが訪問してくれる思い出の絵はかけません。
And, as I looked dreamily towards the clouds, the sky became bright.	そして、夢みごこちで雲の方をみつめると、夜空があかるくなりました。
There was a glancing light, and a beam from the Moon fell upon me.	ひと筋の光がさし、月からの光がわたしを照らし出します。
It vanished again, and dark clouds flew past:	ただお月さまはすぐ姿をけし、黒い雲がとおりすぎました。
but still it was a greeting,	しかしそれでもちゃんとしたあいさつです。
a friendly good-night offered to me by the Moon.	お月さまからわたしへの友情のこもった「こんばんは」のあいさつです。
NINTH EVENING	第九夜
The air was clear again.	空気はふたたび澄みわたっていました。
Several evenings had passed, and the Moon was in the first quarter.	幾夜がすぎ、月は上弦になっていました。
Again he gave me an outline for a sketch.	ふたたびお月さまはわたしにスケッチの輪郭を語ってくれました。
Listen to what he told me.	お月さまの話をきいてください。
"I have followed the polar bird and the swimming whale to the eastern coast of Greenland.	「私は北極鳥と泳いでいる鯨を追って、グリーンランドの東端まできていました。
Gaunt ice-covered rocks and dark clouds hung over a valley,	荒涼とした氷に覆われた岩々と暗い雲が谷にたちこめています。
where dwarf willows and barberry bushes stood clothed in green.	そこには小さなやなぎとヒロハヘビノボラズが緑に装い、
The blooming lychnis exhaled sweet odours.	花をつけたセンソウが甘い香りを漂わせていました。
My light was faint, my face pale as the water lily that, torn from its stem, has been drifting for weeks with the tide.	私の光はぼんやりとしていて、茎からちぎれて何週間も流れにただよったすいれんのように私の顔は青白くなっていました。
The crown-shaped Northern Light burned fiercely in the sky.	王冠の形をしたオーロラが夜空にはげしく燃えています。
Its ring was broad, and from its circumference the rays shot like whirling shafts of fire across the whole sky,	オーロラの輪は大きく、そのまわりでは光線が夜空全体に何本もの火柱のように放たれていました。
flashing in changing radiance from green to red.	オーロラは、緑から赤へときらきら色を変えながらきらめていました。
The inhabitants of that icy region were assembling for dance and festivity;	氷におおわれた場所に住んでいる原住民たちはダンスとお祭りのために集まってきています。
but, accustomed to this glorious spectacle, they scarcely deigned to glance at it.	ただかれらはそういったすばらしい見ものには慣れっこで、わざわざ目をやったりはしません。
'Let us leave the soul of the dead to their ball-play with the heads of the walruses,'	「死人の魂は、セイウチの頭でボール遊びをさせておけばいい」
they thought in their superstition,	という迷信を信じていたのです。
and they turned their whole attention to the song and dance.	かれらのすべての関心は歌とダンスに向けられていました。
In the midst of the circle, and divested of his furry cloak, stood a Greenlander, with a small pipe,	輪の中心では、一人のグリーンランド人が毛皮の上着をぬぎすて、小さな縦笛をもち立っていました。
and he played and sang a song about catching the seal,	かれはアザラシ狩りの歌を演奏しました。
and the chorus around chimed in with, 'Eia, Eia, Ah.'	まわりのコーラスがそれに「エイ、エイ、ヤ」と合いの手をいれています。
And in their white furs they danced about in the circle, till you might fancy it was a polar bear's ball.	白い毛皮をきて輪になっておどっているさまは、まるで北極熊がダンスをしているかのようでした」
"And now a Court of Judgment was opened.	「そして裁判が行われました。
Those Greenlanders who had quarrelled stepped forward, and the offended person chanted forth the faults of his adversary in an extempore song, turning them sharply into ridicule, to the sound of the pipe and the measure of the dance.	争っていたグリーンランドの人たちが前に進み出て、被害を受けたものが前に出て相手の非を縦笛の音楽にあわせてダンスしながら即興で歌い、物笑いの種にするわけです。
The defendant replied with satire as keen, while the audience laughed, and gave their verdict.	相手もするどい皮肉でもってそれに答え、観衆はわらいながら評決を下します。
The rocks heaved, the glaciers melted, and great masses of ice and snow came crashing down, shivering to fragments as they fall;	岩々が動き、氷河がきしみ、大量の氷と雪がくずれおち、こなごなに砕けました。
it was a glorious Greenland summer night.	すばらしいグリーンランドの夏の夜でした。
A hundred paces away, under the open tent of hides, lay a sick man.	100歩ほど向こうに革のテントがあり、一人の病人が横たわっていました。
Life still flowed through his warm blood, but still he was to die	まだ温かい血には生命がかよっていましたが、この男は死ぬ運命なのでしょうか？
- he himself felt it, and all who stood round him knew it also;	男は自分でもそれを感じていましたし、男のまわりをとりかこんでいたものも全員それを知っていました。
therefore his wife was already sewing round him the shroud of furs,	だから男の妻はすでに体の周りに毛皮の覆いを縫いつけていました。
that she might not afterwards be obliged to touch the dead body.	死んだ後、死体にさわらなくてもすむようにです。
And she asked,	妻は尋ねました。
'Wilt thou be buried on the rock, in the firm snow?	「岩にうめてほしいの、それとも固い雪の中に？
I will deck the spot with thy kayak, and thy arrows,	その場所をあんたのカヤックと矢でかざりたてるよ。
and the angekokk shall dance over it.	祈祷師がその上でおどってくれるだろうよ。
Or wouldst thou rather be buried in the sea?'	それとも海に沈めたほうがいいかい？」
'In the sea,'	「海に沈めてくれ」
he whispered, and nodded with a mournful smile.	男はささやき、悲しげな笑みをうかべうなずきました。
'Yes, it is a pleasant summer tent, the sea,'	「あぁ、海は夏には心地いいテントだものね」
observed the wife.	妻も口にしました。
'Thousands of seals sport there, the walrus shall lie at thy feet, and the hunt will be safe and merry!'	「何千というアザラシがそこでたわむれてるし、セイウチも足元でよこたわり、安全ですてきな漁ができるだろうよ」
And the yelling children tore the outspread hide from the window-hole, that the dead man might be carried to the ocean,	泣き叫ぶ子供たちが、死体を海へと運んでいくために窓の穴から覆いをはずしました。
the billowy ocean, that had given him food in life, and that now, in death, was to afford him a place of rest.	大波がうねる海に、そこは生きているときは食べ物をもたらし、今死んでからは休息の地となるわけです。
For his monument, he had the floating, ever-changing icebergs, whereon the seal sleeps, while the storm bird flies round their gleaming summits!"	男の墓は浮かんでいて常に形を変える氷山で、その上でアザラシが眠り、コアシウミツバメがきらきら光るその天辺の上を飛んでいくのです」
TENTH EVENING	第十夜
"I knew an old maid,"	「私はひとりのおばあさんを知っていました」
said the Moon.	お月さまは話しだします。
"Every winter she wore a wrapper of yellow satin,	「彼女は冬になるといつも黄色のサテンを羽織っていました。
and it always remained new, and was the only fashion she followed.	それはいつも流行のもので、それが彼女が唯一流行についていってると思っているものでした。
In summer she always wore the same straw hat,	夏になると、同じむぎわらぼうしをかぶります。
and I verily believe the very same gray-blue dress.	そして私は、いつも同じ青灰色のドレスを着ていたと本当に信じています」
"She never went out, except across the street to an old female friend;	「おばあさんは、通りの向こう側の昔からの親友のところまで行く以外は外出しませんでした。
and in later years she did not even take this walk, for the old friend was dead.	ここ数年は、親友が死んでしまったので、それさえしません。
In her solitude my old maid was always busy at the window,	ひとりぼっちですが、おばあさんはいつも窓際で忙しそうにしていました。
which was adorned in summer with pretty flowers, and in winter with cress, grown upon felt.	窓際ではフェルトの上に、夏は小さな花々が飾り立てられ、冬はカラシナが育てられています。
During the last months I saw her no more at the window,	ここ数ヶ月は、おばあさんを窓際でみかけることもありませんでした。
but she was still alive.	ただ彼女は生きていますし、
I knew that,	私にはそれがわかっています。
for I had not yet seen her begin the 'long journey,'	なぜなら私はまだ彼女が『長い旅路』につくのを見ていないからです。
of which she often spoke with her friend.	『長い旅路』とは、おばあさんが親友とよく話していたことでした。
'Yes, yes,' she was in the habit of saying,	『そう、そう』おばあさんはよく言っていたものです。
'when I come to die I shall take a longer journey than I have made my whole life long.	『死ぬときには、一生の中で一番長い旅をするのよ。
Our family vault is six miles from here.	わが家の墓はここから六マイルもはなれていて、
I shall be carried there, and shall sleep there among my family and relatives.'	わたしはそこに運ばれ、家族や親戚といっしょに眠ることになるわけ』
Last night a van stopped at the house.	昨晩、一台の馬車がその家の前に停まりました。
A coffin was carried out,	ひつぎが運び出されてきます。
and then I knew that she was dead.	私にはおばあさんが亡くなったことがわかりました。
They placed straw round the coffin, and the van drove away.	ひつぎの周りにはわらがしきつめられ、馬車は走り出しました。
There slept the quiet old lady, who had not gone out of her house once for the last year.	そこには、ここ一年は一度も外にでたことがなかった物言わぬおばあさんが眠っていました。
The van rolled out through the town-gate as briskly as if it were going for a pleasant excursion.	馬車は楽しい遠足にでもいくみたいに軽やかに街の門をくぐりぬけました。
On the high-road the pace was quicker yet.	街道ではペースはさらに上がりました。
The coachman looked nervously round every now and then	御者はときどきあたりを不安そうにみていました。
- I fancy he half expected to see her sitting on the coffin, in her yellow satin wrapper.	私が思うに、黄色いサテンの上着をきたおばあさんがひつぎの上に座ってるのでも想像したんでしょう。
And because he was startled, he foolishly lashed his horses,	御者はびくびくしていたので、考えなしに馬たちをいそがせました。
while he held the reins so tightly that the poor beasts were in a foam:	手綱をあんまりつよく持っていたので、かわいそうな馬たちはあぶくをだしている始末です。
they were young and fiery.	馬たちはまだ若くて、元気いっぱいでした。
A hare jumped across the road and startled them, and they fairly ran away.	一匹の野うさぎが街道にでてきて、馬たちを驚かせ、そして馬たちは猛烈な勢いではしりだしました。
The old sober maiden, who had for years and years moved quietly round and round in a dull circle, was now, in death, rattled over stock and stone on the public highway.	落ち着いたおばあさんは、何年も何年もきまった場所をしずかに行き来していたのに、死んだ今になって街道の木や石でガタガタさわがしくしているわけです。
The coffin in its covering of straw tumbled out of the van, and was left on the high-road,	わらをかぶったひつぎが、馬車から転げ落ち、街道に置き去りになりました。
while horses, coachman, and carriage flew past in wild career.	にもかかわらず、馬たち、御者、馬車はものすごいスピードで走り去っていきました。
The lark rose up carolling from the field,	ひばりが野原からとびたち、さえずりの声をあげました。
twittering her morning lay over the coffin,	ひつぎのところに立ち寄って、朝をつげているみたいです。
and presently perched upon it, picking with her beak at the straw covering, as though she would tear it up.	ひつぎの上にとまり、覆い被さっているわらを取り除こうとでもするようにつついています。
The lark rose up again, singing gaily,	ひばりは再びとびたち、楽しげにさえずりました。
and I withdrew behind the red morning clouds."	そして私は朝焼けの真っ赤な雲の後ろに姿を隠しました」
ELEVENTH EVENING	第十一夜
"I will give you a picture of Pompeii,"	「さて、ポンペイの絵をお見せしましょう」
said the Moon.	お月さまは語りました。
"I was in the suburb in the Street of Tombs, as they call it,	「私は郊外の墓場通りとよばれているところにいました。
where the fair monuments stand, in the spot where, ages ago, the merry youths, their temples bound with rosy wreaths, danced with the fair sisters of Lais.	そこにはすばらしい記念碑がたっていて、ずいぶん昔には陽気な若者たちが頭にバラの冠をのせレイ姉妹とおどったところです。
Now, the stillness of death reigned around.	今は死の沈黙があたりをおおっています。
German mercenaries, in the Neapolitan service, kept guard, played cards, and diced;	ドイツ人の傭兵たちがナポリで軍役につき、カード遊びやサイコロをふりながらそこの警備をしていました。
and a troop of strangers from beyond the mountains came into the town, accompanied by a sentry.	一人の見張りにつきそわれて、観光客の一団が山々の向こうから町にやってきました。
They wanted to see the city that had risen from the grave illumined by my beams;	月の光にてらしだされて、墓からよみがえった町を見に来たのです。
and I showed them the wheel-ruts in the streets paved with broad lava slabs;	私は、溶岩にすっかりおおわれた道のわだちを照らし出し、
I showed them the names on the doors, and the signs that hung there yet:	ドアの表札やまだそこらにのこっている看板を照らし出しました。
they saw in the little courtyard the basins of the fountains, ornamented with shells;	観光客はせまい中庭で貝殻におおわれた噴水台を目にしましたが、
but no jet of water gushed upwards, no songs sounded forth from the richly-painted chambers, where the bronze dog kept the door.	水も噴出していなければ、ブロンズの犬が門のところで番をしている豪華にかざられた部屋から歌声が響いてくることもありませんでした」
"It was the City of the Dead;	「そこは死の都でした。
only Vesuvius thundered forth his everlasting hymn,	ただベスビオ山だけがいつまでも轟きを響かせていました。
each separate verse of which is called by men an eruption.	その一つ一つが人にとっては、噴火とよばれているものなのです。
We went to the temple of Venus, built of snow-white marble, with its high altar in front of the broad steps, and the weeping willows sprouting freshly forth among the pillars.	私たちは雪のように真っ白な大理石でできたビーナスの神殿に行き、その広い階段の前には高い祭壇があり、円柱のあいだで生き生きとしている柳が風にそよいでいました。
The air was transparent and blue, and black Vesuvius formed the background, with fire ever shooting forth from it, like the stem of the pine tree.	空気は澄みわたり青く、黒いベスビオ山が常に松の幹のような火柱を噴出しながら背景にそびえていました。
Above it stretched the smoky cloud in the silence of the night, like the crown of the pine,	その上には夜の帳の中に薄雲がひろがっていて、まるで松の樹冠のようでした。
but in a blood-red illumination.	ただ血のように真っ赤にうかびあがっていたのですが。
Among the company was a lady singer,	団体の中には一人の女性の歌い手がいました。
a real and great singer.	本物のすばらしい歌い手です。
I have witnessed the homage paid to her in the greatest cities of Europe.	私はヨーロッパの大都市で彼女が絶賛の嵐を受けたのも見ています。
When they came to the tragic theatre, they all sat down on the amphitheatre steps,	悲劇の劇場までやってきたとき、観光客は円形劇場の段のところに腰をおろしました。
and thus a small part of the house was occupied by an audience, as it had been many centuries ago.	劇場のほんの一角に、数世紀前とおなじように観客がもどってきたのです。
The stage still stood unchanged, with its walled side-scenes, and the two arches in the background,	舞台は昔のままで、両脇には壁があり、背景には２つのアーチがかかっていました。
through which the beholders saw the same scene that had been exhibited in the old times	観客はアーチのむこうに昔に舞台を飾ったのと同じ風景をみることができたのでしょうか？
- a scene painted by nature herself, namely, the mountains between Sorento and Amalfi.	それはまさしく自然のままの風景で、つまり、ソレントとアマルフィの町のあいだの山々がみてとれるわけです。
The singer gaily mounted the ancient stage, and sang.	歌い手はたわむれに古代の舞台に立ち、歌いました。
The place inspired her, and she reminded me of a wild Arab horse,	その場所が歌う気にさせ、その歌声は私にアラブの野生の馬を思わせました。
that rushes headlong on with snorting nostrils and flying mane	鼻息あらく、たてがみをなびかせ、一目散に駆ける馬を。
- her song was so light and yet so firm.	歌はかろやかであるとともに、聞きごたえがありました。
Anon I thought of the mourning mother beneath the cross at Golgotha, so deep was the expression of pain.	すぐに私はゴルゴタの十字架の下でなげきかなしむ母親のことを思いました。
And, just as it had done thousands of years ago, the sound of applause and delight now filled the theatre.	劇場は拍手喝采と歓喜の渦につつまれています。
'Happy, gifted creature!'	『すばらしい、たぐいまれな才能』
all the hearers exclaimed.	聞いていた人はみなそう誉めそやしました。
Five minutes more, and the stage was empty,	五分後、舞台には人っ子一人いません。
the company had vanished, and not a sound more was heard	一団は去っていき、物音一つ聞こえないでしょう？
- all were gone.	すべては終わったのです。
But the ruins stood unchanged,	ただ廃墟は姿をかえず残っています。
as they will stand when centuries shall have gone by,	何世紀たってもこのままでしょう。
and when none shall know of the momentary applause and of the triumph of the fair songstress;	すばらしい歌に対する一時の拍手喝采や歓喜の渦のことを知るものが一人もいなくなっても、廃墟はこのままです。
when all will be forgotten and gone,	全てが忘れさられ、去っていっても、廃墟はこのままでしょう。
and even for me this hour will be but a dream of the past."	そして私にとってもこの一時は、ほんの過去の夢にすぎないのです」
TWELFTH EVENING	第十二夜
"I looked through the windows of an editor's house,"	お月さまは話をします
said the Moon.	「私はある編集者の家の窓からのぞき込んでいました。
"It was somewhere in Germany.	ドイツのどこかで、
I saw handsome furniture, many books, and a chaos of newspapers.	家にはりっぱな家具、多くの本があり、新聞が散乱していました。
Several young men were present:	わかい男が何人かおり、
the editor himself stood at his desk,	編集者は机の側に立っていました。
and two little books, both by young authors, were to be noticed.	いずれも若い作家が書いたニ冊のささやかな本が批評されています。
'This one has been sent to me,'	『これは私に送ってきたものだ』
said he.	と編集者はコメントしました。
'I have not read it yet;	『まだ読んでいないが、
what think you of the contents?'	あなたがたはどう思う？』
'Oh,'	『えぇ』
said the person addressed	一人が答えました、
- he was a poet himself -	彼自身も詩人でしたが
'it is good enough;	『充分いいできだと思いますよ、
a little broad, certainly;	確かに少し自由奔放なところあるけど、
but, you see, the author is still young.	作者もまだ若いことだし。
The verses might be better, to be sure;	確かにもっと改良する余地はあるとおもいますが。
the thoughts are sound, though there is certainly a good deal of common-place among them.	考え方もしっかりしてます、まぁ、どちらかといえばありふれたものといっていいかもしれませんが。
But what will you have?	でもいったい何を期待するっていうんでしょう？
You can't be always getting something new.	いつも新しいものが手に入るわけじゃありません。
That he'll turn out anything great I don't believe,	もちろん私もこの作者が偉大な詩人になるとは思いません。
but you may safely praise him.	でもまぁ、誉めてやってもいいんじゃないですか。
He is well read, a remarkable Oriental scholar, and has a good judgment.	なんといっても読めるし、東洋学者としてはなかなかだし、分別もありますよ。
It was he who wrote that nice review of my 'Reflections on Domestic Life.'	私の『家庭生活に対する感想』にけっこういい批評をしてくれましたから。
We must be lenient towards the young man.'	この若者を寛大に扱ってやりましょうよ」
"'But he is a complete hack!'	「でもあれはまったくのやっつけ仕事ですよ」
objected another of the gentlemen.	他の男が意見をのべた。
'Nothing worse in poetry than mediocrity, and he certainly does not go beyond this.'	「月並みほど詩にとって最悪なことはありませんし、この作品はまったく月並みそのものといっていい」
"'Poor fellow,'	「かわいそうな若者だ」
observed a third,	また別の男が口をはさみました
'and his aunt is so happy about him.	「かれの叔母さんはかれのことを誇りに思ってるんだがね。
It was she, Mr. Editor, who got together so many subscribers for your last translation.'	そう編集長、叔母さんっていうのは、こないだのあなたの翻訳にあれほどたくさんの予約をかきあつめてくれた人ですよ」
"'Ah, the good woman!	「あぁ、あのすばらしい女性か。
Well, I have noticed the book briefly.	この本に手短な批評をしよう。
Undoubted talent - a welcome offering - a flower in the garden of poetry - prettily brought out - and so on.	疑いなき才能、歓迎すべき贈り物、詩の庭にさいた一輪の花、上品にまとまっている、など。
But this other book - I suppose the author expects me to purchase it?	ではもう一冊の本はどうだろう、作者はどうやら僕にも買わせる気らしい。
I hear it is praised.	誉め言葉は耳にするね。
He has genius, certainly:	作者は、間違いなく天才だがね。
don't you think so?'	さぁ、どう思う？」
"'Yes, all the world declares as much,'	「えぇ、全世界がそう宣言しているかのようですね」
replied the poet,	詩人は答えた。
'but it has turned out rather wildly.	「ただちょっと雑な感じもしますがね。
The punctuation of the book, in particular, is very eccentric.'	この本の句点のつけ方なんてとくに、とっぴょうしもないものですよ」
"'It will be good for him if we pull him to pieces, and anger him a little,	「この男はすこしこきおろして、ちょっとばかし怒らした方がいいんですよ。
otherwise he will get too good an opinion of himself.'	さもなきゃ、うぬぼれすぎますから」
"'But that would be unfair,'	「でもそれはあまりにフェアじゃないなぁ」
objected the fourth.	別の男が異議をとなえます。
'Let us not carp at little faults, but rejoice over the real and abundant good that we find here:	「ちいさな欠点をあれこれ言うのはやめて、目の前にあるまさに本物の豊潤な才能を楽しもうじゃありませんか。
he surpasses all the rest.'	かれは群をぬいてる」
"'Not so.	「そうでもないだろう。
If he is a true genius, he can bear the sharp voice of censure.	本物の天才なら、きびしい批判にもたえうるもんだよ。
There are people enough to praise him.	褒め称える人は大勢いるんだから、
Don't let us quite turn his head.'	思い上がらせないようにしないと」
"'Decided talent,'	「まぎれもない才能」
wrote the editor,	編集者は書きました。
'with the usual carelessness.	「ただときおりいい加減なところがあり、
that he can write incorrect verses may be seen in page 25, where there are two false quantities.	25ページには間違った詩がみうけられ、そこでは2箇所ほど韻が誤っている。
We recommend him to study the ancients, etc.'	もっと古典をまなぶことを薦めたい、など」
"I went away,"	「私はその場を去りました」
continued the Moon,	お月さまはつづけました。
"and looked through the windows in the aunt's house.	「そしてあの叔母の家の窓をのぞきこみました。
There sat the be-praised poet, the tame one;	そこには賞賛された詩人、平凡な方、が座っていました。
all the guests paid homage to him, and he was happy.	招かれた客は全員かれに尊敬の念をいだき、かれはとても幸福そうでした」
"I sought the other poet out, the wild one;	「私はもう一人の詩人、並外れた方、も探し出しました。
him also I found in a great assembly at his patron's,	かれもパトロンの家にいて、そこには大勢の人が集まっていました。
where the tame poet's book was being discussed.	そこでも平凡な詩人の本が論じられていました」
"'I shall read yours also,'	「『もちろんあなたの本も読みましょう』
said Maecenas;	パトロンは言いました。
'but to speak honestly -	『でも正直にいわせてもらえば、
you know I never hide my opinion from you	わたしが自分の意見を隠せるような男じゃないことはわかってるだろうし、
- I don't expect much from it,	この本にはたいして期待してないんだ。
for you are much too wild, too fantastic.	その理由は君があまりにとっぴょうしもなく、空想的だからだよ。
But it must be allowed that, as a man, you are highly respectable.'	でも人間としては君はものすごく尊敬に値する人物であることは認めざるをえないが』」
"A young girl sat in a corner;	「一人の少女がすみの方に腰掛け、
and she read in a book these words:	本の次の部分を読んでいました」
"'In the dust lies genius and glory,	「天才と栄光は塵にまみれど
But ev'ry-day talent will pay.	平凡な才能はみとめられる。
It's only the old, old story,	これは古き、古い話なれど
But the piece is repeated each day.'"	同じことは日々繰り返される」
THIRTEENTH EVENING	第十三夜
The Moon said,	お月さまは口を開きました
"Beside the woodland path there are two small farm-houses.	「森の小道の脇に二軒の農家がありました。
The doors are low, and some of the windows are placed quite high, and others close to the ground;	ドアは背が低いもので、窓のいくつかは高いところについていますが、他の窓は低いところについています。
and whitethorn and barberry bushes grow around them.	セイヨウサンザシとヒロハヘビノボラズが低い窓の周りに生い茂っていました。
The roof of each house is overgrown with moss and with yellow flowers and houseleek.	二軒の家の屋根にはコケがむしていて、黄色い花とバンダイソウが育っていました。
Cabbage and potatoes are the only plants cultivated in the gardens, but out of the hedge there grows a willow tree,	庭で栽培されているのはキャベツとじゃかいもだけですが、生垣の向こうには柳の木が一本ありました。
and under this willow tree sat a little girl, and she sat with her eyes fixed upon the old oak tree between the two huts.	柳の木の下には少女が一人座りこみ、その少女の目は二軒の家のあいだにある古い樫の木をみつめています」
"It was an old withered stem.	「樫の木の幹はすっかりやつれていて、
It had been sawn off at the top, and a stork had built his nest upon it;	上の方は切られ、コウノトリがそこに巣をつくっていました。
and he stood in this nest clapping with his beak.	コウノトリは巣にいて、くちばしをガタガタいわせています。
A little boy came and stood by the girl's side:	少年が一人やってきて、少女の脇に立ちました。
they were brother and sister.	二人は兄と妹でした」
"'What are you looking at?'	「何をみてるんだい？」
he asked.	兄がたずねます。
"'I'm watching the stork,'	「コウノトリを見てるの」
she replied:	妹はそう答えると
'our neighbors told me that he would bring us a little brother or sister to-day;	「となりの人はわたしに、今日コウノトリが小さな弟か妹を連れてきてくれるっていったの。
let us watch to see it come!'	見てましょうよ」と続けました。
"'The stork brings no such things,'	「コウノトリはそんなものは運んでこないぞ」
the boy declared,	兄は胸をはっていいます
'you may be sure of that.	「おまえは信じてるかもしれないけどね。
Our neighbor told me the same thing,	おとなりさんは僕にも同じことをいったんだ。
but she laughed when she said it,	でも笑いながらだったし。
and so I asked her if she could say 'On my honor,' and she could not;	それで僕が『神にかけて？』と聞いたら、答えられなかったんだ。
and I know by that the story about the storks is not true,	だから僕はコウノトリの話はホントじゃないってわかったよ。
and that they only tell it to us children for fun.'	子供を喜ばせるためにいってるんだ」
"'But where do babies come from, then?'	「じゃあいったい赤ちゃんはどこからくるの？」
asked the girl.	妹は聞きました。
"'Why, an angel from heaven brings them under his cloak,	「天国から天使が樫の木の下に連れて来るんだよ。
but no man can see him;	でもだれも天使を見ることはできないから、
and that's why we never know when he brings them.'	いつ連れてきてくれるのかは分からないんだ」
"At that moment there was a rustling in the branches of the willow tree,	「そのとき柳の木の枝がざわめきました。
and the children folded their hands and looked at one another:	子供たちはお互いの手をにぎりしめ、みつめあいました。
it was certainly the angel coming with the baby.	まちがいなく天使が子供をつれてきたのです。
They took each other's hand, and at that moment the door of one of the houses opened, and the neighbour appeared.	二人はたがいの手をとり、そのとき二軒の家のうちの一軒のドアが開き、おとなりさんが顔をだしました」
"'Come in, you two,' she said.	「二人ともおいで、
'See what the stork has brought.	コウノトリが運んできたものをみてごらん。
It is a little brother.'	弟よ」
"And the children nodded gravely at one another,	「子供たちは真剣な顔でお互いにうなずきました。
for they had felt quite sure already that the baby was come."	というのは、二人とも赤んぼうがきたのがはっきりわかっていたからです」
FOURTEENTH EVENING	第十四夜
"I was gliding over the Luneburg Heath,"	「私はリューネブルグの荒野の上を照らしていました」
the Moon said.	とお月さまは語りかけました。
"A lonely hut stood by the wayside, a few scanty bushes grew near it,	「道端には一軒きりの小屋が建っていて、そのまわりにはまばらな茂みが生えていました。
and a nightingale who had lost his way sang sweetly.	ナイチンゲールが一匹道に迷って、鳴き声をひびきわたらせていました。
it was his farewell song that I heard.	私が耳にしたのは、お別れの歌でした」
"The morning dawn came glimmering red.	「朝焼けがかすかに赤く空をそめ、
I saw a caravan of emigrant peasant families	私はハンブルグに向かう小作農の移民の一団を目にしました。
who were bound to Hamburgh, there to take ship for America, where fancied prosperity would bloom for them.	ハンブルグからアメリカにわたり、そこで一旗あげようというのでしょう。
The mothers carried their little children at their backs, the elder ones tottered by their sides, and a poor starved horse tugged at a cart that bore their scanty effects.	母親たちは赤んぼうを背負い、子供たちは母親の脇をよろよろと歩き、かわいそうな飢えた馬が家族のわずかな財産を乗せた馬車を引いていました。
The cold wind whistled, and therefore the little girl nestled closer to the mother,	冷たい風がふきすさび、少女は母親にぴったり寄り添いました。
who, looking up at my decreasing disc, thought of the bitter want at home, and spoke of the heavy taxes they had not been able to raise.	母親は私の欠けていく様子をみながら、故郷での困窮を思い、支払えなかったほどの重税について口にしました。
The whole caravan thought of the same thing;	一団の全員が同じことを考えていました。
therefore, the rising dawn seemed to them a message from the sun,	だから夜が明け行く様子は、みんなにとってのメッセージのように思えたことでしょう。
of fortune that was to gleam brightly upon them.	みんなの頭上にかがやくだろう幸運のメッセージが。
They heard the dying nightingale sing;	みんなは死にゆくナイチンゲールの鳴き声を耳にしました。
it was no false prophet, but a harbinger of fortune.	それは偽の予言というわけではなく、幸運の前触れでした。
The wind whistled, therefore they did not understand that the nightingale sung,	風が吹きすさび、ナイチンゲールの歌っている内容はみんなには分からなかったのです。
'Fare away over the sea!	『海を越えていく。
Thou hast paid the long passage with all that was thine,	おまえはすべてのものを抱え、長い旅路をやってきた。
and poor and helpless shalt thou enter Canaan.	そうして貧しく無力なものがカナンの地に至るのだ。
Thou must sell thyself, thy wife, and thy children.	おまえは自分自身も妻も子供も売らなければならない。
But your griefs shall not last long.	でもおまえの苦悩は長くはない。
Behind the broad fragrant leaves lurks the goddess of Death,	十分に楽しい別離のかげには、死の女神がかくれている。
and her welcome kiss shall breathe fever into thy blood.	女神のお迎えの口づけは、あなたの血を沸き立たせる。
Fare away, fare away, over the heaving billows.'	旅立て、旅立つんだ、荒れ果てた海を越えて』
And the caravan listened well pleased to the song of the nightingale, which seemed to promise good fortune.	そしてよく耳をすませた一行は、幸運を約束してくれるようなナイチンゲールの鳴き声を楽しみました。
Day broke through the light clouds;	明るい雲を通して夜明けの光が射し込んできます。
country people went across the heath to church;	地元の人たちが荒野をよこぎって教会へといそいでいます。
the black-gowned women with their white head-dresses looked like ghosts that had stepped forth from the church pictures.	白い髪飾りをつけ、黒いガウンを羽織った女性は、教会の絵からぬけだしてきた幽霊のように見えました。
All around lay a wide dead plain, covered with faded brown heath, and black charred spaces between the white sand hills.	辺りはみわたすかぎりまっ平らで、枯れた茶色の荒野でおおわれ、白い砂の丘にはところどころ黒焦げのような黒い場所がありました。
The women carried hymn books, and walked into the church.	さきほどの女性は賛美歌の本をもち、教会に入っていきました。
Oh, pray, pray for those who are wandering to find graves beyond the foaming billows."	あぁ、祈りましょう、荒れた海をこえて死に場所をさがしさまようものたちのために祈りましょう」
FIFTEENTH EVENING	第十五夜
"I know a Pulcinella,"	「私はある道化役（訳注１　Pulcinella）を知っていました」
the Moon told me.	お月さまは、わたしにそう話しかけてきました。
"The public applaud vociferously directly they see him.	「観客はかれをみると大騒ぎで拍手喝さいでした。
Every one of his movements is comic, and is sure to throw the house into convulsions of laughter;	一挙手一投足がコミカルで、芝居小屋を笑いの渦へとひきこむのです。
and yet there is no art in it all	ただ実はそれは演じているものでなく、
- it is complete nature.	生来のものだったのですが。
When he was yet a little boy, playing about with other boys, he was already Punch.	道化役が少年のころ他の子供たちと遊んでいたときから、すでに彼は笑いもの（Punch）でした。
Nature had intended him for it, and had provided him with a hump on his back, and another on his breast;	生まれたときから自然とそうなっていて、背中と胸にそれぞれこぶがあったのです。
but his inward man, his mind, on the contrary, was richly furnished.	ただ道化役の内面、つまり心は、その正反対で豊かでした。
No one could surpass him in depth of feeling or in readiness of intellect.	情感が豊かなことと当意即妙な知性では彼にかなうものはいませんでした。
The theatre was his ideal world.	劇場は道化役にとっては理想的な世界で、
If he had possessed a slender well-shaped figure, he might have been the first tragedian on any stage;	もし彼が均整のとれた見目のいい姿をしていたら、どんな舞台でも比べものにならないぐらいの悲劇俳優となっていたかもしれません。
the heroic, the great, filled his soul;	勇敢で、偉大なところが道化役の魂には満ちあふれていました。
and yet he had to become a Pulcinella.	だから彼は道化役にならざるをえませんでした。
His very sorrow and melancholy did but increase the comic dryness of his sharply-cut features, and increased the laughter of the audience,	とても悲しそうで深い物思いにふけるところが、するどい容貌のコミカルなところを強調し、観客をますます笑わせるのです。
who showered plaudits on their favourite.	観客は道化役が大のお気に入りでした。
The lovely Columbine was indeed kind and cordial to him;	男役（Harlequin）の相手のかわいらしい女役（Columbine）はとくに道化にやさしく、心から道化を好きでした。
but she preferred to marry the Harlequin.	ただ彼女は男役と結婚することを選んでいました。
It would have been too ridiculous if beauty and ugliness had in reality paired together.	もしこの美女と野獣がじっさいにいっしょになったとしたら、どれほど物笑いの種になったことでしょう」
"When Pulcinella was in very bad spirits, she was the only one who could force a hearty burst of laughter, or even a smile from him:	「道化役が非常に気分が悪いときには、女役だけが唯一道化役のことを心から笑わせるか、少なくとも微笑ませることができました。
first she would be melancholy with him, then quieter, and at last quite cheerful and happy.	最初は女役も気分が落ち込みますが、だんだん落ち着き、最後には気分も晴れやかになり幸せになるのです。
'I know very well what is the matter with you,'	『あなたがどうなのか、私にはよくわかるわ』
she said;	彼女は言いました。
'yes,	『そう、そうよ。
you're in love!'	あなたは恋してるのよ』
And he ncould not help laughing.	そうすると道化役は笑わざるをえません。
'I and Love,'	『僕が恋だって』
he cried,	道化役はさけびます。
'that would have an absurd look.	『そうだとしたらこっけいな見ものだよ。
How the public would shout!'	観客たちはどれほどわめきたてることか！』
'Certainly, you are in love,'	『確かにあなたは恋におちているわ』
she continued;	彼女は続け、
and added with a comic pathos,	コミカルな調子でこう付け加えました
'and I am the person you are in love with.'	『そしてあなたの恋する相手は私なのね』
You see,	おわかりでしょう。
such a thing may be said when it is quite out of the question	こんなことは思ってもみないからこそ口にできるのです。
- and, indeed, Pulcinella burst out laughing, and gave a leap into the air, and his melancholy was forgotten.	そしてじっさい道化役は大笑いして宙にとびはね、憂鬱もふきとんでしまうというわけです」
"And yet she had only spoken the truth.	「ただ彼女の口にしたことは本当のことでした。
He did love her, love her adoringly,	道化役は彼女を愛していたのです。
as he loved what was great and lofty in art.	すばらしい高貴な芸術を愛するように崇拝していたといってもいいくらいです。
At her wedding he was the merriest among the guests,	女役の結婚式では道化役はまねかれた客のあいだで一番ほがらかでした。
but in the stillness of night he wept:	しかし一人ぼっちの夜になると道化役は泣きました。
if the public had seen his distorted face then, they would have applauded rapturously.	もし観客が道化役の涙にゆがんだ顔を見たなら、それみたことかと大騒ぎしたことでしょう」
"And a few days ago, Columbine died.	「それから数日後、女役は死にました。
On the day of the funeral, Harlequin was not required to show himself on the boards,	お葬式の日は男役も舞台には立たなくてよいといわれました。
for he was a disconsolate widower.	というのも悲嘆にくれた男やもめですから。
The director had to give a very merry piece, that the public might not too painfully miss the pretty Columbine and the agile Harlequin.	観客がかわいらしい女役と生き生きとした男役がいないのをひどくさみしく思わないように、演出家は一段と楽しい舞台をつくらなければなりません。
Therefore Pulcinella had to be more boisterous and extravagant than ever;	それは道化役がいつもよりもっとばか騒ぎして、やりすぎなほどやらなくてはいけないということです。
and he danced and capered, with despair in his heart;	道化役は心に悲しみをひめたまま、踊りはね回りました。
and the audience yelled, and shouted	そして観客は大声でわめきました
'bravo, bravissimo!'	『ブラボー、いいぞ！』
Pulcinella was actually called before the curtain.	道化役はじっさい幕前に呼び出され、
He was pronounced inimitable.	誰とも比べられないくらいすごいと評されました」
"But last night the hideous little fellow went out of the town, quite alone, to the deserted churchyard.	「ただ昨晩そのいまわしき小男は一人きりで町をでて、寂しい墓地へと向かいました。
The wreath of flowers on Columbine's grave was already faded, and he sat down there.	女役の墓の花輪もすでにかれ、道化役はそこに腰をおろしました。
It was a study for a painter.	そのようすは絵描きにはいい題材になったことでしょう。
As he sat with his chin on his hands, his eyes turned up towards me, he looked like a grotesque monument	あごを両手でささえ、目は私の方をみていましたが、道化役はグロテスクな銅像のようにみえました。
- a Punch on a grave - peculiar and whimsical!	墓場の笑いもの、奇妙で奇抜ですらある！
If the people could have seen their favourite, they would have cried as usual,	もし観客がこのお気に入りの道化をみたなら、いつものように叫んだことでしょう
'Bravo, Pulcinella;	「ブラボー、道化役。
bravo, bravissimo!' "	ブラボー、いいぞ！」
SIXTEENTH EVENING	第十六夜
Hear what the Moon told me.	これもお月さまがわたしに語ったお話です。
"I have seen the cadet who had just been made an officer put on his handsome uniform for the first time;	「私は士官になりたての若者が、はじめてきりっとした制服を着用したところをみたことがあります。
I have seen the young bride in her wedding dress, and the princess girl-wife happy in her gorgeous robes;	ウェディングドレスに身をつつんだ若い花嫁をみたこともありますし、王女のようなその女性は豪華絢爛な服をきてとても幸せそうでした。
but never have I seen a felicity equal to that of a little girl of four years old, whom I watched this evening.	ただ私は今晩に目にした四才の少女ほどの幸せは見たことがありません。
She had received a new blue dress, and a new pink hat, the splendid attire had just been put on, and all were calling for a candle,	少女は青い新しいドレスとピンクの新しい帽子を買ってもらって、ちょうどそれを身につけた姿はすばらしく、だれもがろうそくを取りに走りました。
for my rays, shining in through the windows of the room, were not bright enough for the occasion,	というのも私のひかりが部屋の窓から照らすだけでは十分明るいとはいえなかったからです。
and further illumination was required.	もっと灯りが必要だったわけです。
There stood the little maid, stiff and upright as a doll, her arms stretched painfully straight out away from the dress, and her fingers apart;	少女は人形のようにまっすぐ立ち、両腕はドレスから苦しそうなほどまっすぐ出て、指はせいいっぱい開かれていました。
and oh, what happiness beamed from her eyes, and from her whole countenance!	そしてなんてことでしょう、彼女の目から、全身から、幸福があふれだしていたのです！
'To-morrow you shall go out in your new clothes,'	『明日おまえはこの新しい服でおでかけするんだよ』
said her mother;	お母さんがいうと、
and the little one looked up at her hat, and down at her frock, and smiled brightly.	少女は帽子を見上げ、服を見下ろすとはれやかな笑顔をみせました。
'Mother,'	『おかあさん』
she cried,	少女はこうふんして言いました
'what will the little dogs think, when they see me in these splendid new things?'"	『こんなすてきな新しい服をきたわたしを見て、子犬はどうおもうかしら？』」
SEVENTEENTH EVENING	第十七夜
"I have spoken to you of Pompeii,"	「ポンペイのお話をしたことがありましたね」
said the Moon;	お月さまはそう言います。
"that corpse of a city, exposed in the view of living towns:	「あれは、たくさんの人が生活しているさまざまな都市の風景の中にさらされた都市の死骸でした。
I know another sight still more strange,	でも私はもっと奇妙な風景を見たことがあります。
and this is not the corpse, but the spectre of a city.	それは死骸ではありませんが、都市の幽霊です。
Whenever the jetty fountains splash into the marble basins, they seem to me to be telling the story of the floating city.	噴きだした噴水が大理石の噴水台にふりそそぐときはいつも、私は宙に漂う都市の話をしてもらっているように思えたものです。
Yes, the spouting water may tell of her, the waves of the sea may sing of her fame!	そう、噴き出す水がその都市の話をしていて、打ち寄せる波はその都市の名声を歌っているのでしょう。
On the surface of the ocean a mist often rests, and that is her widow's veil.	海の表面にはよく霧がでますが、それこそが都市の未亡人のベールなのです。
The bridegroom of the sea is dead, his palace and his city are his mausoleum!	海の花婿は死んでいて、花婿の宮殿と都市は霊廟となっています。
Dost thou know this city?	あなたはこの都市を知っていますか？
She has never heard the rolling of wheels or the hoof-tread of horses in her streets,	その都市の通りでは馬車の車輪や馬のひずめの音を耳にすることは決してありません。
through which the fish swim, while the black gondola glides spectrally over the green water.	その都市の通りには魚が泳いでいて、黒いゴンドラが幽霊のように緑色の水面をすべっていきます。
I will show you the place,"	あなたに宮殿をお見せしましょう」
continued the Moon,	お月さまは続けました。
"the largest square in it, and you will fancy yourself transported into the city of a fairy tale.	「都市の中でもっとも広い場所で、まるでおとぎの町にきたように思うことでしょう。
The grass grows rank among the broad flagstones,	敷石がしきつめられた広い道には草がはびこっています。
and in the morning twilight thousands of tame pigeons flutter around the solitary lofty tower.	朝の薄明かりの中では、人に慣れている何千羽の鳩が一つぽつんと建っている塔の周りを羽ばたいています。
On three sides you find yourself surrounded by cloistered walks.	あなたのいるところは、三方が歩道でとりかこまれて、
In these the silent Turk sits smoking his long pipe,	歩道では物静かなトルコ人が長いパイプをふかしていました。
the handsome Greek leans against the pillar and gazes at the upraised trophies and lofty masts, memorials of power that is gone.	整った顔のギリシャ人が柱にもたれかかり、過ぎ去った権力の記念のかかげられたトロフィーと高いマストをみつめています。
The flags hang down like mourning scarves.	旗は喪にふくしているスカーフのようにたれさがっていました。
A girl rests there:	そこでは少女が一人休んでいました。
she has put down her heavy pails filled with water, the yoke with which she has carried them rests on one of her shoulders, and she leans against the mast of victory.	水でいっぱいになった重いバケツを運んでいましたが、休んでいるときもてんびん棒は肩に乗せたままで、少女は勝利のマストにもたれかかっていました。
That is not a fairy palace you see before you yonder, but a church:	さらに向こうのあなたの前方にあるのは、おとぎ話の宮殿ではなく教会です。
the gilded domes and shining orbs flash back my beams;	金ぱくの丸い屋根ときらめく球が私の光でかがやきました。
the glorious bronze horses up yonder have made journeys, like the bronze horse in the fairy tale:	その上の方にある栄誉ある青銅の馬は、まるでおとぎ話の青銅の馬のようにいろいろなところを旅してきました。
they have come hither, and gone hence, and have returned again.	あちらこちらを行き来し、ふたたびここへと戻ってきたのです。
Do you notice the variegated splendour of the walls and windows?	壁や窓の色とりどりの壮麗さにお気づきになりましたか？
It looks as if Genius had followed the caprices of a child, in the adornment of these singular temples.	このすばらしい寺院の装飾はまるで天才がきまぐれな子供の言うがままにしたみたいです。
Do you see the winged lion on the pillar?	柱の上の翼のついたライオンが目に入るでしょうか？
The gold glitters still, but his wings are tied	まだ金色にかがやいていますが、その翼はくくられています。
- the lion is dead, for the king of the sea is dead;	ライオンは死んでいます、そう海の王が死んでいるのですから。
the great halls stand desolate, and where gorgeous paintings hung of yore, the naked wall now peers through.	大きなホールには人気がなく、昔ははなやかな絵画がかざられていましたが、今はなにもかかっていない壁がじかにみえます。
The lazzarone sleeps under the arcade,	乞食がアーケードの下でねています。
whose pavement in old times was to be trodden only by the feet of high nobility.	昔にはこの道は、高貴な身分のものしか足を踏み入れることはできなかったものですが。
From the deep wells, and perhaps from the prisons by the Bridge of Sighs, rise the accents of woe,	深い井戸から、そしてたぶん『ため息の橋』のそばの牢獄から、哀しみの声が聞こえてきます。
as at the time when the tambourine was heard in the gay gondolas, and the golden ring was cast from the Bucentaur to Adria, the queen of the seas.	にぎやかなゴンドラでタンバリンの音が聞こえ、金の指輪がベニスの総督が乗っている船から海の女王アドリアへと投げ込まれたときのことです。
Adria! shroud thyself in mists;	アドリアよ、その身を霧でつつみたまえ。
let the veil of thy widowhood shroud thy form, and clothe in the weeds of woe the mausoleum of thy bridegroom	未亡人のベールでもってその体をつつみたまえ、そして哀しみの喪服で花婿の霊廟をつつみなさい。
- the marble, spectral Venice."	そう、大理石でできた幽霊の都市ベニスを」
EIGHTEENTH EVENING	第十八夜
"I looked down upon a great theatre,"	「私は大劇場を見下ろしていました」
said the Moon.	お月さまは話しました。
"The house was crowded, for a new actor was to make his first appearance that night.	「劇場は大混雑で、というのも新人俳優が今晩初舞台をふむからでした。
My rays glided over a little window in the wall, and I saw a painted face with the forehead pressed against the panes.	私の光が壁の小さな窓から射し込み、その窓に白粉をぬった額がおしつけられているのが目にとまりました。
It was the hero of the evening.	それが今晩の注目の俳優でした。
The knighly beard curled crisply about the chin;	騎士らしいあごひげが縮れてカールされていましたが、
but there were tears in the man's eyes,	目には涙がいっぱいです。
for he had been hissed off,	というのも、ブーイングをうけて舞台をおりてきたからです。
and indeed with reason.	まぁ、それももっともなのですが。
The poor Incapable!	才能のないかわいそうな男。
But Incapables cannot be admitted into the empire of Art.	ただ才能のない男は、芸術の世界では認められません。
He had deep feeling, and loved his art enthusiastically, but the art loved not him.	その男は深い感受性をもち、芸術を心のそこから愛していましたが、芸術はかれには微笑んでくれなかったのです。
The prompter's bell sounded;	舞台のベルがなりひびき、
'the hero enters with a determined air,' so ran the stage direction in his part,	『主役がさっそうと登場』とト書きにはかかれていました。
and he had to appear before an audience who turned him into ridicule.	男はあざけりを受けた観衆の前へと登場しなければなりません。
When the piece was over, I saw a form wrapped in a mantle, creeping down the steps:	舞台が終わると、私はマントに身をつつみ、階段をとぼとぼと降りる男の姿を目にしました。
it was the vanquished knight of the evening.	それが今晩、敗北した騎士の姿でした。
The scene-shifters whispered to one another,	大道具たちはお互いにこそこそ噂話をしています。
and I followed the poor fellow home to his room.	私はかわいそうな男の家まで跡をつけていきました。
To hang one's self is to die a mean death, and poison is not always at hand, I know;	首をつるのはみすぼらしい死に方だ、ただ毒薬は手に入らない。
but he thought of both.	私はその二つのことが男の頭にうずまいていたのを知っています。
I saw how he looked at his pale face in the glass, with eyes half closed, to see if he should look well as a corpse.	窓に男の青白い顔が映され、両目は半ば閉じられていましたが、死んだときの見た目を気にしているのを私は目にしました。
A man may be very unhappy, and yet exceedingly affected.	人は不幸のどん底にあっても、感情的なものです。
He thought of death, of suicide;	男は死を、自殺のことを考えていました。
I believe he pitied himself, for he wept bitterly,	私には男がひどく涙を流していたので、自己憐憫に陥っているのがわかりました。
and when a man has had his cry out he doesn't kill himself.	人が涙をだして泣くときには、自殺はしないものです」
"Since that time a year had rolled by.	「それから一年がすぎ、
Again a play was to be acted,	ふたたび演劇が上演されていました。
but in a little theatre, and by a poor strolling company.	ただ今回は小劇場で、旅回りの一座です。
Again I saw the well-remembered face, with the painted cheeks and the crisp beard.	ふたたび私は、ほお紅をさしちぢれたあごひげのよく見知った顔を目にしました。
He looked up at me and smiled;	男は私をみあげ、微笑みました。
and yet he had been hissed off only a minute before	その一分前には観客にブーイングをうけて舞台を降りてきたのにです。
- hissed off from a wretched theatre, by a miserable audience.	それも、うらぶれた劇場で、ひどいお客からブーイングを受けたのに。
And tonight a shabby hearse rolled out of the town-gate.	今晩、古い霊柩車が一台、町の門から外へとでていきました。
It was a suicide	自殺者です、
- our painted, despised hero.	そうあの白粉をつけた主役の男でした。
The driver of the hearse was the only person present, for no one followed except my beams.	いるのは霊柩車の運転手だけで、私の光を除いてはだれも付き添うものはありませんでした。
In a corner of the churchyard the corpse of the suicide was shovelled into the earth,	教会の墓地の片隅に自殺者の死骸はうめられました。
and nettles will soon be growing rankly over his grave, and the sexton will throw thorns and weeds from the other graves upon it."	すぐにイラクサが墓をみえなくするほど覆いかぶさり、墓地の掃除をする男が、他の墓に茂っている下草や雑草をその墓のところに捨てることでしょう」
NINETEENTH EVENING	第十九夜
"I come from Rome,"	「私はローマから来ました」.
said the Moon.	お月さまは語りをはじめました。
"In the midst of the city, upon one of the seven hills, lie the ruins of the imperial palace.	「街の中央の七つの丘の一つに、宮殿の廃墟がありました。
The wild fig tree grows in the clefts of the wall, and covers the nakedness thereof with its broad grey-green leaves;	壁の裂け目からはいちじくの木が野生しており、その大きな灰色がかった緑の葉がむきだしの壁をおおっていました。
trampling among heaps of rubbish, the ass treads upon green laurels, and rejoices over the rank thistles.	がれきをかき分け歩いていくと、ロバが緑の月桂樹をふみしめ、はびこっているアザミに大喜びしていました。
From this spot, whence the eagles of Rome once flew abroad, whence they 'came, saw, and conquered,' our door leads into a little mean house, built of clay between two pillars;	この場所からかつてはローマのワシが飛び立ち、『来た、見た、勝った』と伝えたものですが、いま私たちの行くところには質素で小さな家、二つの柱にはさまれた粘土でできた家があるだけです。
the wild vine hangs like a mourning garland over the crooked window.	その家のかしいだ窓には、お葬式の花輪のようにつたが生い茂っていました。
An old woman and her little granddaughter live there:	そこには老婦人と孫娘が住み、
they rule now in the palace of the Caesars, and show to strangers the remains of its past glories.	今ではシーザーの宮殿を治め、見物人に過去の栄光の遺跡をみせているわけです。
Of the splendid throne-hall only a naked wall yet stands,	華麗な王座の間は、今はそっけない壁が立っているだけです。
and a black cypress throws its dark shadow on the spot where the throne once stood.	一本の黒いイトスギがかつては王座があったところにその影をなげかけています。
The dust lies several feet deep on the broken pavement;	砂ぼこりが何フィートも壊れた歩道の上につもり、
and the little maiden, now the daughter of the imperial palace, often sits there on her stool when the evening bells ring.	宮殿の娘である少女が夕べの鐘がなりひびくとき、よくそこに腰かけています。
The keyhole of the door close by she calls her turret window;	近くにあるドアの鍵穴を少女は塔の窓とよんでいます。
through this she can see half Rome, as far as the mighty cupola of St. Peter's.	そこからはローマ半景が一望でき、聖ペテロ教会のすばらしい丸屋根もみることができます」
"On this evening, as usual, stillness reigned around;	「今晩もいつものように、静寂があたりを支配していました。
and in the full beam of my light came the little granddaughter.	私の光を全身にうけ、少女があらわれました。
On her head she carried an earthen pitcher of antique shape filled with water.	頭の上には、水がたっぷり入った古い型の陶器の入れ物を運んでいます。
Her feet were bare, her short frock and her white sleeves were torn.	はだしで、上着のすそもみじかく袖もほつれていました。
I kissed her pretty round shoulders, her dark eyes, and black shining hair.	少女の小さな丸い肩、黒い瞳、黒くつやのある髪に私は口づけしました。
She mounted the stairs; they were steep, having been made up of rough blocks of broken marble and the capital of a fallen pillar.	少女は、くずれた大理石のかけらや倒れた柱の頭でできた急な階段をのぼっていきました。
The coloured lizards slipped away, startled, from before her feet, but she was not frightened at them.	きれいな色のトカゲがびっくりして、少女の足元を走っていきましたが、少女はまったく驚きません。
Already she lifted her hand to pull the door-bell	すでに片手をあげて、ドアの呼び鈴を押すところでした。
- a hare's foot fastened to a string formed the bell-handle of the imperial palace.	宮殿の呼び鈴のひもにはうさぎの足がむすびつけられています。
She paused for a moment - of what might she be thinking?	少女はたちどまりました、何を思っていたのでしょうか？
Perhaps of the beautiful Christ-child, dressed in gold and silver, which was down below in the chapel,	たぶん教会のすぐ下にある美しい神の子供たちが、金銀に着飾っているのを思っていたのでしょう。
where the silver candlesticks gleamed so bright, and where her little friends sung the hymns in which she also could join?	教会の銀の燭台が明るくかがやき、そこでは少女の友達が少女も歌える賛美歌を歌っていました。
I know not.	私には少女が何を思っていたのかはわかりません。
Presently she moved again	さて、少女はふたたび歩き出し、
- she stumbled:	つまづきました。
the earthen vessel fell from her head, and broke on the marble steps.	陶器の容器が頭からすべりおち、大理石の階段でわれました。
She burst into tears.	少女は泣き出しました。
The beautiful daughter of the imperial palace wept over the worthless broken pitcher;	その美しい宮殿の少女は、とるにたらない壊れた容器のことで涙をながしています。
with her bare feet she stood there weeping;	足ははだしで、泣きながらたちすくんで、
and dared not pull the string,	呼び鈴のひもをひくこともしませんでした。
the bell-rope of the imperial palace!"	宮殿の呼び鈴のひもを」
TWENTIETH EVENING	第二十夜
It was more than a fortnight since the Moon had shone.	お月さまが最後に姿をみせてから二週間以上もたちましたが、
Now he stood once more,	いまお月さまはふたたび姿をあらわしています。
round and bright, above the clouds, moving slowly onward.	まんまるで光り輝き、雲の上をゆっくりと動いています。
Hear what the Moon told me.	お月さまがわたしに語りかけることに耳を傾けましょう。
"From a town in Fezzan I followed a caravan.	「フェザンの街から私は隊商のあとをついていきました。
On the margin of the sandy desert, in a salt plain, that shone like a frozen lake, and was only covered in spots with light drifting sand, a halt was made.	砂漠に入るところの塩の平原で、そこはまるで凍りついた湖のように輝いていて、わずかばかりの流砂が表面をおおっていましたが、隊列は一旦停止しました。
The eldest of the company - the water gourd hung at his girdle, and on his head was a little bag of unleavened bread - drew a square in the sand with his staff, and wrote in it a few words out of the Koran,	ベルトに水筒をぶらさげ、発酵させていないパンをいれた小さな袋を頭にのせた一団のリーダーが、棒で砂の上に四角をかき、コーランからの数言をその中にかきいれました。
and then the whole caravan passed over the consecrated spot.	それから隊商の一行が、その清められた場所をとおりすぎていったのです。
A young merchant, a child of the East, as I could tell by his eye and his figure, rode pensively forward on his white snorting steed.	目と姿かたちで東部の出身だとわかる一人の若い商人が、鼻をならしている白い馬にのって、物思いにふけりながら歩を進めていました。
Was he thinking, perchance, of his fair young wife?	たぶん若くて色白の妻のことでも考えているのでしょう。
It was only two days ago that the camel, adorned with furs and with costly shawls, had carried her, the beauteous bride, round the walls of the city, while drums and cymbals had sounded, the women sang, and festive shots, of which the bridegroom fired the greatest number, resounded round the camel;	なにせ二日前のことですから、そう毛皮と豪奢なショールをまとったらくだが、美しい花嫁を運んで街の城壁のまわりをめぐり、そのあいだ太鼓やシンバルがなりひびき、女性たちは歌い、祝砲がなりひびき、花婿がなんといっても一番多くらくだの周りで祝砲をあげたのは。
and now he was journeying with the caravan across the desert.	そして今、花婿は隊商といっしょに砂漠を旅しています」
"For many nights I followed the train.	「私は幾晩も隊列のあとをついていきました。
I saw them rest by the wellside among the stunted palms;	隊列は発育がとまった椰子の木々にかこまれた水源で一休みしていました。
they thrust the knife into the breast of the camel that had fallen, and roasted its flesh by the fire.	一行は倒れたらくだの胸にナイフをつきさし、肉を火であぶりました。
My beams cooled the glowing sands, and showed them the black rocks, dead islands in the immense ocean of sand.	私の光はもえたつような砂を冷やし、広大な砂漠の海の孤島である黒い岩々をてらしだしました。
No hostile tribes met them in their pathless route, no storms arose, no columns of sand whirled destruction over the journeying caravan.	一行は道なき道をゆくときでも敵の部族に遭うこともありませんでしたし、砂嵐にも遭わなければ、隊商を死に至らしめる砂の竜巻にも出くわしませんでした。
At home the beautiful wife prayed for her husband and her father.	故郷では、美しい妻が夫と父親のために祈りをささげています
'Are they dead?'	『死んでしまったのかしら？』
she asked of my golden crescent;	妻は三日月の私にたずねました。
'Are they dead?'	『死んでしまったのかしら？』
she cried to my full disc.	満月の私にそうなげきました。
Now the desert lies behind them.	一行は砂漠をとおりすぎ、
This evening they sit beneath the lofty palm trees,	今晩は背の高い椰子の木々の下で休んでいます。
where the crane flutters round them with its long wings, and the pelican watches them from the branches of the mimosa.	つるが長い羽をはばたかせ、その周りを飛んでいますし、ペリカンがミモザの木の枝にとまり隊商をみています。
The luxuriant herbage is trampled down, crushed by the feet of elephants.	うっそうとしげった草木が象の足でふみつぶされ、倒れています。
A troop of negroes are returning from a market in the interior of the land:	黒人の一団が内陸にある市場からもどってきました。
the women, with copper buttons in their black hair, and decked out in clothes dyed with indigo, drive the heavily-laden oxen,	女性たちはその黒い髪に銅のボタンをつけ、青藍にそめた服でかざりたて、荷物をたくさん積んだ雄牛たちを追っています。
on whose backs slumber the naked black children.	そして雄牛たちの背では、はだかの黒い子供たちがまどろんでいます。
A negro leads a young lion which he has brought, by a string.	一人の黒人が自分で買った子供のライオンをつれています。
They approach the caravan;	一団は隊商に近づいていきます。
the young merchant sits pensive and motionless, thinking of his beautiful wife, dreaming, in the land of the blacks, of his white lily beyond the desert.	若い商人は物思いにふけり微動だにせず、黒人の地で美しい妻のことを考え、砂漠の白いユリを夢みて腰をおろしていました。
He raises his head, and - "	商人が頭をあげると、」
But at this moment a cloud passed before the Moon, and then another.	ちょうどそのとき雲がお月さまをさえぎり、
I heard nothing more from him this evening.	わたしはその晩はそれ以上、お月さまから話をきくことはできませんでした。
TWENTY-FIRST EVENING	第二十一夜
"I saw a little girl weeping,"	「私は、幼い女の子が泣いているのを目にしました」
said the Moon;	お月さまは話をはじめました
"she was weeping over the depravity of the world.	「女の子は世の中の悪を嘆いていたのです。
She had received a most beautiful doll as a present.	贈り物として美しいお人形をもらったのですが、
Oh, that was a glorious doll, so fair and delicate!	なんとすばらしくきれいで繊細なお人形さんだったことでしょう。
She did not seem created for the sorrows of this world.	世の中の悲哀を背負うために生まれてきたようには思えません。
But the brothers of the little girl, those great naughty boys, had set the doll high up in the branches of a tree and had run away.	でも女の子の兄弟がとんでもないいたずら坊やたちで、お人形を高い木の枝のところに置いて逃げてしまったのです」
"The little girl could not reach up to the doll, and could not help her down,	「女の子はお人形のところまでは手がとどきませんし、助けて下ろしてあげることも無理です。
and that is why she was crying.	それが女の子が泣いている理由でした。
The doll must certainly have been crying too, for she stretched out her arms among the green branches, and looked quite mournful.	お人形も泣いているに違いありません、というのも青々とした枝の合間から両手を伸ばしていたからで、とても悲しそうにみえました。
Yes, these are the troubles of life of which the little girl had often heard tell.	そう、これが女の子がよく耳にする人生の災難ってものでしょう。
Alas, poor doll!	あぁ、かわいそうなお人形。
it began to grow dark already;	あたりはすでにだんだん暗くなってきました、
and suppose night were to come on completely!	すぐにでも夜になってしまうことでしょう。
Was she to be left sitting on the bough all night long?	お人形は枝の上で一晩中すごさなきゃならないのでしょうか？
No, the little maid could not make up her mind to that.	だめ、幼い女の子にはそんなことは許せません
'I'll stay with you,'	『わたしもここにいる』
she said, although she felt anything but happy in her mind.	そうはいってみたものの、みるみる不安な気持ちがわきおこるのを感じないわけにはいきませんでした。
She could almost fancy she distinctly saw little gnomes, with their high-crowned hats, sitting in the bushes;	大きな冠の形をした帽子をかぶった小さな妖精が、しげみに隠れているのがはっきり見えたようにも思えます。
and further back in the long walk, tall spectres appeared to be dancing.	おまけに、道のむこうではひょろひょろとしたお化けがゆらゆらしているようにも。
They came nearer and nearer, and stretched out their hands towards the tree on which the doll sat;	だんだん近づいてきて、両手をお人形の座っている木の方にのばしたりするのです。
they laughed scornfully, and pointed at her with their fingers.	あざけりわらって、お人形の方を指さしたりしています。
Oh, how frightened the little maid was!	えぇ、なんて女の子は怖かったことでしょう
'But if one has not done anything wrong,'	『でもなんにも悪いことしてないもの』
she thought,	女の子は思いました。
'nothing evil can harm one.	『だからどんな悪いやつだってなにもしないわ。
I wonder if I have done anything wrong?'	わたし、なにか悪いことしてなかったわよねぇ』
And she considered.	そうして考えてみると、
'Oh, yes!	『あら、
I laughed at the poor duck with the red rag on her leg;	わたしかわいそうなあひるが足に赤いぼろきれをつけているのを笑っちゃったわ。
she limped along so funnily,	あんまりおかしく足をひきずっていたんですもの。
I could not help laughing;	思わずわらっちゃったの。
but it's a sin to laugh at animals.'	でも動物を笑うなんていけないことだわ』
And she looked up at the doll.	お人形を見上げると、
'Did you laugh at the duck too?'	こうたずねました
she asked;	『あなたもあのあひるを笑ったでしょう？』
and it seemed as if the doll shook her head."	えぇ、お人形もうなずいたようでした」
TWENTY-SECOND EVENING	第二十二夜
"I looked down upon Tyrol,"	「私はチロルを見下ろしていました」
said the Moon,	これがお月さまが言ったことです
"and my beams caused the dark pines to throw long shadows upon the rocks.	「私のひかりが黒い松の長い影を岩々の上になげかけました。
I looked at the pictures of St. Christopher carrying the Infant Jesus that are painted there upon the walls of the houses,	私は、子供のキリストをつれている聖クリストファーの絵が家々のかべに描かれているのをみました。
colossal figures reaching from the ground to the roof.	姿は大きく、地面から屋根までとどくくらいありました。
St. Florian was represented pouring water on the burning house,	絵の中では、聖フロリアンは燃えている家に水をかけてけしていました。
and the Lord hung bleeding on the great cross by the wayside.	キリストは路傍の十字架で血を流しています。
To the present generation these are old pictures, but I saw when they were put up, and marked how one followed the other.	今の時代の人たちには、これは古い絵ですが、わたしはそれらが出来るときから観ているわけです、一軒一軒できていくのを。
On the brow of the mountain yonder is perched, like a swallow's nest, a lonely convent of nuns.	向こうの山のがけの上に、修道尼の修道院が一軒、ツバメの巣のように建っていました。
Two of the sisters stood up in the tower tolling the bell;	尼僧が二人、鐘をならす塔にいました、
they were both young, and therefore their glances flew over the mountain out into the world.	二人ともまだ若く、二人の視線は山を越え町のほうへと流れていきました。
A travelling coach passed by below,	一台の旅馬車が眼下を通り過ぎていきます。
the postillion wound his horn, and the poor nuns looked after the carriage for a moment with a mournful glance,	御者がつのぶえを響き渡らせ、その刹那二人は悲しみにみちた目で馬車を追いました。
and a tear gleamed in the eyes of the younger one.	とくに若い尼僧の両目には涙が光っています。
And the horn sounded faint and more faintly, and the convent bell drowned its expiring echoes."	つのぶえの音はだんだん小さくなり、修道院の鐘がそのひびきを打ち消しました」
TWENTY-THIRD EVENING	第二十三夜
Hear what the Moon told me.	これがお月さまがわたしに話してくれたことです。
"Some years ago, here in Copenhagen, I looked through the window of a mean little room.	「数年前、ここコペンハーゲンで私はみすぼらしい小さな部屋の窓から中をのぞきこんでいました。
The father and mother slept, but the little son was not asleep.	両親は眠りについていましたが、小さな息子は眠っていません。
I saw the flowered cotton curtains of the bed move, and the child peep forth.	ベットの側の綿のカーテンがうごき、子供の顔がのぞきました。
At first I thought he was looking at the great clock,	最初その子が大きな時計を見ているのかと思いました。
which was gaily painted in red and green.	赤と緑にはでに彩られた時計です。
At the top sat a cuckoo, below hung the heavy leaden weights,	上にはカッコーが乗っていますし、下にはとても重い錘がぶら下がっています。
and the pendulum with the polished disc of metal went to and fro, and said 'tick, tick.'	そして金属製の光沢のある丸い振り子が左右にゆれ、『チクタク』と時をきざんでいました。
But no, he was not looking at the clock, but at his mother's spinning wheel, that stood just underneath it.	でも子供がみていたのは時計ではなく、ちょうどその下にあるお母さんの紡ぎ車でした。
That was the boy's favourite piece of furniture,	男の子はそれが大のお気に入りだったのです。
but he dared not touch it,	でもさわる勇気はありませんでした。
for if he meddled with it he got a rap on the knuckles.	なんせちょっとでも触れようとしたら、手を叩かれるのですから。
For hours together, when his mother was spinning, he would sit quietly by her side, watching the murmuring spindle and the revolving wheel,	何時間ものあいだお母さんが糸を紡いでいると、男の子もそのそばで一緒にしずかに座って、糸がつむがれ、車が回るのをみているのでした。
and as he sat he thought of many things.	男の子はすわっていてもいろんなことを考えていました。
Oh, if he might only turn the wheel himself!	えぇ、自分でも糸を紡ぐことができたらとか！
Father and mother were asleep;	両親は寝ていました。
he looked at them, and looked at the spinning wheel,	男の子は両親をみて、そして紡ぎ車をみました。
and presently a little naked foot peered out of the bed,	小さなはだしの足がベットから顔をのぞかせました。
and then a second foot, and then two little white legs.	そしてもう一つの足も、それから二本の白い足がみえました。
There he stood.	立ち上がり、
He looked round once more, to see if father and mother were still asleep	もう一回両親がまだ寝ているかあたりを見回しました。
- yes, they slept;	えぇ寝ています。
and now he crept softly, softly, in his short little nightgown, to the spinning wheel, and began to spin.	それからしずかにしずかに歩をすすめ、丈のみじかい寝巻きのままで、紡ぎ車のところまでやってきました。
The thread flew from the wheel, and the wheel whirled faster and faster.	糸が紡ぎ車からでてきて、紡ぎ車は勢いよくまわりました。
I kissed his fair hair and his blue eyes,	私は男の子の金髪の髪と青い目にくちづけをしました。
it was such a pretty picture.	それはまるで絵のような光景でした」
"At that moment the mother awoke.	「そのとき母親が目をさましました。
The curtain shook, she looked forth,	カーテンがゆれ、彼女はそこをみました。
and fancied she saw a gnome or some other kind of little spectre.	地の精やなにかそういったお化けでもみたのかと思ったのです。
'In Heaven's name!'	『おぉ、神様』
she cried, and aroused her husband in a frightened way.	母親はさけび、父親も驚いて目をさましました。
He opened his eyes, rubbed them with his hands, and looked at the brisk little lad.	目を眠そうにこすって、元気いっぱいの小さな坊やを目にしました。
'Why, that is Bertel,' said he.	『どうしたんだ、ベルテルじゃないか』。
And my eye quitted the poor room,	そして私の目はその部屋から離れました。
for I have so much to see.	というのも私にはみるべきものがたくさんあるわけですから。
At the same moment I looked at the halls of the Vatican, where the marble gods are enthroned.	そしてバチカンの半分あまりを目にしたとき、そこでは大理石の神々があがめられていました。
I shone upon the group of the Laocoon;	私の光がラオコーンの一団をてらしたとき、
the stone seemed to sigh.	その石像はためいきをもらしたかのようでした。
I pressed a silent kiss on the lips of the Muses,	わたしはミューズの唇にかるく口づけをしました。
and they seemed to stir and move.	石像たちは今にも動き出しそうでした。
But my rays lingered longest about the Nile group with the colossal god.	しかし私の光がいちばん長くとどまっていたのは巨大な神々のナイルの一団のところでした。
Leaning against the Sphinx, he lies there thoughtful and meditative,	スフィンクスにもたれかかり、物思いにふけり、瞑想しているかのように横たわっていました。
as if he were thinking on the rolling centuries;	その姿はまるですぎさった月日に想いをはせているかのようです。
and little love-gods sport with him and with the crocodiles.	小さな愛らしい神々がたわむれ、ワニたちもそこで遊んでいました。
In the horn of plenty sat with folded arms a little tiny love-god,	豊穣の角笛の中には、両腕をくんだほんとうに小さな愛らしい神が一人すわっていました。
contemplating the great solemn river	まじめに荘厳な川の神をみていたのです。
-god, a true picture of the boy at the spinning wheel - the features were exactly the same.	その姿は、紡ぎ車をまわしていたあの少年に生き写しでした。
Charming and life-like stood the little marble form,	その小さな大理石の姿は、チャーミングでまるで生きてるかのようでした。
and yet the wheel of the year has turned more than a thousand times since the time when it sprang forth from the stone.	それなのに石から神が飛び出したときから、時の歯車は千回以上もまわっているのです。
Just as often as the boy in the little room turned the spinning wheel had the great wheel murmured,	あの小さな部屋の男の子が紡ぎ車をまわすのと同じだけ、時の歯車も音をたてたのです。
before the age could again call forth marble gods equal to those he afterwards formed.	それも時がのちと同じようなこの石像を再びつくりあげるまで」
"Years have passed since all this happened,"	「こういったことから何年も後のことです」
the Moon went on to say.	お月さまは続けました
"Yesterday I looked upon a bay on the eastern coast of Denmark.	「昨晩、私はデンマークの東岸の湾の上から見下ろしていました。
Glorious woods are there, and high trees, an old knightly castle with red walls, swans floating in the ponds, and in the background appears, among orchards, a little town with a church.	みごとな森、高い木々、赤い壁の古い騎士の城、池の白鳥、背景には果樹園のあいだに教会のある小さな町。
Many boats, the crews all furnished with torches, glided over the silent expanse	多くの舟、舟に乗っている人達はみなたいまつを持っていて、静かな水面をすべっていきました。
- but these fires had not been kindled for catching fish,	しかしこうした火は魚を捕まえるためのものではありません。
for everything had a festive look.	なぜなら全てはお祭りのようでしたから。
Music sounded, a song was sung, and in one of the boats the man stood erect	音楽がなりひびき、歌がきこえ、そうした船の一つに一人の男がすくっと立ち上がっていました。
to whom homage was paid by the rest,	全員が彼に敬意をはらっていました。
a tall sturdy man, wrapped in a cloak.	背の高いたくましい男で、外套に身を包んでいます。
He had blue eyes and long white hair.	青い目をして長い白い髪をなびかせていました。
I knew him,	私はこの男を知っています。
and thought of the Vatican, and of the group of the Nile, and the old marble gods.	バチカンやナイルの一団のこと、そして古き大理石の神々を思い浮かべました。
I thought of the simple little room where little Bertel sat in his night-shirt by the spinning wheel.	小さなベルテルが寝巻きをきて、紡ぎ車の側にすわっていたさっぱりとした小さな部屋を思い浮かべました。
The wheel of time has turned, and new gods have come forth from the stone.	時の歯車がまわって、新しい神々が石から飛び出してきました。
From the boats there arose a shout:	舟からは声があがります
'Hurrah, hurrah for Bertel Thorwaldsen!'"	『ばんざい、ベルテル・トルヴァルセン、ばんざい』」
TWENTY-FOURTH EVENING	第二十四夜
"I will now give you a picture from Frankfort,"	「フランクフルトの絵を見せてあげましょう」
said the Moon.	とお月さま。
"I especially noticed one building there.	「私は一つの建物に特に注意をひきつけられました。
It was not the house in which Goethe was born, nor the old Council House, through whose grated windows peered the horns of the oxen that were roasted and given to the people when the emperors were crowned.	それはゲーテの生まれた家でも、古い議会でもありませんが、その格子窓からは皇帝が王位についたときに人々に与えられる焼かれた雄牛の角がみてとれました。
No, it was a private house,	そうではなく、そこは個人の家でした。
plain in appearance, and painted green.	外見は質素で、緑に塗られていて、
It stood near the old Jews' Street.	ジュー通りにたっています。
It was Rothschild's house.	そこはロスチャイルドの家でした」
"I looked through the open door.	「開いた扉から家の中をみると、
The staircase was brilliantly lighted:	階段のところが明るく照らされていました。
servants carrying wax candles in massive silver candlesticks stood there, and bowed low before an old woman,	召使たちは大きな銀の燭台にろうそくを立て、そこに立って、老婦人の前で低く頭をたれていました。
who was being brought downstairs in a litter.	その老婦人は、籠で階下にはこばれるところでした。
The proprietor of the house stood bare-headed, and respectfully imprinted a kiss on the hand of the old woman.	この家の主人は帽子をぬいでそこに立っており、老婦人の手をとりうやうやしく口づけしました。
She was his mother.	老婦人は母親だったのです。
She nodded in a friendly manner to him and to the servants, and they carried her into the dark narrow street, into a little house,	母親は親しげに主人と召使たちにうなずくと、召使たちは暗くせまい通りへと運び出し、小さな家へ運び込みました。
that was her dwelling.	そこが彼女の住居でした。
Here her children had been born, from hence the fortune of the family had arisen.	そこが子供たちが生まれた場所であり、ここから一家の富が生まれたのです。
If she deserted the despised street and the little house, fortune would also desert her children.	もし老婦人がこのうらぶれた通りと小さな家を見捨てたとしたら、富もまた彼女の子供たちを見捨てたことでしょう。
That was her firm belief."	それが彼女の固い信念でした」
The Moon told me no more;	お月さまはそれ以上何も口にしませんでした。
his visit this evening was far too short.	お月さまの今晩の訪問はごくみじかいものでした。
But I thought of the old woman in the narrow despised street.	でもわたしはあの狭いうらぶれた通りの老婦人に思いをはせました。
It would have cost her but a word, and a brilliant house would have arisen for her on the banks of the Thames	老婦人がたった一言でもいえば、テームズ川の川辺に素敵な家をたてることもできたでしょう。
- a word, and a villa would have been prepared in the Bay of Naples.	またナポリ湾にすてきな別荘を建てる事もできたでしょう。
"If I deserted the lowly house, where the fortunes of my sons first began to bloom, fortune would desert them!"	「もし私がこのみすぼらしい家を見捨てたら、そう、私の息子たちの富が最初に花咲いたこの家を見捨てたら、富は息子たちを見捨てるだろう！」
It was a superstition,	それは迷信に過ぎません。
but a superstition of such a class, that he who knows the story and has seen this picture, need have only two words placed under the picture to make him understand it;	でもそういった類の迷信は、お話を知っていてこの絵を見たものにとっては、理解するためにはたった二言あれば十分です。
and these two words are: "A mother."	そう「一人の母親」と。
TWENTY-FIFTH EVENING	第二十五夜
"It was yesterday, in the morning twiligh"t	「昨晩の黎明（れいめい）のことでした」
- these are the words the Moon told me -	これはお月さまがわたしに言ったことです。
"in the great city no chimney was yet smoking	「大都市でしたが、まだどの煙突からも煙はでていません。
- and it was just at the chimneys that I was looking.	私がみていたのは煙突そのものでした。
Suddenly a little head emerged from one of them,	突然そのうちの一つから小さな頭が姿をのぞかせました。
and then half a body, the arms resting on the rim of the chimney-pot.	それから体が半分、両腕を煙突のへりのところにもたれかからせています。
'Ya-hip! ya-hip!'	『やった、やった』
cried a voice.	と声がします。
It was the little chimney-sweeper,	それは煙突掃除の子供でした。
who had for the first time in his life crept through a chimney, and stuck out his head at the top.	うまれてはじめて煙突にもぐりこんで、てっぺんから頭をのぞかせたわけです。
'Ya-hip! ya-hip'	『やった、やった』
Yes, certainly that was a very different thing to creeping about in the dark narrow chimneys!	えぇ、確かに暗く狭い煙突にもぐりこむのはいままで体験したことのない出来事でした。
the air blew so fresh, and he could look over the whole city towards the green wood.	ふきぬける風は新鮮で、緑の森まで都市全体をみわたすことができました。
The sun was just rising.	ちょうど太陽がのぼってきます。
It shone round and great, just in his face,	朝日がその子の満面をてらします。
that beamed with triumph, though it was very prettily blacked with soot.	顔はとてもかわいらしい具合にすすけてましたが、なんとほこらしげだったことでしょう」
"'The whole town can see me now,'	「まち全部がぼくのことをみてるぞ」
he exclaimed,	その子はさけび、
'and the moon can see me now, and the sun too.	「お月さまも、お日さまもだ。
Ya-hip! ya-hip!'	やった、やった」
And he flourished his broom in triumph."	ほこらしさのあまり、ほうきをふりあげました。
TWENTY-SIXTH EVENING	第二十六夜
"Last night I looked down upon a town in China,"	「昨晩、私は中国のある町を見下ろしていました」
said the Moon.	お月さまは話しはじめます。
"My beams irradiated the naked walls that form the streets there.	「私の光は道をつくっているむきだしの塀をてらしていました。
Now and then, certainly, a door is seen;	ところどころには門がみてとれました。
but it is locked,	でもその門には鍵がかかっています。
for what does the Chinaman care about the outer world?	というのは、中国人は外の世界にはまったく注意を払っていないからでしょう。
Close wooden shutters covered the windows behind the walls of the houses;	家の塀のうしろにある窓には、木製のよろい戸がきちんと閉められています。
but through the windows of the temple a faint light glimmered.	ただお寺の窓をとおしてかすかな光がもれだしていました。
I looked in,	私は中をのぞきこみました。
and saw the quaint decorations within.	そして古風で趣がある内装を目にしました。
From the floor to the ceiling pictures are painted, in the most glaring colours, and richly gilt -  pictures representing the deeds of the gods here on earth.	床から天井に至るまで、まばゆいほどの色とあふれんばかりの金ぱくで絵がえがかれており、絵はこの世での神の行ないをうつしていました。
In each niche statues are placed, but they are almost entirely hidden by the coloured drapery and the banners that hang down.	あらゆる隙間には仏像がかざられ、ただそれらもいろとりどりの幕や旗でほとんど見えないくらいでした。
Before each idol (and they are all made of tin) stood a little altar of holy water, with flowers and burning wax lights on it.	それぞれの神像の前には（すべてすずでつくられたものでしたが）、小さな祭壇があり、聖水に花と炎のゆらめくろうそくがありました。
Above all the rest stood Fo, the chief deity, clad in a garment of yellow silk,	とりわけ最後には最高の神、仏陀が黄色のシルクを身にまとっています。
for yellow is here the sacred colour.	黄色は中国では聖なる色なのです。
At the foot of the altar sat a living being, a young priest.	祭壇の下には一人の人間、若い僧がすわっていました。
for his cheeks glowed and he held down his head.	そのほほには赤みがさし、頭をたれています。
Poor Soui-Hong!	かわいそうなソーホン。
Was he, perhaps, dreaming of working in the little flower garden behind the high street wall?	たぶん高い塀のむこうの小さな花壇で働いている夢でもみているのでしょう。
And did that occupation seem more agreeable to him than watching the wax lights in the temple?	そういった仕事のほうが、お寺でろうそくの火をみているより彼には合っているのでしょうか？
Or did he wish to sit at the rich feast, wiping his mouth with silver paper between each course?	それとも饗宴に座して、出されるもののたびに銀の紙で口をぬぐいたいとでもいうのでしょうか？
Or was his sin so great that, if he dared utter it, the Celestial Empire would punish it with death?	それとももし口にだしたら、天上界の神が死をもって罰するほど彼の罪は大きいのでしょうか？
Had his thoughts ventured to fly with the ships of the barbarians, to their homes in far distant England?	彼の想いは海賊の船にのって空高く舞い上がったのでしょうか、そう遠くはなれた海賊の故郷のイギリスまで？
No, his thoughts did not fly so far,	いいえ、彼の想いはそこまで至っていません。
and yet they were sinful,	それなのに彼の想いは十分罪深いものでした。
sinful as thoughts born of young hearts, sinful here in the temple, in the presence of Fo and the other holy gods.	若い心に浮かんだその想いは罪深く、とくにお寺で、仏陀や他の神聖な神々の前ではそうなのです」
"I know whither his thoughts had strayed.	「私は彼の想いがどこにあったのかを知っています。
At the farther end of the city, on the flat roof paved with porcelain, on which stood the handsome vases covered with painted flowers,	町のはるかはなれた外れに、タイルでおおわれた平らな床があり、そこには花が描かれたすてきな花瓶がありました。
sat the beauteous Pu, of the little roguish eyes, of the full lips, and of the tiny feet.	そしていたずらな目をして、ふっくらとした唇で、小さな足の美しいプーが座っていました。
The tight shoe pained her, but her heart pained her still more.	靴がきついのも彼女を苦しめていましたが、その心はもっと苦しんでいました。
She lifted her graceful round arm, and her satin dress rustled.	彼女がその優雅でまるみをおびた腕をもちあげると、繻子（しゅす）織りの着物が音をたてました。
Before her stood a glass bowl containing four gold-fish.	彼女の前には、金魚鉢にはいった四匹の金魚がいます。
She stirred the bowl carefully with a slender lacquered stick, very slowly,	彼女は金魚鉢を細い漆塗りの棒で、注意深くゆっくりゆっくりかきまぜました。
for she, too, was lost in thought.	というのも、彼女も想いにふけっていたからです。
Was she thinking, perchance, how the fishes were richly clothed in gold, how they lived calmly and peacefully in their crystal world, how they were regularly fed, and yet how much happier they might be if they were free?	ひょっとして彼女もこうした金魚たちが金で着飾ってどんな風かとか、鉢の中で平和で穏やかにくらしているとか、えさをちゃんともらってるかとか、もし自由になったらどれほど幸せになるだろうかと考えていたのでしょうか？
Yes, that she could well understand, the beautiful Pu.	えぇ、美しきプーにはよくわかっていました。
Her thoughts wandered away from her home, wandered to the temple,	彼女の想いも自分の家を遠く離れ、寺院へとさまよっていたのです。
but not for the sake of holy things.	ただ寺院の聖なるもののためではありません。
Poor Pu!	かわいそうなプー、
Poor Soui-hong!	そしてかわいそうなソーホン」
"Their earthly thoughts met, but my cold beam lay between the two, like the sword of the cherub."	「この世での二人の想いはめぐり会いましたが、私の冷たい光が天使の剣のようにその想いのあいだにあったのです」
TWENTY-SEVENTH EVENING	第二十七夜
"The air was calm,"	「ここちよい夜でした」
said the Moon;	お月さまはそう話をしました。
"the water was transparent as the purest ether through which I was gliding, and deep below the surface I could see the strange plants that stretched up their long arms towards me like the gigantic trees of the forest.	「水はすみきった大気のように透明で、そこを私はすべっていき、水面から深いところでは奇妙な植物が、その長い触手を私の方へまるで森の巨大な木のようにのばしていました。
The fishes swam to and fro above their tops.	魚たちがそのてっぺんをあちこち泳いでいます。
High in the air a flight of wild swans were winging their way,	空たかく白鳥の群れがとんでいました。
one of which sank lower and lower, with wearied pinions,	そのうちの一羽が疲れきって、だんだん落ちて行きます。
his eyes following the airy caravan, that melted farther and farther into the distance.	目は軽やかな仲間たちを追っているのですが、その姿はだんだん遠くになっていきます。
With outspread wings he sank slowly, as a soap bubble sinks in the still air, till he touched the water.	つばさを精一杯広げ、ゆっくりと白鳥は水面まで落ちて行きました。
At length his head lay back between his wings, and silently he lay there, like a white lotus flower upon the quiet lake.	とうとう白鳥の頭は羽のあいだにうもれ、しずまりかえった湖の蓮の白い花のように、白鳥はしずかによこたわりました。
And a gentle wind arose, and crisped the quiet surface,	そこにゆるやかな風がふき、しずまりかえった水面にさざなみが立ちました。
which gleamed like the clouds that poured along in great broad waves;	さざなみは大きな波のなかでただよう雲のように光りました。
and the swan raised his head, and the glowing water splashed like blue fire over his breast and back.	そして白鳥は頭をあげ、その胸と背中のまわりで水が青い炎のようにしぶきをあげました。
The morning dawn illuminated the red clouds,	朝焼けが雲を赤くそめています。
the swan rose strengthened, and flew towards the rising sun,	白鳥はすくっと姿勢をただし、朝日にむかって飛んでいきます。
towards the bluish coast whither the caravan had gone;	仲間たちが飛んで行った透明に近い青い色をした海岸の方へ。
but he flew alone, with a longing in his breast.	ただ一羽、胸にあこがれをいだき飛んで行きます。
Lonely he flew over the blue swelling billows."	青くうねる大海の上を一羽さびしく飛んで行きます」
TWENTY-EIGHTH EVENING	第二十八夜
"I will give you another picture of Sweden,"	「スウェーデンのようすをお話しましょう」
said the Moon.	とお月さまははじめました
"Among dark pine woods, near the melancholy banks of the Stoxen, lies the old convent church of Wreta.	「暗い松林から、ストックセンの憂鬱な土手の近くに、古いレタ修道院がありました。
My rays glided through the grating into the roomy vaults,	私の光は格子窓から埋葬室へとさしこみました。
where kings sleep tranquilly in great stone coffins.	そこには王たちが大きな石の棺のなかでしずかに眠りについていました。
On the wall, above the grave of each, is placed the emblem of earthly grandeur, a kingly crown;	壁にはそれぞれのお墓の上に、この世での偉大さを表す紋章、王族の冠がついていました。
but it is made only of wood, painted and gilt, and is hung on a wooden peg driven into the wall.	ただそれは木で作られ、金めっきされたもので、壁に打ちつけられた木の掛けくぎにぶらさげられているものでした。
The worms have gnawed the gilded wood, the spider has spun her web from the crown down to the sand, like a mourning banner, frail and transient as the grief of mortals.	虫たちが金めっきされた木をかじっており、クモが冠から地面までまるで半旗のように巣をはり、死の悲しみのようにもろくはかないようすでした。
How quietly they sleep!	なんと静かな眠りでしょう。
I can remember them quite plainly.	そのようすをありありと思い浮かべることができます。
I still see the bold smile on their lips, that so strongly and plainly expressed joy or grief.	かれらの唇にうかんだ不敵な笑み、喜びや悲しみをはっきりありありと示していました。
When the steamboat winds along like a magic snail over the lakes, a stranger often comes to the church, and visits the burial vault;	蒸気船が湖を魔法のかたつむりのようにわたるとき、旅行者が修道院にやってきて、埋葬室を訪れます。
he asks the names of the kings, and they have a dead and forgotten sound.	王たちの名をたずね、死者の忘れられた名前を耳にするのです。
He glances with a smile at the worm-eaten crowns, and if he happens to be a pious, thoughtful man, something of melancholy mingles with the smile.	虫食いのある王冠をみて微笑み、もしたまたま敬虔ぶかく思慮のある人なら、その笑みにどこか物悲しいようすが見られることでしょう。
Slumber on, ye dead ones!	眠れよ、死者たち。
The Moon thinks of you, the Moon at night sends down his rays into your silent kingdom, over which hangs the crown of pine wood."	月が見守り、夜の月がおまえたちの静かな王国に、松林の上を越えて光をなげかけると」
TWENTY-NINTH EVENING	第二十九夜
"Close by the high-road,"	「本街道の近くに」
said the Moon,	お月さまは物語をはじめました。
"is an inn, and opposite to it is a great waggon-shed,	「一軒の宿があり、その向かいには大きな馬車置き場がありました。
whose straw roof was just being re-thatched.	そのわらぶき屋根はちょうどふきなおされているところでした。
I looked down between the bare rafters and through the open loft into the comfortless space below.	私は小屋の枠組みのあいだから顔をのぞかせ、屋根裏部屋からその下のわびしい場所をながめました。
The turkey-cock slept on the beam, and the saddle rested in the empty crib.	梁では七面鳥が眠っており、からのかいば桶には鞍がおかれていました。
In the middle of the shed stood a travelling carriage;	小屋のまんなかには旅行馬車が一台とまっていました。
the proprietor was inside, fast asleep, while the horses were being watered.	その馬車の持ち主は中にいて、ぐっすり眠りについており、馬たちには水が与えられていました。
The coachman stretched himself, though I am very sure that he had been most comfortably asleep half the last stage.	御者は体をおもいっきりのばし、私が思うにはついさきほどの旅程の半分で気持ちよくうつらうつらとしていたに違いありません。
The door of the servants' room stood open, and the bed looked as if it had been turned over and over;	召使の部屋のドアは開けっぱなしで、ベッドは何度もひっくりかえったかのようで、
the candle stood on the floor, and had burnt deep down into the socket.	ろうそくは床に立っており、ずいぶん燃えていました。
The wind blew cold through the shed:	小屋を風がふきぬけ、
it was nearer to the dawn than to midnight.	夜分をすぎて夜明けが近くなっていました。
In the wooden frame on the ground slept a wandering family of musicians.	地面におかれた木のベッドでは音楽の巡業の一家が眠りについていました。
The father and mother seemed to be dreaming of the burning liquor that remained in the bottle.	両親はボトルにのこっていたきついお酒の夢をみているようでした。
The little pale daughter was dreaming too,	小さな青白い顔をした娘も夢をみていました。
for her eyes were wet with tears.	というのも彼女の目は涙にぬれていたからです。
The harp stood at their heads, and the dog lay stretched at their feet."	頭のところにはハープがあり、足元では犬がだらんと寝転がっていました」
THIRTIETH EVENING	第三十夜
"It was in a little provincial town,"	「それは小さな地方都市でのことでした」
the Moon said;	お月さまはそう口火をきりました。
"it certainly happened last year, but that has nothing to do with the matter.	「確かに昨年のことですが、とくに昨年ということに関係あるわけじゃありません。
I saw it quite plainly.	私はそれをはっきりと目にしました。
To-day I read about it in the papers, but there it was not half so clearly expressed.	今日新聞でそのことを読んだのですが、半分も物事は明らかになっていません。
In the taproom of the little inn sat the bear leader, eating his supper;	小さな宿屋のバーに、熊使いが腰を下ろして夕食をとっていました。
the bear was tied up outside, behind the wood pile	熊は外で木のくいにつながれています。
- poor Bruin,	かわいそうな熊のブルーイン。
who did nobody any harm, though he looked grim enough.	何の害も与えないのに、まぁ十分獰猛に見えたのはたしかですが。
Up in the garret three little children were playing by the light of my beams;	屋根裏部屋では三人の子供が私の光をあびて遊んでいました。
the eldest was perhaps six years old, the youngest certainly not more than two.	一番年上が六才で、一番小さいのがたぶんニ才くらいでしょう。
'Tramp, tramp'	『ドシン、ドシン』
- somebody was coming upstairs:	誰かが二階に上がってきました。
who might it be?	だれでしょう？
The door was thrust open	ドアが押されて開きました。
- it was Bruin, the great, shaggy Bruin!	ブルーインです、大きな毛むくじゃらのブルーイン。
He had got tired of waiting down in the courtyard, and had found his way to the stairs.	庭でまってるのにうんざりして、階段を上る道をみつけたのでした。
I saw it all,"	私はなにもかも見ていました」
said the Moon.	とお月さまは続けました。
"The children were very much frightened at first at the great shaggy animal;	「子供たちは最初は大きなけむくじゃらの動物をみて、びっくりぎょうてんして、
each of them crept into a corner,	三人とも隅の方で縮こまっていました。
but he found them all out, and smelt at them, but did them no harm.	だけど熊はすぐに子供たちをみつけだし、においをくんくんかぎましたが、なんら危害をくわえるようなことはしません。
'This must be a great dog,'	『これは大きな犬にちがいないよ』
they said, and began to stroke him.	子供たちは口々にいい、熊をなではじめました。
He lay down upon the ground, the youngest boy clambered on his back, and bending down a little head of golden curls, played at hiding in the beast's shaggy skin.	熊は床に横たわり、一番小さい子がその背中にのぼりって、その小さな金髪の頭を隠し、熊の毛むくじゃらの体の中に隠れて遊びました。
Presently the eldest boy took his drum, and beat upon it till it rattled again;	そのとき一番年上のこどもがたいこを持ち出してきて、ぼんぼこ叩きはじめました。
the bear rose upon his hind legs, and began to dance.	熊は後ろ足でたちあがり、踊りはじめました。
It was a charming sight to behold.	みているとすっかり楽しくなるような光景でした。
Each boy now took his gun, and the bear was obliged to have one too,	子供たちはみな銃を持ち、熊もひとつもたされました。
and he held it up quite properly.	熊は銃をちゃんともつことができました。
Here was a capital playmate they had found;	子供たちはすばらしい遊び友達をみつけたのです。
and they began marching - one, two; one, two.	みんなで行進をはじめました、おいっちに、おいっちに」
"Suddenly some one came to the door, which opened,	「とつぜん誰かがドアのところにやってきて、ドアを開けました。
and the mother of the children appeared.	子供たちの母親が姿をあらわしました。
You should have seen her in her dumb terror, with her face as white as chalk, her mouth half open, and her eyes fixed in a horrified stare.	すっかり口もきけないほどびっくりしてしまい、顔からさっと血の気がひき、口は半開きで、目はおそろしい光景を凝視しています。
But the youngest boy nodded to her in great glee, and called out in his infantile prattle,	でも一番ちいさな子供が大喜びでお母さんにうなづき、子供らしい口調ではなしかけました。
'We're playing at soldiers.'	『兵隊ごっこをやってるんだ』、
And then the bear leader came running up."	そして熊使いも階段をのぼってきました」
THIRTY-FIRST EVENING	第三十一夜
The wind blew stormy and cold,	風がびゅんびゅん冷たくふきました。
the clouds flew hurriedly past;	雲はすごい勢いで流れて行きました。
only for a moment now and then did the Moon become visible.	お月さまがその隙間から顔をのぞかせたときです。
He said,	こう切り出しました
"I looked down from the silent sky upon the driving clouds,	「流れる雲の上の静かな空から地上を見下ろしていました。
and saw the great shadows chasing each other across the earth.	地上ではいくつもの大きな影が追いかけっこをしていました。
I looked upon a prison.	私はある監獄を見下ろしていました。
A closed carriage stood before it;	屋根のある馬車が監獄の前にとまります。
a prisoner was to be carried away.	一人の囚人が移送されることになっていたのです。
My rays pierced through the grated window towards the wall;	私の光は格子窓を通りぬけ壁まで達しました。
the prisoner was scratching a few lines upon it, as a parting token;	囚人はかけらで壁になにかを書いていました。
but he did not write words,	でも言葉を書いていたのではありません。
but a melody, the outpouring of his heart.	心にあふれてくるメロディーを刻んでいたのです。
The door was opened, and he was led forth, and fixed his eyes upon my round disc.	ドアが開き、囚人はつれていかれ、その目は私の丸い姿にくぎづけでした。
Clouds passed between us, as if he were not to see his face, nor I his.	まるで彼が自分の顔をみれないさだめで、私も彼の顔をみれないさだめでもあるかのように雲が二人のあいだを流れて行きました。
He stepped into the carriage, the door was closed, the whip cracked,	囚人は馬車にのりこみ、そのドアが閉まり、むちの音が鳴り響きました。
and the horses gallopped off into the thick forest,	馬が深い森へと駆け出して行きました。
whither my rays were not able to follow him;	そこには私の光も届きません。
but as I glanced through the grated window, my rays glided over the notes,	でも私は格子窓をとおして、書かれたものを読み取りました。
his last farewell engraved on the prison wall	監獄の壁に書かれた最後のお別れの挨拶を。
- where words fail, sounds can often speak.	言葉では語れず、音楽が雄弁になるときがあるのです。
My rays could only light up isolated notes,	私の光はそのぽつんと書かれたものを照らし出しました。
so the greater part of what was written there will ever remain dark to me.	そこに書かれた大部分は私には暗くてよく見えませんでした。
Was it the death-hymn he wrote there?	囚人がそこに書いたのは死の賛美歌なのでしょうか？
Were these the glad notes of joy?	喜びに満ちた歌なのでしょうか？
Did he drive away to meet death, or hasten to the embraces of his beloved?	馬車でつれていかれ死を迎えるのか、愛するものを抱きしめるために急いでいるのでしょうか？
The rays of the Moon do not read all that is written by mortals."	月光は死の運命をもった人間のかいたものを、すべて読むことができるわけではありません」
THIRTY-SECOND EVENING	第三十二夜
"I love the children,"	「私は子供を愛しています」
said the Moon,	お月さまはそう話しかけました
"especially the quite little ones	「特にちっちゃい子は。
- they are so droll.	おどけたところがあるじゃないですか。
Sometimes I peep into the room, between the curtain and the window frame, when they are not thinking of me.	ときどき子供たちがぜんぜん私のことなんて考えてないときに、私はカーテンや窓枠のあいだから部屋をのぞくのです。
It gives me pleasure to see them dressing and undressing.	着替えているところをみるのは楽しいものです。
First, the little round naked shoulder comes creeping out of the frock, then the arm;	まず子供服をぬぐとまんまるいちっちゃい肩が、そして腕が姿をあらわします。
or I see how the stocking is drawn off, and a plump little white leg makes its appearance, and a white little foot that is fit to be kissed,	あるいは、くつしたをぬいで、ふっくらした小さなまっしろい脚が、そしてキスしたくなるような真っ白な小さな足が姿をあらわすのです。
and I kiss it too.	もちろん私もそれにキスをします」
"But about what I was going to tell you.	「でもお話したいのはこういうことです。
This evening I looked through a window,	今晩、カーテンのかかってないある窓から部屋をのぞいていました。
before which no curtain was drawn, for nobody lives opposite.	向かいの家にだれも住んでいなかったので、カーテンがいらなかったのです。
I saw a whole troop of little ones, all of one family,	わたしはちっちゃい子供の一団を目にしました。
and among them was a little sister.	みんな家族で、そこには小さな女の子がいました。
She is only four years old, but can say her prayers as well as any of the rest.	たった四才ですが、みんなと同じようにお祈りをちゃんとできるのです。
The mother sits by her bed every evening, and hears her say her prayers;	お母さんは毎晩、女の子のベッドのそばにすわりこんで、その子がお祈りするのを聞いてあげるのでした。
and then she has a kiss, and the mother sits by the bed till the little one has gone to sleep,	それから女の子にキスをして、寝るまでずっとそばに座っているのです。
which generally happens as soon as ever she can close her eyes.	女の子はいつも目をとじるとすぐ寝てしまうのですが」
"This evening the two elder children were a little boisterou.s	「今晩、年上の二人がすこしおいたをしました。
One of them hopped about on one leg in his long white nightgown,	一人は長いまっしろな寝巻きをきて、片足でぴょんぴょんはねていました。
and the other stood on a chair surrounded by the clothes of all the children, and declared he was acting Grecian statues.	もう一人は子供服をまわりにちりばめ椅子の上にたって、ギリシャ彫刻みたいだろ、と得意げにいいはなちました。
The third and fourth laid the clean linen carefully in the box,	三番目と四番目の子はきれいな下着を箱の中に注意深くしまいました。
for that is a thing that has to be done;	というのはそれがやらなきゃいけないことだったからです。
and the mother sat by the bed of the youngest, and announced to all the rest that they were to be quiet,	お母さんは一番小さい子のベッドのそばに腰をおろし、全員に静かにするようにといいました。
for little sister was going to say her prayers.	女の子がお祈りをするからです」
"I looked in, over the lamp, into the little maiden's bed,	「私はランプ越しに小さな女の子のベッドをのぞき込みました。
where she lay under the neat white coverlet, her hands folded demurely and her little face quite grave and serious.	こざっぱりした白い上布団にもぐりこみ、両手は上品に組まれていて、女の子の小さな顔は真剣そのものでした。
She was praying the Lord's prayer aloud.	女の子はお祈りを声にだしました。
But her mother interrupted her in the middle of her prayer.	でもお母さんがお祈りの途中でやめさせます。
'How is it,'	『どうしたの』
she asked,	お母さんは聞きました。
'that when you have prayed for daily bread, you always add something I cannot understand?	『日々のパンってところで、いつも聞き取れないけど何かいってるわね。
You must tell me what that is.'	なんて言ってるのかいいなさい』
The little one lay silent, and looked at her mother in embarrassment.	小さい女の子は答えず横になっていて、お母さんの顔をこまったように見ています
'What is it you say after our daily bread?'	『日々のパンのあとになんていってるの？』
'Dear mother, don't be angry:	『おかあさん、怒らないでね。
I only said, and plenty of butter on it.'"	ただ、それにバターもたっぷりって言っただけなの』」
