PETER PAN IN KENSINGTON GARDENS 　James Matthew Barrie	ケンジントン公園のピーターパン
Peter Pan	1. ピーターパン
The Thrush's Nest	2. つぐみの巣
The Little House	3. ちいさな家
Lock-Out Time	4. ロック・アウトの時間
Peter Pan	１章　ピーターパンの章
If you ask your mother whether she knew about Peter Pan when she was a little girl she will say,	もしお母さんに、幼かった頃にピーターパンを知っていたかどうかたずねたら、こう答えるでしょう。
"Why, of course, I did, child,"	「もちろん、知っていたに決まってるじゃないの、かわいい子」。
and if you ask her whether he rode on a goat in those days	そしてピーターが、その頃やぎに乗っていたかどうかもたずねたら、
she will say, "What a foolish question to ask, certainly he did."	「なんてばかげたこと聞くの、もちろん乗っていたにきまってるわよ」と答えるでしょう。
Then if you ask your grandmother whether she knew about Peter Pan when she was a girl,	次におばあちゃんに同じ事をたずねても、
she also says, "Why, of course, I did, child,"	「おやまぁ、もちろん知っていたに決まってるよ、かわいい子」と答えるでしょう。
but if you ask her whether he rode on a goat in those days, she says she never heard of his having a goat.	けれども、その頃ピーターはやぎに乗っていたかどうかを聞くと、やぎを飼っていたなんてことは聞いたこともないよ、と答えます。
Perhaps she has forgotten,	たぶんおばあちゃんは忘れてしまったのでしょう。
just as she sometimes forgets your name and calls you Mildred, which is your mother's name.	なんせあなたの名前も時々忘れてしまって、お母さんの名前の「ミルドレッド」と、あなたに呼びかけるくらいですから。
Still, she could hardly forget such an important thing as the goat.	でもやぎみたいな大切なことを、おばあちゃんが思い出せないなんて事があるでしょうか？
Therefore there was no goat when your grandmother was a little girl.	つまりおばあちゃんが幼い頃には、やぎはいなかったのです。
This shows that,	だからこういうことです。
in telling the story of Peter Pan, to begin with the goat (as most people do) is as silly as to put on your jacket before your vest.	ピーターパンのお話をするにあたって、みんながそうするように、やぎのことから始めるのはベストを着る前に上着を着こむほどばかげたことなんです。
Of course, it also shows that Peter is ever so old, but he is really always the same age,	もちろん、ピーターはとても年をとってるってことにもなりますが、実際のところはずっと年をとらないのです。
so that does not matter in the least.	だから年のことなんて全然問題にもなりません。
His age is one week, and though he was born so long ago he has never had a birthday, nor is there the slightest chance of his ever having one.	ピーターの歳は生まれて１週間で、ずっと昔に生まれたのですが、まだ１回も誕生日が来たこともなければ、これから来ることもないでしょう。
The reason is that he escaped from being a human when he was seven days' old;	その理由というのは、生後７日目に人になることから逃げ出したからです。
he escaped by the window and flew back to the Kensington Gardens.	窓から抜けだして、ケンジントン公園へ飛んで帰ってきたのです。
If you think he was the only baby who ever wanted to escape,	これまでで、ピーターが逃げ出したいだなんて思った、たった一人の赤ん坊だったんじゃないの？
it shows how completely you have forgotten your own young days.	と考えるのは、どれほど自分が幼かった頃のことをすっかり忘れてしまっているかを示しているようなものです。
When David heard this story first he was quite certain that he had never tried to escape,	デビットが初めてこの話を聞いたとき、自分は逃げようとした事なんかないや、と思いこんでいたものです。
but I told him to think back hard, pressing his hands to his temples,	私はこめかみを両手で押さえてよく思い出してご覧なさいと言いました。
and when he had done this hard, and even harder, he distinctly remembered a youthful desire to return to the tree-tops, and with that memory came others, as that he had lain in bed planning to escape as soon as his mother was asleep, and how she had once caught him half-way up the chimney.	デビットが一心にそうしてみると、木のてっぺんに戻りたいと幼心に思っていたこと、その記憶が次の記憶へつながって、ベッドに横になっていた時に、お母さんが眠ったらすぐにでも逃げ出す計画を立てていたこと、かつて煙突に半分のぼったところでお母さんにどうやって捕まっちゃったかを、はっきりと思い出したのでした。
All children could have such recollections if they would press their hands hard to their temples,	全ての子供はもしこめかみを両手で強く押さえて思い出せば、このような思い出を持っているものです。
for, having been birds before they were human, they are naturally a little wild during the first few weeks,	なぜなら子供たちは人になる前は鳥だったので、生まれたての数週間はちょっと動物っぽいところがあるのです。
and very itchy at the shoulders, where their wings used to be.	肩の、かつて翼があったあたりがとてもムズムズするのでした。
So David tells me.	これが、デビットが私に話してくれたことです。
I ought to mention here that the following is our way with a story:	私がここで言っておかなきゃいけないのは、私たちの方法でお話するってことです。
First, I tell it to him, and then he tells it to me, the understanding being that it is quite a different story;	つまり最初に私がデビットにお話をして、それからデビットが私にお話をする、そうすると全く違ったお話になるってことが分かるでしょう。
and then I retell it with his additions, and so we go on until no one could say whether it is more his story or mine.	私は自分のお話をデビットの分に足して話すし、話をすすめていけば、デビットのお話なのか私のお話なのか、どちらのお話だなんて誰にもいえなくなるでしょう。
In this story of Peter Pan, for instance, the bald narrative and most of the moral reflections are mine, though not all,	このピーターパンのお話に関して言えば、例えばつまらない部分と、道徳に関しての小言の、全部ではないにしてもほとんどは私のお話です。
for this boy can be a stern moralist,	というのもピーターパンは、きちんと道徳を守ることもあるからです。
but the interesting bits about the ways and customs of babies in the bird-stage are mostly reminiscences of David's,	でも子供が鳥だった頃のやり方や習慣のちょっとしたおもしろいことは、ほとんどデビットが思い出したことです。
recalled by pressing his hands to his temples and thinking hard.	こめかみを強く両手で押えてじっくり考えて。
Well, Peter Pan got out by the window, which had no bars.	さてピーターパンは窓から出て行きましたけど、そこには柵はありませんでした。
Standing on the ledge he could see trees far away,	窓棚の上に立っていると、遠くの木々がみえました。
which were doubtless the Kensington Gardens,	そこは間違いなくケンジントン公園です。
and the moment he saw them he entirely forgot that he was now a little boy in a nightgown,	公園を見ていたときは、ねまきをきた小さな男の子だってことをすっかり忘れていました。
and away he flew, right over the houses to the Gardens.	そして公園まで、家のすぐ上を越えて飛んでいったのです。
It is wonderful that he could fly without wings,	翼もなしに飛ぶことができるなんて不思議です。
but the place itched tremendously,	ただ翼の生える場所は、とてもムズムズするのでした。
and, perhaps we could all fly if we were as dead-confident-sure of our capacity to do it as was bold Peter Pan that evening.	そしてたぶん、勇敢なピーターパンがその夜に飛べるって固く強く信じたほど私たちも信じれば、みんなが空を飛べることでしょう。
He alighted gaily on the open sward, between the Baby's Palace and the Serpentine,	ピーターは、赤ん坊の王宮とサーペンタイン池の間の広々とした芝生に楽しそうに降り立ちました。
and the first thing he did was to lie on his back and kick.	最初にピーターがしたことは仰向けに横たわって、けるように足を動かすことでした。
He was quite unaware already that he had ever been human,	ピーターは、自分がかつて人だったとは全く知りません。
and thought he was a bird, even in appearance, just the same as in his early days,	そして自分は外見も、幼い頃からずっと同じで、鳥のままだと思っていました。
and when he tried to catch a fly he did not understand that the reason he missed it	だからハエを一匹捕まえようとして、失敗してしまう理由が全然わからないのでした。
was because he had attempted to seize it with his hand,	失敗する理由は、手でハエを捕まえようとしていたからなんです。
which, of course, a bird never does.	もちろん鳥はそんなことをしません。
He saw, however, that it must be past Lock-out Time,	でもピーターには、門が閉まる頃に違いないということは分かりました。
for there were a good many fairies about, all too busy to notice him;	なぜなら周りにたくさんの素敵な妖精たちがいましたが、みんな忙しそうにしていて、ピーターに気づかなかったからでした。
they were getting breakfast ready, milking their cows, drawing water, and so on,	妖精たちは、朝食の準備をしたり、牛の乳をしぼったり、水を汲んできたりしていました。
and the sight of the water-pails made him thirsty, so he flew over to the Round Pond to have a drink.	何杯ものバケツに水が入っているのをみて、ピーターはのどが乾き、水を飲むために丸い池まで飛んでいきました。
He stooped, and dipped his beak in the pond;	ピーターはかがんで、くちばしを池の水につけました。
he thought it was his beak, but, of course, it was only his nose,	ピーターはくちばしだと思ってましたが、もちろん鼻でした。
and, therefore, very little water came up,	だからほとんど水は飲めませんでした。
and that not so refreshing as usual, so next he tried a puddle, and he fell flop into it.	そして水はいつものようにそれほどきれいではなかったので、次にピーターは水たまりを試してみましたが、ドボンと落っこちてしまいました。
When a real bird falls in flop, he spreads out his feathers and pecks them dry, but Peter could not remember what was the thing to do, and he decided, rather sulkily, to go to sleep on the weeping beech in the Baby Walk.	本物の鳥が落っこちたら、羽を広げて、くちばしでついばんでかわかすのでしたが、ピーターはどうしてよいかわからなかったので、すごく不機嫌になって、赤ん坊の道にある枝が垂れ下がっているブナの木にとまって寝ることにしたのでした。
At first he found some difficulty in balancing himself on a branch, but presently he remembered the way, and fell asleep.	最初のうちは枝の上でどうにもバランスが取れなかったのですが、すぐにバランスの取り方を思い出し、眠りにつきました。
He awoke long before morning, shivering,	夜明け前に目を覚ますと、ぶるっと身を震わして
and saying to himself,	「こんな寒い夜に外で過ごしたことはないなぁ」
"I never was out in such a cold night;"	とひとりごとを言いました。
he had really been out in colder nights when he was a bird, but, of course, as everybody knows, what seems a warm night to a bird is a cold night to a boy in a nightgown.	本当は鳥だった頃に、もっと寒い夜を外で過ごしたこともあったのですが、みなさんご存じの通り、鳥にとっては暖かに思える夜でも、ねまきだけの子供にとっては寒い夜なのです。
Peter also felt strangely uncomfortable, as if his head was stuffy,	ピーターはまた、頭が重いみたいでなんとなく落ち着かない感じがしました。
he heard loud noises that made him look round sharply, though they were really himself sneezing.	大きな音を耳にして、あたりをすばやく見まわしましたが、それは実際には自分のくしゃみでした。
There was something he wanted very much,	ピーターには、とっても欲しいものがありました。
but, though he knew he wanted it, he could not think what it was.	でも欲しいことは分かっていたのに、何が欲しいのかまではわかりません。
What he wanted so much was his mother to blow his nose, but that never struck him, so he decided to appeal to the fairies for enlightenment.	とっても欲しかったのは、鼻をかんでくれるお母さんでしたが、ピーターに思い浮かぶはずもなかったので、教えてくれるように妖精にお願いすることにしました。
They are reputed to know a good deal.	妖精が良い知恵を持っていることは、知られていることです。
There were two of them strolling along the Baby Walk, with their arms round each other's waists, and he hopped down to address them.	赤ん坊の道には、お互いの腰に手を回してぶらぶらしている２人の妖精がいたので、ピーターは話しかけるためにひょいと飛び出ました。
The fairies have their tiffs with the birds, but they usually give a civil answer to a civil question,	妖精というものは鳥とはちょっといざこざがあるものですが、ふつうは礼儀正しい質問をすれば、きちんとした返事をしてくれます。
and he was quite angry when these two ran away the moment they saw him.	なので、目があった瞬間に２人とも逃げ出したとき、ピーターはかんかんに怒りました。
Another was lolling on a garden-chair, reading a postage-stamp which some human had let fall, and when he heard Peter's voice he popped in alarm behind a tulip.	別の妖精ときたら、公園の椅子に腰掛けて人間が落としていった切手を見ていたのですが、ピーターの声を聞いたとたん、驚いてチューリップの向こうにひょいと隠れてしまいました。
To Peter's bewilderment he discovered that every fairy he met fled from him.	ピーターが戸惑ったことに、出会う妖精、出会う妖精がみんな自分の前から逃げてしまうのでした。
A band of workmen, who were sawing down a toadstool, rushed away, leaving their tools behind them.	毒きのこを切り倒していた一団の妖精は道具をおいて逃げ出してしまいましたし、
A milkmaid turned her pail upside down and hid in it.	乳搾りをしていた妖精はバケツをひっくり返してその中に隠れてしまう始末です。
Soon the Gardens were in an uproar.	やがて公園は大騒ぎになりました。
Crowds of fairies were running this way and that, asking each other stoutly, who was afraid, lights were extinguished, doors barricaded,	妖精たちの群はあちらこちらへ駆けまわり、だれが恐がってるの？と大声で尋ねあいながら、明かりをけし、ドアにバリケードを築くありさまでした。
and from the grounds of Queen Mab's palace came the rubadub of drums, showing that the royal guard had been called out.	マブ女王の宮殿の広場ではドンドンと太鼓が打ち鳴らされ、それは王宮の警備員が召集されたしるしでした。
A regiment of Lancers came charging down the Broad Walk, armed with holly-leaves, with which they jog the enemy horribly in passing.	騎兵の連隊が、すれ違うときには敵にしっかりつきささるようにセイヨウヒイラギの葉で身を固め、広い道へ突撃してきました。
Peter heard the little people crying everywhere that there was a human in the Gardens after Lock-out Time,	子供の妖精が、あちこちで「門が閉まったのにまだ人がいるんだよ」と大声をだしているのをピーターは耳にしました。
but he never thought for a moment that he was the human.	でも一瞬たりとて自分が人間だとは考えたこともなかったので、
He was feeling stuffier and stuffier, and more and more wistful to learn what he wanted done to his nose,	だんだん混乱して、どうしたらいいか全然わかりません。
but he pursued them with the vital question in vain;	妖精に聞いてみようと後をつけてまわりましたが、むだでした。
the timid creatures ran from him, and even the Lancers, when he approached them up the Hump, turned swiftly into a side-walk, on the pretence that they saw him there.	臆病な生き物の妖精はピーターから逃げ回り、「あっちでピーターを見かけたぞ」なんてうそをついて、騎兵隊でさえピーターが丘に登ると、あわてて歩道へ引き返すしまつでした。
Despairing of the fairies, he resolved to consult the birds,	ピーターは妖精に相談することはあきらめて、鳥に相談することにしました。
but now he remembered, as an odd thing, that all the birds on the weeping beech had flown away when he alighted on it,	ただあのブナに止まっていた鳥がみんな、ピーターが枝に降り立ったとき飛び去ってしまったことを珍しいことに思い出したのでした。
and though that had not troubled him at the time, he saw its meaning now.	その時はなんのことかわからなかったのでしたが、いまやっとその意味がわかりました。
Every living thing was shunning him.	生き物はみな彼を避けているのです。
Poor little Peter Pan, he sat down and cried, and even then he did not know that, for a bird, he was sitting on his wrong part.	かわいそうにちっちゃなピーターパンは、そうと知らなかったとはいえ、鳥としてはおかしな場所に座りこんで泣いているのに気づきもしませんでした。
It is a blessing that he did not know, for otherwise he would have lost faith in his power to fly,	気づかなかったのは幸いなことです、というのも気づいていたら飛べるという自信をなくしていたでしょうから。
and the moment you doubt whether you can fly, you cease forever to be able to do it.	飛べるかどうか疑いを持ったときは、もう永遠に飛べなくなってしまっているものなのです。
Now, except by flying, no one can reach the island in the Serpentine,	さて、飛ぶ以外には、サーペンタイン池の島までたどり着く方法はありません。
for the boats of humans are forbidden to land there,	なぜなら人間たちのボートはそこに横づけすることを禁止されていたからです。
and there are stakes round it, standing up in the water, on each of which a bird-sentinel sits by day and night.	島の周りには水中にくいが打たれており、そのひとつひとつに見張りの鳥がそれぞれ一
It was to the island that Peter now flew to put his strange case before old Solomon Caw,	ピーターは、その島へ自分のいっぷう変わった問題を老ソロモン・コーに相談するために飛んでいったのでした。
and he alighted on it with relief,	ピーターはその島に降り立って、ほっとしました。
much heartened to find himself at last at home, as the birds call the island.	鳥たちがその島を呼ぶように、ついに我が家に帰ってきたようでとても元気づけられたのです。
All of them were asleep, including the sentinels, except Solomon,	鳥たちは見張り番までみんな、ソロモンを除いて眠っていました。
who was wide awake on one side, and he listened quietly to Peter's adventures, and then told him their true meaning.	ソロモンは、島の一方の側で目をさましており、静かにピーターの冒険に耳をかたむけ、冒険の本当の意味をピーターに語るのでした。
"Look at your night-gown, if you don't believe me,"	「わしのいう事を疑うのなら、おまえのねまきをみてごらん」
Solomon said, and with staring eyes Peter looked at his nightgown, and then at the sleeping birds.	ソロモンは言いました、そしてピーターはまず自分のねまきを、それから寝ている他の鳥たちをじっと見つめました。
Not one of them wore anything.	鳥たちはもちろんなにも着てはいません。
"How many of your toes are thumbs?"	「おまえの足の指の何本が親指かい？」
said Solomon a little cruelly, and Peter saw to his consternation, that all his toes were fingers.	ソロモンはちょっと意地悪にそう言いました、そしてピーターは見て、びっくりぎょうてんしてしまいました、なんせ自分の足の指はすべて手の指と同じだったんですから。
The shock was so great that it drove away his cold.	あんまりびっくりぎょうてんしたので、寒さをすっかり忘れるほどでした。
"Ruffle your feathers,"	「おまえの羽毛を逆立てみなさい」
said that grim old Solomon, and Peter tried most desperately hard to ruffle his feathers, but he had none.	情け容赦なく老ソロモンは続けました、ピーターは必死になって羽毛を逆立てようとしましたが、羽毛がないのでした。
Then he rose up, quaking, and for the first time since he stood on the window-ledge, he remembered a lady who had been very fond of him.	それからふるえながら立ちあがって、窓棚の所に立ってから初めて、自分のことを大事にしてくれたお母さんを思い出しました。
"I think I shall go back to mother,"	「お母さんの所に帰ろうかな？」
he said timidly.	おずおずとピーターは言いました。
"Good-bye,"	「それではさらばじゃな」
replied Solomon Caw with a queer look.	なんともいえない表情でソロモン・コーは答えました。
But Peter hesitated.	でもピーターはためらっていました。
"Why don't you go?"	「いかないのか？」
the old one asked politely.	老ソロモンは親切にそうたずねました。
"I suppose,"	「僕は、」
said Peter huskily,	ピーターはかすれた声で言いました。
"I suppose I can still fly?"	「僕はまだ飛べるかな？」
You see, he had lost faith.	ほら、ピーターときたら自信をなくしてしまったのでした。
"Poor little half-and-half,"	「かわいそうな、半分鳥で半分人の子供よ」
said Solomon, who was not really hard-hearted,	ソロモンは言いました、本当は冷酷無情というわけではなかったのでした。
"you will never be able to fly again, not even on windy days.	「もう二度と飛べないよ、風が強い日でもな。
You must live here on the island always."	おまえはずっとここで暮らしていかなきゃならん」
"And never even go to the Kensington Gardens?"	「ケンジントン公園にもいけないの？」
Peter asked tragically.	ピーターは、悲しみにうちひしがれてたずねました。
"How could you get across?"	「どうやってここを渡っていくというんだ？」
said Solomon.	ソロモンは言うと、
He promised very kindly, however,	しかしとてもやさしくこう約束しました。
to teach Peter as many of the bird ways as could be learned by one of such an awkward shape.	こんなかわった姿のピーターでも学べるような多くの鳥たちの方法を教えてやるよと。
"Then I sha'n't be exactly a human?"	「じゃあ僕はちゃんとした“人”にはなれないんだね」
Peter asked.	ピーターはたずねました。
"No."	「ああ」
"Nor exactly a bird?"	「ちゃんとした“鳥”にも」
"No."	「ああ」
"What shall I be?"	「何になるの？」
"You will be a Betwixt-and-Between,"	「どっちつかずになるんだろうな」
Solomon said,	ソロモンはそう答えました。
and certainly he was a wise old fellow,	確かにソロモンはかしこい年寄りでした。
for that is exactly how it turned out.	というのもまさにその通りであることが後に分かったのでした。
The birds on the island never got used to him.	その島の鳥たちは、決してピーターに慣れませんでした。
His oddities tickled them every day,	ピーターの変わった行動が鳥たちを毎日刺激したのです。
as if they were quite new,	まるで鳥たちが全く新しくなっているかのように。
though it was really the birds that were new.	現に鳥たちは新しくなっているのでした。
They came out of the eggs daily, and laughed at him at once, then off they soon flew to be humans,	つまり鳥たちは日々たまごから生まれてきて、すぐにピーターに笑いかけて、それから人間になるためすぐに飛び立つのでした。
and other birds came out of other eggs, and so it went on forever.	そして他の鳥たちが他のたまごから生まれてきて、と永遠に続いていくのです。
The crafty mother-birds, when they tired of sitting on their eggs, used to get the young one to break their shells a day before the right time by whispering to them	ずる賢い母親の鳥たちときたら、たまごを温めるのが退屈になると、こんなことをたまごのなかの鳥にささやいて、生まれる日より１日はやく殻を破るようにさせるのでした。
that now was their chance to see Peter washing or drinking or eating.	「ピーターが手を洗ってるところや、飲み物を飲んでるところや、食べてるところを見るには今がチャンスだよ」なんて言うのです。
Thousands gathered round him daily to watch him do these things, just as you watch the peacocks,	何千という鳥たちが日々ピーターの周りに集まって、まるであなたが孔雀を見守るように、ピーターのしている事を見守るのでした。
and they screamed with delight when he lifted the crusts they flung him with his hands instead of in the usual way with the mouth.	そして鳥たちがピーターに運んできたパンの耳を、普通そうするように口ではなくて両手で拾い上げようものなら、大喜びで歓声を上げるのでした。
All his food was brought to him from the Gardens at Solomon's orders by the birds.	ピーターの食べ物は、全部公園からソロモンの命令によって鳥たちが運んできました。
He would not eat worms or insects (which they thought very silly of him), so they brought him bread in their beaks.	ピーターは、ミミズや昆虫は食べなかったので（このことも鳥達はバカにしていましたが）、くちばしにパンをくわえて持ってきたのでした。
Thus, when you cry out, "Greedy! Greedy!" to the bird that flies away with the big crust, you know now that you ought not to do this,	だから大きなパンの耳をもって飛び去って行く鳥に対して「よくばり、よくばり」なんて叫ぶのは、そんなことをするべきじゃないと今はお分かりでしょう。
for he is very likely taking it to Peter Pan.	なぜならたぶんその鳥は、パンの耳をピーターパンのところに持って行っているのでしょうから。
Peter wore no night-gown now.	ピーターは、もうねまきを着ていませんでした。
You see, the birds were always begging him for bits of it to line their nests with, and, being very good-natured, he could not refuse, so by Solomon's advice he had hidden what was left of it.	ごぞんじのように鳥たちは巣をつくるためにねまきの端切れをいつもせがみましたし、ピーターも人が良くて断ることができなかったので、ソロモンのアドバイスに従って、ねまきの端切れの残りを隠してしまったのでした。
But, though he was now quite naked, you must not think that he was cold or unhappy.	ピーターはすっぽんぽんでしたが、寒いだろうなとか不幸なのでは？と考えるのは間違っています。
He was usually very happy and gay,	ピーターは、いつもとても幸せで陽気でした。
and the reason was that Solomon had kept his promise and taught him many of the bird ways.	というのもソロモンが約束を守って、ピーターに鳥のやり方をいろいろ教えてくれたからでした。
To be easily pleased, for instance, and always to be really doing something, and to think that whatever he was doing was a thing of vast importance.	例えば、すぐに喜ぶこととか、いつもちゃんとなにかをしていること、そして何をしていてもそのことこそがとても重要なことだと考えることを教えてくれました。
Peter became very clever at helping the birds to build their nests;	ピーターは、鳥たちが巣を作るのを手伝うのがとても上手になりました。
soon he could build better than a wood-pigeon, and nearly as well as a blackbird, though never did he satisfy the finches,	すぐにハトをはるかに追い越して、クロウタドリとほとんど同じくらい、でもちいさな鳥たちはどうしても満足させられませんでした。
and he made nice little water-troughs near the nests and dug up worms for the young ones with his fingers.	そして巣の近くに便利な小さな水桶をいくつか作ったり、小鳥のために指を使ってミミズを掘り起こしたりしてやりました。
He also became very learned in bird-lore, and knew an east-wind from a west-wind by its smell,	ピーターは鳥の伝承（文字に残らない歴史）にも詳しくなりましたし、風のにおいで東風と西風の区別がつきました。
and he could see the grass growing and hear the insects walking about inside the tree-trunks.	ピーターは草が伸びるのを見たり、虫が木の幹の中を歩くのを聞いたりできました。
But the best thing Solomon had done was to teach him to have a glad heart.	でもソロモンのしてくれたことで一番よかったことは、喜ぶ心を持つことをピーターに教えてくれたことでした。
All birds have glad hearts unless you rob their nests,	全ての鳥は、巣を盗まれでもしない限り、喜ぶ心を持っているものです。
and so as they were the only kind of heart Solomon knew about, it was easy to him to teach Peter how to have one.	とはいっても、ソロモンが知っているのは喜ぶ心だけでしたから、ピーターにどうやって喜ぶ心をもてばいいか教えるのは簡単なことでした。
Peter's heart was so glad that he felt he must sing all day long, just as the birds sing for joy,	ピーターの心は喜びに満ちていて、鳥たちが楽しむために歌うように、一日中でも歌ってなければならないように感じたのでした。
but, being partly human, he needed in instrument,	でもまだ少し人の部分もあったので、楽器がほしいと思ってあしで笛を作りました。
so he made a pipe of reeds, and he used to sit by the shore of the island of an evening,	そしてよく夕方には、島の波打ちぎわにこしかけていたものでした。
practising the sough of the wind and the ripple of the water, and catching handfuls of the shine of the moon, and he put them all in his pipe	ヒュウヒュウとなる風の音や打ち寄せる波の音を練習して、月の光を一握りつかんで、そんなものをすべて笛の音にこめたのでした。
and played them so beautifully that even the birds were deceived, and they would say to each other,	その笛の音はとっても美しい調べだったので、鳥たちでさせすっかりだまされて、お互いにこうささやきあいました。
"Was that a fish leaping in the water or was it Peter playing leaping fish on his pipe?"	「魚が水で飛び跳ねたのかしら、それともピーターが笛で真似してるのかしら？」
and sometimes he played the birth of birds, and then the mothers would turn round in their nests to see whether they had laid an egg.	ときどき鳥の生まれた音を笛で真似したりするので、母親たちときたらたまごが生まれちゃったかしらときびすを返して巣にもどるくらいでした。
If you are a child of the Gardens you must know the chestnut-tree near the bridge,	もしあなたがケンジントン公園で育った子供なら、あの橋のそばのクリの木をご存知でしょう。
which comes out in flower first of all the chestnuts,	そしてそのクリの木が公園のどんなクリの木よりも早く花をつけることも知っているでしょう。
but perhaps you have not heard why this tree leads the way.	でもその理由までは、聞いたことがないと思います。
It is because Peter wearies for summer and plays that it has come, and the chestnut being so near, hears him and is cheated.	ピーターが夏をまちわびて、夏がきたよなんて笛をふくので、一番近くにあるそのクリの木が笛を聞いてだまされてしまうのでした。
But as Peter sat by the shore tootling divinely on his pipe he sometimes fell into sad thoughts	でもピーターが波打ち際に座って素晴らしい笛の音を奏でると、ふと物寂しくなりました。
and then the music became sad also,	すると笛の音も寂しそうに響くのです。
and the reason of all this sadness was that he could not reach the Gardens, though he could see them through the arch of the bridge.	寂しくなるわけは、橋のアーチの間から向こうにケンジントン公園が見えるにもかかわらず、そこへは決してたどり着けないからでした。
He knew he could never be a real human again, and scarcely wanted to be one, but oh, how he longed to play as other children play,	ピーターはもう自分が本当の人になれないのは分かっていましたし、なりたいとも思っていませんでしたが、でもどんなに他の子供たちのように遊びたいと思っていたことでしょう。
and of course there is no such lovely place to play in as the Gardens.	そして実際にケンジントン公園ほど遊んで楽しい場所も他にはなかったことでしょう。
The birds brought him news of how boys and girls play, and wistful tears started in Peter's eyes.	鳥たちが、男の子や女の子たちがどんな風に遊んでいたかピーターに知らせてくれると、悲しさのあまりピーターの目には涙が浮かぶのでした。
Perhaps you wonder why he did not swim across.	たぶん、泳いでわたればいいのになんてお思いになるかもしれません。
The reason was that he could not swim.	ピーターは泳げませんでした。
He wanted to know how to swim, but no one on the island knew the way except the ducks,	ピーターは泳ぎ方を習いたいと思いましたが、その島ではアヒルのほかには泳ぎ方を知っているものはいませんでした。
and they are so stupid.	アヒルはすこし頭がたりなくて、
They were quite willing to teach him, but all they could say about it was,	泳ぎ方をピーターにすごく熱心に教えようとしましたが、いう事ときたら
"You sit down on the top of the water in this way, and then you kick out like that."	「こういう風に水の上にすわって、こんな風に水をけるのよ」なんてことだけでした。
Peter tried it often, but always before he could kick out he sank.	ピーターは何度も試してみましたが、けるまえに沈んでしまうのでした。
What he really needed to know was how you sit on the water without sinking, and they said it was quite impossible to explain such an easy thing as that.	ピーターが本当に学ばなければならなかったのは、沈まずに水の上ですわっていられる方法でしたが、アヒルたちが言うにはそんな簡単なことは説明できないよ、といった具合でした。
Occasionally swans touched on the island, and he would give them all his day's food and then ask them how they sat on the water, but as soon as he had no more to give them the hateful things hissed at him and sailed away.	ときどき白鳥たちが島に近づいてきたときに、ピーターはその日の食べ物を全て差しだして、どうして水の上ですわっていられるのかたずねたのですが、あげられる食べ物がなくなるとすぐに、そのいやなやつらはピーターを追い払って、泳いで行ってしまうのでした。
Once he really thought he had discovered a way of reaching the Gardens.	ピーターは、前にケンジントン公園へ行く方法を見つけたなんて思ったことがありました。
A wonderful white thing, like a runaway newspaper, floated high over the island and then tumbled, rolling over and over after the manner of a bird that has broken its wing.	風に舞う新聞紙のような不思議な白いものが島の空高くに浮かんでおり、それから羽が折れた鳥のように何度も回転して落下したのでした。
Peter was so frightened that he hid,	ピーターは、とっても驚いたので身を隠しました。
but the birds told him it was only a kite, and what a kite is, and that it must have tugged its string out of a boy's hand, and soared away.	ただ鳥たちがピーターに、それはたこというもので、どういうものか、そしてたこは男の子の手から糸が強く引っ張られて舞いあがったにちがいないことを教えてくれました。
After that they laughed at Peter for being so fond of the kite,	そういい終わった後も、ピーターがたこをとても気に入ったのを鳥たちは笑いました。
he loved it so much that he even slept with one hand on it,	ピーターはたこが大好きで、寝る時もたこの上に片手をおくほどでした。
and I think this was pathetic and pretty,	私が思うには、これは痛ましくもかわいらしい話なのです。
for the reason he loved it was because it had belonged to a real boy.	なぜならピーターは、たこが本当の男の子のものだからこそ大好きだったのですから。
To the birds this was a very poor reason,	鳥たちにとっては、こんなことはばかばかしい理由でした。
but the older ones felt grateful to him at this time because he had nursed a number of fledglings through the German measles,	ただ年とった鳥たちは、この時ピーターが風疹にかかった若鳥を手厚く看病したので感謝の念を抱いていたのでした。
and they offered to show him how birds fly a kite.	そして鳥たちは、ピーターにたこを飛ばす方法を見せてあげるよと申し出ました。
So six of them took the end of the string in their beaks and flew away with it;	６羽の鳥が糸の端をくちばしでもって飛び立ちました。
and to his amazement it flew after them and went even higher than they.	ピーターはびっくりぎょうてんしたのですが、たこは鳥たちのあとを飛び立ち、鳥たちよりももっと高く舞いあがったのでした。
Peter screamed out,	ピーターはさけびました。
"Do it again!"	「もう一度やって！」
and with great good nature they did it several times,	鳥たちはとっても親切だったので、何回もやってあげました。
and always instead of thanking them he cried,	そして毎回ピーターは感謝するかわりにこうさけぶのでした。
"Do it again!"	「もう一度やって！」
which shows that even now he had not quite forgotten what it was to be a boy.	このことは、今でもピーターが子供であるってことはどういうことなのか、完全には忘れてしまっていないことを示しています。
At last, with a grand design burning within his brave heart, he begged them to do it once more with him clinging to the tail,	とうとうピーターの勇敢な心にすばらしい計画がうかび、鳥たちにピーターをたこのしっぽにくっつけてもう一回飛ばしてくれるように頼みました。
and now a hundred flew off with the string,	そして百羽もの鳥が糸を持って飛び立ちました。
and Peter clung to the tail,	ピーターはしっぽにくっついていました。
meaning to drop off when he was over the Gardens.	ケンジントン公園の上にきたら降りるつもりでした。
But the kite broke to pieces in the air,	でもたこが空中でばらばらになってしまいました。
and he would have drowned in the Serpentine had he not caught hold of two indignant swans and made them carry him to the island.	２羽の白鳥がぷんぷん怒りながらもピーターを捕まえて、島まで連れていってくれなかったなら、ピーターはサーペンタイン池でおぼれてしまったことでしょう。
After this the birds said that they would help him no more in his mad enterprise.	これ以降、鳥たちはピーターの頭のおかしい企みには力を貸すつもりはないよと言い放ちました。
Nevertheless, Peter did reach the Gardens at last by the help of Shelley's boat,	でもピーターは、シェリーのボートの助けをかりてケンジントン公園にたどり着くのでした。
as I am now to tell you.	これからそのてんまつをお話することにしましょう。
The Thrush's Nest	２章 つぐみの巣
Shelley was a young gentleman and as grown-up  as he need ever expect to be.	シェリーは年若き紳士で、もうすっかり大人といってもいいくらいの年でした。
He was a poet;	ただ詩人なので、
and they are never exactly grown-up.	決して本当の大人にはなれませんでした。
They are people who despise money except what you need for to-day,	詩人というものは今日一日、まさに一日必要なだけのお金以外はすっかりバカにしているものです。
and he had all that and five pounds over.	シェリーときたら、一日に必要な分に５ポンドも余していたので、
So, when he was walking in the Kensington Gardens, he made a paper boat of his bank-note, and sent it sailing on the Serpentine.	ケンジントン公園を散歩しているとき、持っている紙幣で紙のボートを作って、サーペンタイン池に浮かべたのでした。
It reached the island at night:	そのボートは、夜に島までやって来ました。
and the look-out brought it to Solomon Caw,	見張りが、それをソロモン・コーに知らせます。
who thought at first that it was the usual thing,	ソロモンは、最初いつものやつだなと思いました。
a message from a lady, saying she would be obliged if he could let her have a good one.	いつものやつというのは、女の人からのよい子供を授けてくれたらとてもうれしいんですが、という手紙のことです。
They always ask for the best one he has,	女の人ときたら、いつでもソロモンのところの一番いい子供を望むのです。
and if he likes the letter he sends one from Class A,	もしソロモンがその手紙を気に入ると、Ａクラスの子供を送り届けるといった具合でした。
but if it ruffles him he sends very funny ones indeed.	でもいらいらさせるような手紙だと、ふうがわりな子供を送り届けるのです。
Sometimes he sends none at all, and at another time he sends a nestful;	時々は一人も送らないこともあれば、別の時には巣一杯の子供を送り届けます。
it all depends on the mood you catch him in.	全てあなたの手紙が、ソロモンをどんな気分にするかにかかっているのです。
He likes you to leave it all to him, and if you mention particularly that you hope he will see his way to making it a boy this time, he is almost sure to send another girl.	ソロモンは、全部を自分に任せてもらうのが好きなので、もし今度は男の子を送り届けてほしいなんて細かく書いたりすると、代わりに女の子を送り届けること確実です。
And whether you are a lady or only a little boy who wants a baby-sister, always take pains to write your address clearly.	そしてあなたが女の人でも、あるいは妹が欲しい男の子でも、いつもちゃんと住所を書くようにしてください。
You can't think what a lot of babies Solomon has sent to the wrong house.	ソロモンが、どれほど多くの赤ん坊を間違った家に届けるか想像もつかないくらいです。
Shelley's boat, when opened, completely puzzled Solomon, and he took counsel of his assistants,	折りたたまれているシェリーのボートを開いてみても、ソロモンには全く何なのかわからなかったので助手たちに相談しました。
who having walked over it twice, first with their toes pointed out, and then with their toes pointed in,	助手たちは、一回目はつま先を開いて、２回目はつま先を閉じて、その上を歩きました。
decided that it came from some greedy person who wanted five.	そしてこれは５人も子供が欲しいという欲張りなやからがよこしたんだ、と結論づけたのです。
They thought this because there was a large five printed on it.	どうしてそう思ったかといえば、その紙幣には大きく５と印刷されていましたから。
"Preposterous!"	「ばかもの！」
cried Solomon in a rage, and he presented it to Peter;	ソロモンはカンカンに怒って、ピーターに紙幣をくれてやりました。
anything useless which drifted upon the island was usually given to Peter as a play-thing.	島に流れ着いた役にたたないものは、いつもピーターのおもちゃとして与えられるのでした。
But he did not play with his precious bank-note,	でもピーターは、この大事な紙幣を遊び道具にはしませんでした。
for he knew what it was at once, having been very observant during the week when he was an ordinary boy.	というのも、普通の子供だった一週間の間に注意深くみていたので、これが何かはちゃんと分かっていたのです。
With so much money, he reflected, he could surely at last contrive to reach the Gardens,	こんなにお金を持っていて、その上ピーターはよく考えたので、とうとう公園までたどりつくことができたのです。
and he considered all the possible ways, and decided (wisely, I think) to choose the best way.	ピーターはいろいろな方法を考えて、もっともいい方法を選びました（とても賢いですね）。
But, first, he had to tell the birds of the value of Shelley's boat;	でも最初に鳥たちにシェリーのボートの価値を言わなければなりません。
and though they were too honest to demand it back, he saw that they were galled,	鳥たちは正直者で紙幣を返しておくれとは言いませんでしたが、ピーターは鳥たちが悔しがっているのが分かりました。
and they cast such black looks at Solomon, who was rather vain of his cleverness, that he flew away to the end of the island, and sat there very depressed with his head buried in his wings.	そして自分の賢さを自慢していたソロモンを軽蔑したような目でみたので、ソロモンは島の隅の方に飛んでいって、羽に頭をうずめてしょんぼり座りこんでしまいました。
Now Peter knew that unless Solomon was on your side, you never got anything done for you in the island, so he followed him and tried to hearten him.	でもピーターはソロモンが味方になってくれなければ、この島ではなにもできないことを知っていたので、ソロモンのあとを追って励まそうとしたのでした。
Nor was this all that Peter did to pin the powerful old fellow's good will.	ピーターが力をもっている老ソロモンの好意を射止めようとして、やった事はこれだけではありません。
You must know that Solomon had no intention of remaining in office all his life.	あなたも知ってるように、ソロモンはそもそも一生仕事にあけくれるなんて夢にも思っていません。
He looked forward to retiring by-and-by, and devoting his green old age to a life of pleasure on a certain yew-stump in the Figs which had taken his fancy,	だんだんリタイアして、老年期はソロモンが大好きなイチジクの森にある、あのセイヨウイチイの切り株あたりで楽しい余生をおくりたいと夢見ていました。
and for years he had been quietly filling his stocking.	それで何年もの間、もくもくと靴下に蓄えをしていたのでした。
It was a stocking belonging to some bathing person which had been cast upon the island,	その靴下は水浴びをしていた人の持ち物で、その人が島の方へと投げ込んだものでした。
and at the time I speak of it contained a hundred and eighty crumbs, thirty-four nuts, sixteen crusts, a pen-wiper and a bootlace.	初めから靴下の中には１８０ものパンくず、３４の木の実、１６のパンの耳、万年筆のインクふき、そして靴ひも一本が入ったことは言っておきましょう。
When his stocking was full, Solomon calculated that he would be able to retire on a competency.	靴下が一杯になった時、ソロモンは収入の心配はしなくてもリタイアできるという計画を立てたのです。
Peter now gave him a pound.  He cut it off his bank-note with a sharp stick.	ピーターは、５ポンド紙幣を先の鋭いもので切り分けて、１ポンドをソロモンにあげました。
This made Solomon his friend for ever,	これでピーターとソロモンは生涯の友になりました。
and after the two had consulted together they called a meeting of the thrushes.	２人は一緒に相談して、つぐみの集会を呼びかけました。
You will see presently why thrushes only were invited.	どうしてつぐみだけに呼びかけたのかは、いずれおわかりになるでしょう。
The scheme to be put before them was really Peter's, but Solomon did most of the talking, because he soon became irritable if other people talked.	つぐみたちの前に持ち出された計画というのは、本当はピーターが考えたものでしたが、ソロモンは他人が話しているとすぐにいらいらし始めるので、ほとんどの部分をソロモン自身で説明しました。
He began by saying	ソロモンはこういう話からはじめました。
that he had been much impressed by the superior ingenuity shown by the thrushes in nest-building, and this put them into good-humour at once,	つぐみたちの巣作りの見事なことにわしはずっと感心してきたんだと、これはつぐみたちをたちまち上機嫌にさせました。
as it was meant to do;	もちろんそうするつもりで言ったことです。
for all the quarrels between birds are about the best way of building nests.	なぜ上機嫌になるかといえば、鳥たちの言いあらそいの原因は、いつも誰が一番巣を作るのが上手いかということなのです。
Other birds, said Solomon, omitted to line their nests with mud, and as a result they did not hold water.	ソロモンはこうも言いました。
Here he cocked his head as if he had used an unanswerable argument;	そしてソロモンは、反論は許さんとばかりにふんぞり返りました。
but, unfortunately, a Mrs. Finch had come to the meeting uninvited, and she squeaked out,	ただ、不運なことに、ちいさな鳥のご婦人が１匹紛れ込んでいてこう叫んだのです。
"We don't build nests to hold water, but to hold eggs,"	「わたしらは、水をためるためじゃなくて、卵を入れとくために巣を作りますけどね」
and then the thrushes stopped cheering, and Solomon was so perplexed that he took several sips of water.	つぐみたちはおしゃべりを止め、ソロモンは慌てふためいて何杯も水を飲む始末です。
"Consider,"	「考えてもみなさい」
he said at last,	やっとソロモンは口を開くと
"how warm the mud makes the nest."	「泥がどれほど巣を暖かくしてくれてることか」と言いました。
"Consider,"	「考えてもください、」
cried Mrs. Finch,	ちいさな鳥のご婦人は答えました。
"that when water gets into the nest it remains there and your little ones are drowned".	「巣の中に水が入ってたまったら、子供はおぼれてしまいます」
The thrushes begged Solomon with a look to say something crushing in reply to this,	つぐみたちは、ソロモンがこれを論破してくれるのを期待するような顔つきです。
but again he was perplexed.	でもソロモンは、またまた慌てふためいてしまいました。
"Try another drink,"	「もう一杯水をのんで」
suggested Mrs. Finch pertly.	ケイトと言う名前のちいさな鳥のご婦人は小生意気そうに言いました。
Kate was her name, and all Kates are saucy.	ケイトなんて名前の人は生意気って相場がきまってます。
Solomon did try another drink, and it inspired him.	ソロモンはもう一杯水を飲もうとして、ひらめきました。
"If," said he, "a finch's nest is placed on the Serpentine it fills and breaks to pieces,	「もしちいさな鳥のご婦人の巣をサーペンタイン池に置いたら、水浸しでばらばらになるよ。
but a thrush's nest is still as dry as the cup of a swan's back."	でもつぐみの巣ときたら、白鳥の背中にのったカップみたいにぬれることはない」
How the thrushes applauded!	どれほどつぐみたちが喜んだことでしょう！
Now they knew why they lined their nests with mud,	ようやくどうして自分たちが巣を泥でかためるかの理由が分かったのですから。
and when Mrs. Finch called out,	そしてちいさな鳥のご婦人が
"We don't place our nests on the Serpentine,"	「サーペンタイン池に巣を置くことなんてないわ」
they did what they should have done at first:	なんて叫んだときには、最初からそうすべきだったことをつぐみたちはしてのけました。
chased her from the meeting.	つまりちいさな鳥のご婦人を集会から追い払ったのです。
After this it was most orderly.	追い出した後は、整然と話は進みました。
What they had been brought together to hear, said Solomon, was this:	「君達にわざわざ集まって聞いてもらいたかったことは、こういうことなんだ」
their young friend, Peter Pan, as they well knew, wanted very much to be able to cross to the Gardens,	「きみたちの若き友人でもあるピーターパン君が、きみらもよくご存知だろうが、ケンジントン公園まで是が非でも池を渡ってｎいきたいということなんだよ」
and he now proposed, with their help, to build a boat.	だからつぐみたちに手伝ってもらって、ボートが作れないだろうかと申し出たのでした。
At this the thrushes began to fidget, which made Peter tremble for his scheme.	これを聞くとつぐみたちがそわそわしはじめましたので、ピーターは自分の計画が心配になりました。
Solomon explained hastily	ソロモンはあわてて自分の言ったことを説明しました。
that what he meant was not one of the cumbrous boats that humans use;	人間たちが使うようなかさばるボートじゃなくて、
the proposed boat was to be simply a thrush's nest large enough to hold Peter.	ピーターを乗せるのに十分なくらいの簡単なつぐみの巣を作りたいんだと。
But still, to Peter's agony, the thrushes were sulky.	でもまだピーターにとっては心配なことに、つぐみたちは不機嫌でした。
"We are very busy people,"	「わたしたちは忙しいですからね、」
they grumbled,	とぶつくさ言いました。
"and this would be a big job."	「大変な仕事です」
"Quite so,"	「そうだろうとも」
said Solomon,	ソロモンは言いました。
"and, of course, Peter would not allow you to work for nothing.	「もちろんピーターは、ただで働いてもらおうなんて思ってないよ。
You must remember that he is now in comfortable circumstances,	ピーターが、今とても裕福だという事を忘れてもらいたくないね。
Peter Pan authorises me to say	ピーターパンは私にこう発言することを許してくれたよ。
that you shall all be paid sixpence a day."	君たちみんな１日６ペンスもらえるとね」
Then all the thrushes hopped for joy,	そしてつぐみたちは全員、喜びのあまり飛び跳ねました。
and that very day was begun the celebrated Building of the Boat.	まさにその日から名高いボート作りが始まったのです。
All their ordinary business fell into arrears.	いつもの仕事は全部後回しです。
It was the time of year when they should have been pairing, but not a thrush's nest was built except this big one,	この時期は１年の内でちょうどつぐみがつがいになっているときでしたが、この大きな巣以外はひとつもつぐみの巣は作られませんでした。
and so Solomon soon ran short of thrushes with which to supply the demand from the mainland.	そしてソロモンのところでは、すぐに人間界からうけた注文をこなすつぐみが足りなくなりました。
The stout, rather greedy children, who look so well in perambulators but get puffed easily when they walk, were all young thrushes once,	頑丈でどちらかといえばがつがつ食べるような、乳母車の中では元気一杯で歩かせても息を切らさないような子供は、みんなかつて若いつぐみだったのです。
and ladies often ask specially for them.	女の人たちは、格別つぐみを欲しがるものです。
What do you think Solomon did?	ソロモンはどうしたと思います？
He sent over to the housetops for a lot of sparrows and ordered them to lay their eggs in old thrushes' nests	屋根の上にたくさんいるすずめたちに使いをやって、古いつぐみの巣でたまごを生むように命令しました。
and sent their young to the ladies and swore they were all thrushes!	そして女の人たちにすずめの子供を送りつけ、みんなつぐみだよと断言したのでした。
It was known afterward on the island as the Sparrows' Year,	のちになってこの島では、その年はすずめの年として知られるようになりました。
and so, when you meet, as you doubtless sometimes do, grown-up people who puff and blow as if they thought themselves bigger than they are,	あなたも、まるで自分が実際より年をとっていると考えていて、すぐ息を切らす大人に会ったことが、たしかに時々会うことでしょう。
very likely they belong to that year.	彼らはたぶん、その年に生まれたにちがいありません。
You ask them.	聞いてみてください。
Peter was a just master,	ピーターはきちんとした親方でした。
and paid his work-people every evening.	毎日夕方に給料を払いました。
They stood in rows on the branches, waiting politely while he cut the paper sixpences out of his bank-note,	つぐみたちは木の枝に一列になって礼儀正しく、ピーターが紙幣を６ペンスに切り分ける間、待っていました。
and presently he called the roll, and then each bird, as the names were mentioned, flew down and got sixpence.	そしてしばらくするとピーターが名簿を読み上げて、それぞれの鳥が自分の名前が呼ばれると降りてきて、６ペンスを持って飛んで行きました。
It must have been a fine sight.	それはそれは、すてきな光景だったに違いありません。
And at last, after months of labor, the boat was finished.	何ヶ月も働いた末に、ついにボートができあがりました。
Oh, the deportment of Peter as he saw it growing more and more like a great thrush's nest!	ええ、だんだん素晴らしいつぐみの巣みたいに大きくなっていくのを見ているピーターの態度といったら。
From the very beginning of the building of it he slept by its side, and often woke up to say sweet things to it,	ほんの少しばかりできたときから、ボートの横でねて、すぐ起きてはやさしい言葉をかけていました。
and after it was lined with mud and the mud had dried he always slept in it.	そして泥でかためられて、泥がすっかり乾いてからは、いつもボートの中で寝ていました。
He sleeps in his nest still,	ピーターは、今でもボートの中で寝ます。
and has a fascinating way of curling round in it,	背中をまげたかわいい姿で寝るのです。
for it is just large enough to hold him comfortably when he curls round like a kitten.	というのもボートは、ピーターが子猫のように丸まって入って、ちょうど快適という大きさですから。
It is brown inside, of course, but outside it is mostly green, being woven of grass and twigs,	ボートはもちろん中は茶色で、外は草と枝で編み上げられていて、ほとんど緑色でした。
and when these wither or snap the walls are thatched afresh.	草と枝が枯れたり折れたりすると、新しくふきかえるのでした。
There are also a few feathers here and there, which came off the thrushes while they were building.	あちらこちらに鳥の羽も編みこまれていますが、巣を作る時につぐみたちから抜けたものでしょう。
The other birds were extremely jealous and said	他の鳥たちはとってもやっかんでこう言いました。
that the boat would not balance on the water,	そのボートは水の中ではバランス悪いわね、なんて。
but it lay most beautifully steady;	ところが水に浮かべると見事に安定して浮かびました。
they said the water would come into it, but no water came into it.	他の鳥たちは水が入ってくるよなんて言いましたが、一滴も入ってきません。
Next they said that Peter had no oars, and this caused the thrushes to look at each other in dismay,	それからピーターはオールをもってないと言いましたが、これにはつぐみたちもお互いにうろたえて、顔を見合わせるだけでした。
but Peter replied that he had no need of oars, for he had a sail,	ただピーターは、僕にはオールはいらないよ、帆があるものと答えました。
and with such a proud, happy face he produced a sail which he had fashioned out of this night-gown,	ピーターは得意満面で、ねまきから作った帆を出してきました。
and though it was still rather like a night-gown it made a lovely sail.	そして帆は見方によってはねまきそのままでしたが、とにかく素敵な帆でした。
And that night, the moon being full, and all the birds asleep, he did enter his coracle (as Master Francis Pretty would have said) and depart out of the island.	そしてあの夜、満月で、全ての鳥が寝静まったころ、かご船（フランシス・プリティー坊ちゃんならそう呼んだことでしょう）に乗り込んで、島を離れたのでした。
And first, he knew not why, he looked upward, with his hands clasped,	そして最初になぜかは分かりませんが、上を見上げて両手を組みました。
and from that moment his eyes were pinned to the west.	そのとき、ピーターの目は西の方を見つめていました。
He had promised the thrushes to begin by making short voyages, with them to his guides,	ピーターは、つぐみたちに航海を始める時には案内をしてくれるように頼んでいました。
but far away he saw the Kensington Gardens beckoning to him beneath the bridge, and he could not wait.	けれども遠くのケンジントン公園が橋の下においでと誘っているような気がしたので、待っていられなかったのです。
His face was flushed, but he never looked back;	ピーターの顔は紅潮していましたが、振り返りませんでした。
there was an exultation in his little breast that drove out fear.	ピーターが小さく吐く息は喜びで一杯で、恐怖を吹き飛ばしてしまいました。
Was Peter the least gallant of the English mariners who have sailed westward to meet the Unknown?	なんといってもピーターは、未知なるものを目指して西に向かったイギリスの勇敢な船乗りの末裔ですから。
At first, his boat turned round and round, and he was driven back to the place of his starting,	最初、ピーターのボートはくるくる回って、スタートした場所に流されて戻ってしまいました。
whereupon he shortened sail, by removing one of the sleeves,	そこでそでの片方を取り去って、帆をたたみました。
and was forthwith carried backward by a contrary breeze,	するとすぐに具合の悪い風がふき、後向きに運ばれてしまいました。
to his no small peril.	ピーターにとってはかなり危険なことです。
He now let go the sail, with the result that he was drifted toward the far shore,	そこで帆をあげると、岸から遠くのほうへ運ばれて行きました。
where are black shadows he knew not the dangers of, but suspected them, and so once more hoisted his night-gown	そちらの方には暗闇が広がっており、ピーターは暗闇が危険なものではないことを知っていましたが、かなり危ないとは思ったので、もう一回ねまきの帆を高くあげました。
and went roomer of the shadows until he caught a favouring wind, which bore him westward,	そして暗闇から遠ざかり、よい風をうけ、ピーターは西の方へと運ばれていきました。
but at so great a speed that he was like to be broke against the bridge.	ただスピードがのりすぎて、橋に激しくぶつかるところでした。
Which, having avoided, he passed under the bridge and came, to his great rejoicing, within full sight of the delectable Gardens.	衝突をさけて橋の下をくぐると、ピーターにはうれしかったことに、公園の美しい光景が一望できる場所へやってきました。
But having tried to cast anchor, which was a stone at the end of a piece of the kite-string, he found no bottom,	錨、それはたこの糸のはしに石を結んだものでした、を下ろそうとしましたが、池の底までとどきません。
and was fain to hold off, seeking for moorage, and, feeling his way, he buffeted against a sunken reef that cast him overboard by the greatness of the shock,	そして岸から離れたところで、停泊する場所を探したのですが、手探りで進んで、海底の暗礁にぶつかり、その大きなショックで船の外に投げ出されてしまいました。
and he was near to being drowned, but clambered back into the vessel.	ピーターは溺れかけましたが、ようやくよじ登って船に戻りました。
There now arose a mighty storm, accompanied by roaring of waters,	そこに今度は強い嵐がおこって、波がとどろく音がしました。
such as he had never heard the like, and he was tossed this way and that, and his hands so numbed with the cold that he could not close them.	ピーターは、そんな音を聞いたことがありませんでしたし、あちらこちらへと揺られ、両手は寒さで凍えて、握りしめることもできませんでした。
Having escaped the danger of which, he was mercifully carried into a small bay,	その危険からようやく逃れると、ピーターは幸運にも小さな港に運ばれて行きました。
where his boat rode at peace.	小さな港でピーターのボートは落ち着いて停泊することができました。
Nevertheless, he was not yet in safety;	けれどもピーターは、まだまだ安心というわけにはいきません。
for, on pretending to disembark, he found a multitude of small people drawn up on the shore to contest his landing;	なぜならピーターが上陸しようとすると、岸のところに小さな姿が列になって、ピーターが上陸するのを妨げようとしましたから。
and shouting shrilly to him to be off, for it was long past Lock-out Time.	そしてピーターに向かって甲高い声で、もう閉門の時間はとっくに過ぎたからあっちに行け、と叫ぶのです。
This, with much brandishing of their holly-leaves, and also a company of them carried an arrow which some boy had left in the Gardens,	ひいらぎの葉を振りまわすものもいれば、その上に男の子が公園に忘れて行った矢を持ってくる一団もいました。
and this they were prepared to use as a battering-ram.	その矢を、城を打ち壊す棒のように使おうとしているのです。
Then Peter, who knew them for the fairies, called out that he was not an ordinary human and had no desire to do them displeasure, but to be their friend,	ピーターには、彼らが妖精であることがわかったので、自分がただの人間ではないこと、そして妖精を怒らせるようなことはするつもりがなく、妖精と友達になりたいということを大声で伝えました。
nevertheless, having found a jolly harbour, he was in no temper to draw off there-from, and he warned them if they sought to mischief him to stand to their harms.	でもピーターはよい港を探していて、ここから引き返すつもりはなかったので、もし妖精がピーターに危害を及ぼそうとしてるなら、ピーターもだまってないぞと妖精に警告したのでした。
So saying; he boldly leapt ashore,	そういうと、ピーターは大胆にも岸へ飛び移りました。
and they gathered around him with intent to slay him, but there then arose a great cry among the women,	すると妖精たちは、ピーターをこらしめようと集まってきましたが、そのとき一団から、女の人たちがひときわ大きい声をあげました。
and it was because they had now observed that his sail was a baby's night-gown.	それは、ピーターの船の帆が赤ん坊のねまきであることに気づいたからでした。
Whereupon, they straightway loved him,	そうして女の人たちは、すぐさまピーターのことが好きになりました。
and grieved that their laps were too small,	そしてピーターをひざ枕するには、自分たちのひざがあまりに小さいのを残念がりました。
the which I cannot explain, except by saying that such is the way of women.	それが私には上手く言えませんが、女の人たちのやり方ということでしょう。
The men-fairies now sheathed their weapons on observing the behaviour of their women,	男の妖精たちは、女の人たちの様子をみて、刀をさやにおさめました。
on whose intelligence they set great store,	男の妖精たちは、女の人たちの聡明さを大事にしていたのです。
and they led him civilly to their queen,	そこで妖精たちは、ピーターを礼儀正しく妖精の女王のところに連れて行きました。
who conferred upon him the courtesy of the Gardens after Lock-out Time,	女王も丁寧に、ピーターに門が閉まった後も公園で過ごすことを認めてくれました。
and henceforth Peter could go whither he chose, and the fairies had orders to put him in comfort.	そしてピーターは行きたいところにはどこでも行くことができましたし、妖精たちはピーターに親切にするようにと女王に命令されたのです。
Such was his first voyage to the Gardens,	それが、ピーターの公園への最初の航海でした。
and you may gather from the antiquity of the language that it took place a long time ago.	そしてあなたは言葉が古めかしいので、ずっと昔のことだと思ったかもしれません。
But Peter never grows any older, and if we could be watching or him under the bridge to-night (but, of course, we can't), I daresay	ただピーターは決して年をとらないので、もし今夜ピーターを橋の下で見かけたとすると（もちろん、見かけないでしょうけど）私はあえてこういいたいのです。
we should see him hoisting his night-gown and sailing or paddling toward us in the Thrush's Nest.	ピーターがねまきの帆をかかげ、つぐみの巣にのって、私たちの方へ帆をあげたり、オールで漕いだりしてやってくるのをみることでしょうと。
When he sails, he sits down, but he stands up to paddle.	ピーターは帆で船を走らせている時は、腰をおろしていましたが、オールで漕ぐときには立ちあがるのです。
I shall tell you presently how he got his paddle.	わたしは、ピーターがどんな風にしてオールを手に入れたか、追ってお話しすることにしましょう。
Long before the time for the opening of the gates comes he steals back to the island,	門が開くずっと前に、ピーターはこっそり島へと戻ってきました。
for people must not see him	人に姿を見られないためです。
(he is not so human as all that)	（ピーターはまったく普通の人間というわけではありませんから）
but this gives him hours for play,	ただこうすることでピーターは、何時間も遊ぶことができました。
and he plays exactly as real children play.	ピーターは、本当の子供たちのように遊びました。
At least he thinks so,	少なくともピーターはそう考えていました。
and it is one of the pathetic things about him that he often plays quite wrongly.	そしてピーターがしばしば全然見当違いな方法で遊んでいる姿は、涙なしでは見られないものでした。
You see,	そうです。
he had no one to tell him how children really play,	ピーターに本当は子供がどうやって遊ぶものか、教えてくれる人はいませんでした。
for the fairies were all more or less in hiding until dusk, and so know nothing,	妖精たちは、みんなだいたい暗くなるまで隠れていましたからなにも知りません。
and though the buds pretended that they could tell him a great deal, when the time for telling came, it was wonderful how little they really knew.	妖精の若者たちはピーターにいろいろ教えてやるふりをしましたが、いざ話すときになると、実際にはほとんど何も知らないのは不思議なことです。
They told him the truth about hide-and-seek,	かくれんぼについては、妖精たちは本当のことを教えてくれました。
and he often plays it by himself,	ピーターは、ひとりでかくれんぼをしたものでした。
but even the ducks on the Round Pond could not explain to him what it is that makes the pond so fascinating to boys.	でも丸い池のあひるたちでさえ、なぜ池がふつうの男の子たちにとっておもしろい場所であるかをピーターに説明することができません。
Every night the ducks have forgotten all the events of the day,	夜になると、あひるは昼間のことをすっかり忘れてしまいます。
except the number of pieces of cake thrown to them.	覚えているのは、池に投げてもらったケーキのかけらの数だけなんです。
They are gloomy creatures, and say that cake is not what it was in their young days.	あひるなんて憂鬱などうぶつで、このごろのケーキはわしらの若い頃とは比べ物にならん、なんて言ってるものです。
So Peter had to find out many things for himself.	だからピーターは、なにもかも自分で学ばなければなりませんでした。
He often played ships at the Round Pond,	ピーターはしばしば丸い池で船遊びをしました。
but his ship was only a hoop which he had found on the grass.	でもピーターの船は、芝生でみつけたただの輪っかでした。
Of course, he had never seen a hoop, and he wondered what you play at with them, and decided that you play at pretending they are boats.	もちろん、輪っかなんてみたこともありませんでしたから、どうやって遊ぶんだろうと不思議に思って、船にして遊ぶと決めつけたのです。
This hoop always sank at once, but he waded in for it, and sometimes he dragged it gleefully round the rim of the pond,	輪っかはすぐに沈んでしまいますが、ピーターは拾い上げるために水の中に入っていって、時々うれしそうに輪っかを引きずって池の周りをまわるのでした。
and he was quite proud to think that he had discovered what boys do with hoops.	ピーターはとてもプライドが高かったので、どうやって男の子たちが輪っかで遊ぶのかすっかりわかったと思いこんでいました。
Another time, when he found a child's pail, he thought it was for sitting in,	別の時には、ピーターは子供のバケツを見つけると、椅子だと思いました。
and he sat so hard in it that he could scarcely get out of it.	そしてバケツの中に勢いよく座りこんだものですから、抜けられなくなるくらいでした。
Also he found a balloon.	また風船を見つけたこともありました。
It was bobbing about on the Hump, quite as if it was having a game by itself,	風船は、まるで一人でゲームでもしているみたいに丸い丘でゆらゆら漂っていました。
and he caught it after an exciting chase.	そしてピーターは、喜び勇んで風船を追いかけ捕まえました。
But he thought it was a ball,	でもピーターは、それをボールだと思っていました。
and Jenny Wren had told him that boys kick balls, so he kicked it;	ミソサザイのジェニーが、ピーターに男の子たちはボールを蹴ってたよといいましたから、ピーターもボールだと思って風船を蹴り飛ばし、
and after that he could not find it anywhere.	風船はどこかに行ってしまいました。
Perhaps the most surprising thing he found was a perambulator.	たぶんピーターが見つけて、最も驚いたのは、うばぐるまでしょう。
It was under a lime-tree, near the entrance to the Fairy Queen's Winter Palace	うばぐるまはシナノキの下にあって、そこは妖精の女王の冬の宮殿の入り口の近くでした。
(which is within the circle of the seven Spanish chestnuts),	宮殿はスペインのクリの７本の木が丸く植えられた場所の中にありました。
and Peter approached it warily, for the birds had never mentioned such things to him.	そしてピーターは、鳥たちがうばぐるまが何かは教えてくれないので、用心してうばぐるまに近づきました。
Lest it was alive, he addressed it politely,	それは生きているかもしれないので、ピーターは丁寧に話しかけました。
and then, as it gave no answer, he went nearer and felt it cautiously.	そして返事がないので、もっと近づくと用心深くふれて、
He gave it a little push,	ちょっと押してみました。
and it ran from him,	するとピーターから離れていきます。
which made him think it must be alive after all;	ピーターは、なんだやっぱり生きてるんじゃないかと思いました。
but, as it had run from him, he was not afraid.	でも離れて行ったので、恐くはありません。
So he stretched out his hand to pull it to him,	ピーターは手を伸ばして、自分の方へうばぐるまを引き寄せてみました。
but this time it ran at him,	今度はピーターの方へ向かってきます。
and he was so alarmed that he leapt the railing and scudded away to his boat.	ピーターはびっくりぎょうてんして柵を越え、自分のボートに駆けこみました。
You must not think, however, that he was a coward, for he came back next night with a crust in one hand and a stick in the other,	なんて臆病だなんて思うでしょうが、ピーターは次の夜には片手にパンの耳、片手に棒をもってもどってきました。
but the perambulator had gone, and he never saw another one.	ただうばぐるまはすっかり姿を消していて、ピーターは二度とうばぐるまを見ることはありませんでした。
I have promised to tell you also about his paddle.	私は、ピーターのオールのお話をする約束をしました。
It was a child's spade which he had found near St. Govor's Well,	それはピーターが聖ガーバーの井戸の近くでみつけた子供用のくわでした。
and he thought it was a paddle.	ピーターは、くわをオールだと思ったのです。
Do you pity Peter Pan for making these mistakes?	こんな間違いばかりで、ピーターパンがかわいそうなんて思われるかもしれません。
If so, I think it rather silly of you.	もしそうなら、あなたたちの方が浅はかというものです。
What I mean is that, of course, one must pity him now and then, but to pity him all the time would be impertinence.	浅はかというのは、もちろんピーターのことを時々はかわいそうと思う必要はありますが、いつもいつもかわいそうなんて思うのは見当違いだからです。
He thought he had the most splendid time in the Gardens,	ピーターは、公園でとっても楽しんでいると自分自身では思っていました。
and to think you have it is almost quite as good as really to have it.	そしてそう思っているという事は、実際にそうするのと同じくらいすばらしいことなんです。
He played without ceasing,  while you often waste time by being mad-dog or Mary-Annish.	みなさんが狂ったような男の子や憂鬱な女の子になって時間を無駄にしている間、ピーターは遊びつづけていました。
He could be neither of these things,	ピーターは狂ったようになったり憂鬱になったりすることはありません。
for he had never heard of them,	ピーターはそんなことは聞いたこともありませんでしたから。
but do you think he is to be pitied for that?	さあ、これでもピーターのことをかわいそうだなんてお思いになるでしょうか？
Oh, he was merry.	そうです、ピーターは朗らかでした。
He was as much merrier than you, for instance, as you are merrier than your father.	ピーターはあなたたち、たとえばひあなたたちのお父さんに負けず劣らず朗らかだったんです。
Sometimes he fell, like a spinning-top, from sheer merriment.	時々は、コマみたいに笑いころげてしまうことさえありました。
Have you seen a greyhound leaping the fences of the Gardens?	公園の柵を飛び越えるグレイハウンドを見たことがあるでしょうか？
That is how Peter leaps them.	ピーターもそんな風に柵をこえるのです。
And think of the music of his pipe.	ピーターの笛の調べを想像してみましょう。
Gentlemen who walk home at night write to the papers to say they heard a nightingale in the Gardens,	家路をいそぐ紳士たちは、公園でナイチンゲールが一匹さえずっているのを耳にしたと新聞に書きました。
but it is really Peter's pipe they hear.	実際に彼らが聞いたのは、ピーターの笛の調べです。
Of course, he had no mother	もちろんピーターにはお母さんはいません。
--at least, what use was she to him?	でも少なくともピーターにとっては、お母さんが何の役にたったでしょうか？
You can be sorry for him for that,	そのことでピーターをかわいそうに思うかもしれません。
but don't be too sorry,	でも思いすぎるのはいけないことです。
for the next thing I mean to tell you is how he revisited her.	次にお話しすることは、どのようにしてピーターがお母さんのもとへと戻って行ったのかということです。
It was the fairies who gave him the chance.	妖精たちがチャンスをくれました。
The Little House	３章　小さな家
Everybody has heard of the Little House in the Kensington Gardens,	だれもがケンジントン公園の小さな家のことを聞いたことがあるでしょう。
which is the only house in the whole world that the fairies have built for humans.	小さな家は世界でたった一つの、妖精が人間のために作った家です。
But no one has really seen it, except just three or four,	でもほんの３、４人しかそれを見た人はいません。
and they have not only seen it but slept in it,	でもその３、４人は見ただけでなく、その中で寝泊りさえしました。
and unless you sleep in it you never see it.	でも寝泊りしないかぎり、見ることもできません。
This is because it is not there when you lie down, but it is there when you wake up and step outside.	なぜなら小さな家は寝ているときは見えなくて、起き出して外にでると見えるものだからです。
In a kind of way everyone may see it, but what you see is not really it, but only the light in the windows.	あなたがたは、まちまちの方法で小さな家を見るでしょうが、見えたものは本当の小さな家ではなくて、窓の明かりだけということもあります。
You see the light after Lock-out Time.	門が閉まった後は、その家の窓の明かりが見えるのです。
David, for instance, saw it quite distinctly far away among the trees as we were going home from the pantomime,	例えば、デビットはパントマイムを見た帰り道で、木々の間から遠くに見える明かりをはっきり目にしました。
and Oliver Bailey saw it the night he stayed so late at the Temple, which is the name of his father's office.	そしてオリバー・ベイリーは、テンプルと言う名前の父親の事務所に遅くまでいた晩にその明かりを見ています。
Angela Clare, who loves to have a tooth extracted because then she is treated to tea in a shop, saw more than one light, she saw hundreds of them all together,	アンジェラ・クレアは、店でお茶をご馳走になると、ついでに歯の一本もよろこんで抜いてもらうといった女性でしたが、一つより多くの明かりを、何百もの明かりを一度に目にしました。
and this must have been the fairies building the house,	それは、妖精たちが家を建てていたところだったのでしょう。
for they build it every night and always in a different part of the Gardens.	妖精たちは毎晩家を建てるのですが、いつも公園の違う場所に建てるのです。
She thought one of the lights was bigger than the others, though she was not quite sure,	アンジェラには明かりの一つが、はっきりというわけではありませんが、他のものより明るい感じがしました。
for they jumped about so, and it might have been another one that was bigger.	まあ明かりは飛びはねたりもしていましたし、大きかったのは何か別のものだったのかもしれません。
But if it was the same one, it was Peter Pan's light.	いいえ、もしその明かりが別のものでなければ、ピーターパンの明かりでしょう。
Heaps of children have seen the fight, so that is nothing.	多くの子供たちがピーターが飛ぶところを見ていますから、それほど珍しいことでもありません。
But Maimie Mannering was the famous one for whom the house was first built.	でもマイミー・マナリングは、初めて家を建ててもらったことで有名でした。
Maimie was always rather a strange girl,	マイミーは、常日頃から変わったところのある女の子でした。
and it was at night that she was strange. She was four years of age, and in the daytime she was the ordinary kind.	４才で、昼間はいたって普通ですが、夜になると変わるのです。
She was pleased when her brother Tony, who was a magnificent fellow of six, took notice of her,	６才で素敵なお兄ちゃんのトニーがかまってくれると、マイミーはうれしがりましたし、お兄ちゃんをとても慕っていました。
and she looked up to him in the right way, and tried in vain to imitate him and was flattered rather than annoyed when he shoved her about.	お兄ちゃんの真似をしようとしますができなくて、お兄ちゃんにぐいっと押されてもいやがるどころかうれしがる始末でした。
Also, when she was batting she would pause though the ball was in the air to point out to you that she was wearing new shoes.	ボールを打つ時なんかも、ボールがまだ宙にあるというのに、新しい靴をはいてるのといって一休みしてしまいます。
She was quite the ordinary kind in the daytime.	昼間は、本当に普通の女の子なんです。
But as the shades of night fell, Tony, the swaggerer, lost his contempt for Maimie and eyed her fearfully,	でも夜のとばりがおりると、いばっていたトニーがマイミーを馬鹿にするどころか恐いものでも見るような目でみつめます。
and no wonder,	不思議でも何でもありません。
for with dark there came into her face a look that I can describe only as a leary look.	暗くなるとマイミーの顔にはずるがしこいとしかいいようのない表情が浮かぶのでした。
It was also a serene look that contrasted grandly with Tony's uneasy glances.	その顔は、トニーの不安そうな表情と正反対の落ち着き払った表情でした。
Then he would make her presents of his favourite toys (which he always took away from her next morning) and she accepted them with a disturbing smile.	そしてトニーは自分の一番好きなおもちゃをマイミーに差し出して、マイミーときたら人を不安にさせる笑みを浮かべてそれを受け取りました。
The reason he was now become so wheedling and she so mysterious was (in brief) that they knew they were about to be sent to bed.	トニーがどうしておもちゃを差し出すのか、マイミーがどうしてこんなにミステリアスなのか、簡単に言えば、まさにベッドに行くところだからです。
It was then that Maimie was terrible.	ベッドでのマイミーといったら、それは恐いものです。
Tony entreated her not to do it to-night, and the mother and their coloured nurse threatened her, but Maimie merely smiled her agitating smile.	トニーは今晩はそうしないでねと頼み込み、お母さんや黒人の乳母も脅すように言ってきかせるのでしたが、マイミーは人を不安にさせるような笑みを浮かべるだけでした。
And by-and-by when they were alone with their night-light she would start up in bed crying	そして２人きりになり、だんだんナイトライトがついているだけの頃になると、マイミーがベッドの中で
"Hsh! what was that?"	「あら、あれはなに？」と叫び出すのでした。
Tony beseeches her!	「なんでもないよ、マイミー、だめだよ！」
"It was nothing--don't, Maimie, don't!"	トニーはマイミーにお願いするように声をかけ、
and pulls the sheet over his head.	頭からシーツをかぶりました。
"It is coming nearer!"	「近づいてくるわ！」
she cries;	マイミーは叫びます。
"Oh, look at it, Tony!	「見て！
It is feeling your bed with its horns--it is boring for you, oh, Tony, oh!"	隅でお兄ちゃんのベッドを探ってるわ、つつこうとしてる、お兄ちゃん！」
and she desists not until he rushes downstairs in his combinations, screeching.	トニーが下着のまま叫びながら一階へ駆けだして行くまで、マイミーは話しつづけました。
When they came up to whip Maimie they usually found her sleeping tranquilly,	マイミーに罰をあたえるため、みんなで上がってくると、いつもマイミーが静かなねいきをたてて寝ている姿をみるのでした。
not shamming,	ねているふりをしているわけではありません。
you know, but really sleeping,	そうです、本当に寝ています。
and looking like the sweetest little angel, which seems to me to make it almost worse.	愛らしい小さな天使のような寝顔で、それだけにいっそう薄気味わるく思えるのでした。
But of course it was daytime when they were in the Gardens, and then Tony did most of the talking.	ただもちろん公園に行くのは昼間でしたから、その時はトニーのおしゃべりばかりです。
You could gather from his talk that he was a very brave boy,	おしゃべりの内容からも、トニーがとても勇敢な男の子だということはうかがえます。
and no one was so proud of it as Maimie.	そしてマイミーほどそれを誇りに思っている子もいなかったでしょう。
She would have loved to have a ticket on her saying that she was his sister.	マイミーは、自分がトニーの妹だと誇りをもってふれまわりたいくらいでした。
And at no time did she admire him more than when he told her,	トニーがマイミーにこう断言してくれるときほど、トニーを尊敬したことはありません。
as he often did with splendid firmness, that one day he meant to remain behind in the Gardens after the gates were closed.	トニーはいつか閉門時間の後まで公園にいるんだと言ったのでした。
"Oh, Tony,"	「でも、お兄ちゃん」
she would say, with awful respect,	マイミーは、尊敬の念を隠すこともなく口にだしたものです。
"but the fairies will be so angry!"	「妖精たちは、それは怒るでしょうねぇ！」
"I daresay,"	「かまわないさ」
replied Tony, carelessly.	トニーは大したことじゃないよといった風に答えました。
"Perhaps,"	「たぶん」
she said, thrilling,	マイミーはどきどきしながらつづけました。
"Peter Pan will give you a sail in his boat!"	「ピーターパンが、お兄ちゃんをボートに乗せてくれるかもね」
"I shall make him,"	「僕がピーターにそうさせるんだ」
replied Tony;	トニーは答えました。
no wonder she was proud of him.	このときほどマイミーがトニーを誇りに思ったことはありません。
But they should not have talked so loudly,	でも２人は、そんなに大きな声で話をするべきではありませんでした。
for one day they were overheard by a fairy	ある日ひとりの妖精が、２人が話していることを耳にしました。
who had been gathering skeleton leaves, from which the little people weave their summer curtains,	妖精は、サマーカーテンを作るために筋だらけの葉っぱを集めていました。
and after that Tony was a marked boy.	そしてそれ以降、トニーは要注意人物となったのです。
They loosened the rails before he sat on them, so that down he came on the back of his head;	トニーが柵にもたれかかろうとすると、妖精たちが前もってがたがたにしておいたので、頭からうしろに落ちてしまいます。
they tripped him up by catching his bootlace and bribed the ducks to sink his boat.	その他にも、靴ひもをつかんでつまづかせたり、あひるにトニーのボートを沈めさせたりしました。
Nearly all the nasty accidents you meet with in the Gardens occur because the fairies have taken an ill-will to you,	あなたが公園ででくわすほとんど全てのいやな出来事は、妖精たちがあなたに悪意をもってるがために起きることです。
and so it behoves you to be careful what you say about them.	だから妖精のことを口にするときは、よっぽど注意しなければいけません。
Maimie was one of the kind who like to fix a day for doing things, but Tony was not that kind,	マイミーはその日のことはその日にすませるのがすきなたちでしたが、トニーはそうではありません。
and when she asked him which day he was to remain behind in the Gardens after Lock-out he merely replied,	マイミーがトニーに「いつ公園に残るの？」と聞いたときも、
he merely replied, "Just some day;"	トニーはただ「その日がきたらね」と答えるだけでした。
he was quite vague about which day except when she asked "Will it be today?" and then he could always say for certain that it would not be to-day.	いつやるのという質問に対するトニーの答えはいつでもあいまいでしたが、「今日やるの」とマイミーが尋ねた時は、はっきりと「今日じゃないね」と答えるのでした。
So she saw that he was waiting for a real good chance.	だからマイミーはお兄ちゃんは本当にいいチャンスを待っているんだわと思っていたのでした。
This brings us to an afternoon when the Gardens were white with snow,	こうして、公園がまっしろな雪で覆われたある午後のお話をしましょう。
and there was ice on the Round Pond,	丸い池には氷がはりました。
not thick enough to skate on but at least you could spoil it for tomorrow by flinging stones,	スケートができるほどは厚くはありませんが、いずれにせよ子供たちが石を投げ込んで次の日にも滑れなくしてしまうのでした。
and many bright little boys and girls were doing that.	多くの元気で小さな男の子や女の子が、石を投げ込みました。
When Tony and his sister arrived they wanted to go straight to the pond, but their ayah said they must take a sharp walk first,	公園につくとトニーと妹はすぐに池に向かおうとしましたが、乳母が最初はきちんと歩かなくてはというのです。
and as she said this she glanced at the time-board to see when the Gardens closed that night.	乳母はそう言ったあと、その夜は何時に公園が閉まるか時間の表示をみると、
It read half-past five.	５時半でした。
Poor ayah!	かわいそうな乳母！
she is the one who laughs continuously because there are so many white children in the world, but she was not to laugh much more that day.	彼女は世界中にこんなにたくさんの白人の子供がいるなんて笑い転げるくらいでしたが、その日ばかりは笑ってもいられないことになるのです。
Well, they went up the Baby Walk and back,	そして、みんなは赤ん坊の道を行って、戻って来ました。
and when they returned to the time-board she was surprised to see that it now read five o'clock for closing time.	時間の表示のところまで戻ってくると、乳母は公園が閉まる時間が５時になっていてびっくりしました。
But she was unacquainted with the tricky ways of the fairies, and so did not see (as Maimie and Tony saw at once) that they had changed the hour because there was to be a ball to-night.	でも妖精たちのいたずらには詳しくなかったので、妖精たちが舞踏会があるからといって時間を書き換えたことには気づきません。
She said there was only time now to walk to the top of the Hump and back,	乳母は、もう丘の上まで上がってる時間しかありませんよ、と言いました。
and as they trotted along with her she little guessed what was thrilling their little breasts.	ただ２人が乳母といっしょに急いでいるとき、２人が小さな胸でどれほどスリルを感じているか乳母には全然思いもよりませんでした。
You see the chance had come of seeing a fairy ball.	あなたがたも思うとおり、妖精の舞踏会をみるチャンスがやってきたのです。
Never, Tony felt, could he hope for a better chance.	トニーもそう思いましたが、これほどいいチャンスはないでしょう。
He had to feel this,	トニーはそう思うべきだったのです。
for Maimie so plainly felt it for him.	というのも、マイミーも明らかにトニーの代わりにそう思っていたぐらいですから。
Her eager eyes asked the question,	マイミーの目はこう訴えかけているようでした。
"Is it to-day?"	「今日でしょ？」
and he gasped and then nodded.	トニーは息をのみ、うなずきました。
Maimie slipped her hand into Tony's, and hers was hot, but his was cold.	マイミーはトニーの手に自分の手を滑り込ませると、マイミーの手はとても暖たかでしたが、トニーの手は冷え切っていました。
She did a very kind thing;	マイミーはとてもやさしくしました。
she took off her scarf and gave it to him!	スカーフをとると、お兄ちゃんに渡したのでした！
"In case you should feel cold,"	「寒くなったらね」
she whispered.	マイミーはささやきました。
Her face was aglow, but Tony's was very gloomy.	マイミーの顔は赤らんでいましたが、トニーの顔ときたらまっさおでした。
As they turned on the top of the Hump he whispered to her,	３人が丘の上までやってきたとき、トニーはマイミーに耳打ちしました。
"I'm afraid Nurse would see me, so I sha'n't be able to do it."	「ばあやに見つかっちゃうと、なんにもできないや」
Maimie admired him more than ever for being afraid of nothing but their ayah, when there were so many unknown terrors to fear, and she said aloud,	マイミーは、これからまだ未知の恐ろしいことが起きるかもしれないのに、乳母のことしか恐れていないなんて、いよいよお兄ちゃんを尊敬し、大きな声でこういいました。
"Tony, I shall race you to the gate,"	「お兄ちゃん、門までかけっこしよう」
and in a whisper,	そして小さな声で
"Then you can hide,"	「それで、かくれればいいわ」と。
and off they ran.	２人は駆け出しました。
Tony could always outdistance her easily,	トニーは、いつも簡単にマイミーをはるかに引き離すことができました。
but never had she known him speed away so quickly as now,	今ほどの勢いでかけていくお兄ちゃんを見たことはありません。
and she was sure he hurried that he might have more time to hide.	マイミーは、隠れる時間をかせぐために急いでいるに違いないと思っていました。
"Brave, brave!"	「勇敢だわ、勇敢！」
her doting eyes were crying	マイミーの信じきっているひとみは、そう訴えかけていました。
when she got a dreadful shock;	とその時マイミーは大ショックをうけました。
instead of hiding, her hero had run out at the gate!	かくれるどころか、尊敬すべきお兄ちゃんは門の外へと駆け出して行ってしまったのです！
At this bitter sight Maimie stopped blankly,	このつらい光景を目にして、マイミーはぽかんと立ちつくしました。
as if all her lapful of darling treasures were suddenly spilled,	まるでエプロンいっぱいのすばらしい宝物を、突然あたり一面に撒き散らしてしまったみたいにです。
and then for very disdain she could not sob;	そしてあまりに軽蔑しきったので、泣くことすらできませんでした。
in a swell of protest against all puling cowards she ran to St. Govor's Well and hid in Tony's stead.	あまりに臆病なお兄ちゃんへの反感でいっぱいになって、マイミーは聖ガーバーの井戸へ駆け出して行き、トニーの代わりにそこに隠れました。
When the ayah reached the gate and saw Tony far in front she thought her other charge was with him and passed out.	乳母が門のところまでやってきたとき、トニーははるか前に行っており、乳母はもう一人、マイミーもいっしょに行って姿が見えなくなったのだと思いました。
Twilight came on, and scores and hundreds of people passed out,	たそがれどきになり、みんな公園から出て行きます。
including the last one, who always has to run for it, but Maimie saw them not.	最後の一人は、いつも駆け足で出て行かなければなりません。
She had shut her eyes tight and glued them with passionate tears.	マイミーは目をぎゅっと閉じて、思いがけず涙がでて目を開けることができませんでした。
When she opened them something very cold ran up her legs and up her arms and dropped into her heart.	目を開けたとき、なにかとても冷たいものが手と足をすーっと登ってきて、心臓のところに落ちてきました。
It was the stillness of the Gardens.	それは公園の静けさでした。
Then she heard clang, then from another part _clang_, then _clang_, _clang_ far away.	それからカランという音を聞き、他からもカラン、別でカラン、遠くでカラン、
It was the Closing of the Gates.	門の閉まる音でした。
Immediately the last clang had died away Maimie distinctly heard a voice say,	すぐに最後のカランという音も聞こえなくなり、マイミーははっきりとこう言っている声をききました。
"So that's all right."	「万事問題なし」
It had a wooden sound and seemed to come from above,	木がしゃべっているような音で、上から聞こえてきました。
and she looked up in time to see an elm tree stretching out its arms and yawning.	そこで見上げてみると、すぐに楡の木が両腕を伸ばして、あくびをしているのが目に入りました。
She was about to say,	マイミーは思わず
"I never knew you could speak!"	「木がしゃべるなんて！」と声にだすところでした。
when a metallic voice that seemed to come from the ladle at the well remarked to the elm,	ただ金属からでるｔような声が井戸のところのひしゃくから聞こえてきて、楡の木に意見しました。
"I suppose it is a bit coldish up there?"	「そこはちょっと寒くないかい？」
and the elm replied,	そして楡の木は答えました。
"Not particularly, but you do get numb standing so long on one leg,"	「そうでもないよ、ところで君はそんなに長い間一本足で立っていて、しびれてくるだろう」
and he flapped his arms vigorously just as the cabmen do before they drive off.	そして楡の木は、ちょうど御者が動き出す前にするように力強く手を振り回しました。
Maimie was quite surprised to see that a number of other tall trees were doing the same sort of thing	マイミーは多くの背の高い木が、楡の木とおなじような動作をするのをみて本当にびっくりしました。
and she stole away to the Baby Walk and crouched observantly under a Minorca Holly	そしてこっそりと赤ん坊の道まで出ていくと、注意を払いながらミノルカのヒイラギの木の下に身をかくしました。
which shrugged its shoulders but did not seem to mind her.	ヒイラギの木は両肩をひょいとすくめましたが、マイミーには気づかないようでした。
She was not in the least cold.	マイミーはすこしも寒くはありません。
She was wearing a russet-coloured pelisse and had the hood over her head,	あずき色の子供用オーバーを着ていましたし、頭にはフードもかぶっていました。
so that nothing of her showed except her dear little face and her curls.	そして外から見ると、かわいい小さな顔と巻き毛以外はなにも見えません。
The rest of her real self was hidden far away inside so many warm garments that in shape she seemed rather like a ball.	その他の部分はあたたかな洋服にすっぽりつつまれていて、姿はまるまるとしたボールのようでした。
She was about forty round the waist.	まるでウエストのサイズが４０もあるみたいです。
There was a good deal going on in the Baby Walk,	赤ん坊の道には、いろいろなものが行き来しました。
when Maimie arrived in time to see a magnolia and a Persian lilac step over the railing and set off for a smart walk.	マイミーが着いた時は、マグノリア（もくれん）とペルシアライラックが柵を越えて、さっそうと歩いて行くところでした。
They moved in a jerky sort of way certainly, but that was because they used crutches.	たしかに彼らはてきぱきと動いていましたが、それは松葉杖を使っていたからです。
An elderberry hobbled across the walk, and stood chatting with some young quinces,	ニワトコは道をびっこを引きながら横切り、年若そうなカリンと立ち話をしていました。
and they all had crutches.	みんな松葉杖をついていて、
The crutches were the sticks that are tied to young trees and shrubs.	松葉杖とは若い枝や下のほうの枝に結び付けられたステッキのことです。
They were quite familiar objects to Maimie, but she had never known what they were for until to-night.	松葉杖はマイミーにとって、よく目にするものでしたが、今夜までどんな風に使うものか知りませんでした。
She peeped up the walk and saw her first fairy.	マイミーは道をこっそりのぞいて、初めて妖精をみました。
He was a street boy fairy who was running up the walk closing the weeping trees.	その妖精は男の子の浮浪児で道をかけまわっては、垂れ下がった枝を閉じているのでした。
The way he did it was this,	そのやり方はこうです。
he pressed a spring in the trunk and they shut like umbrellas, deluging the little plants beneath with snow.	妖精が木の幹に飛びかかると、木は傘みたいに枝を閉じ、木の下の小さな草木の上に雪をどさりと落とすのです。
"Oh, you naughty, naughty child!"	「わんぱく坊や、まったくわんぱくなんだから！」
Maimie cried indignantly,	マイミーは腹をたてて叫びました。
for she knew what it was to have a dripping umbrella about your ears.	マイミーも、耳元のところに雨がしたたる傘をもってこられることがどういうことかは知ってましたから。
Fortunately the mischievous fellow was out of earshot,	運がよいことに、いたずらな妖精はマイミーの声が聞こえなかったみたいです。
but the chrysanthemums heard her,	ただ菊の花が、マイミーの声を聞いていました。
and they all said so pointedly	菊の花は辛らつに
"Hoity-toity, what is this?"	「いやはや、どういうことだい？」と言い放ち、
that she had to come out and show herself.	マイミーは出て来ざるをえませんでした。
Then the whole vegetable kingdom was rather puzzled what to do.	そして植物界は、どうしようかすっかり困ってしまいました。
"Of course it is no affair of ours,"	「もちろん、私たちには関係ないですから」
a spindle tree said after they had whispered together,	マユミの木は、みんなと何やらささやきあってからそう言いました。
"but you know quite well you ought not to be here, and perhaps our duty is to report you to the fairies;	「でもここにいちゃいけないって知ってるでしょうに、私たちとしてはあなたのこと、妖精たちに言わなきゃならないわ。
what do you think yourself?"	自分ではどう思ってるの？」
"I think you should not,"	「妖精たちには言わないで」
Maimie replied, which so perplexed them that they said petulantly there was no arguing with her.	マイミーがそう答えたので、みんなは困ってしまって、怒りっぽい口調でマイミーのことなんかあれこれ言いたくもないと言いました。
"I wouldn't ask it of you,"	「もし自分で悪いことだと思ってたら、頼まないわ」
she assured them, "if I thought it was wrong,"	マイミーはみんなに断言しました。
and of course after this they could not well carry tales.	もちろんこう言われては、告げ口できません。
They then said,	みんなは口々にこういいました
"Well-a-day,"	「なんてことのなの」
"Such is life!"	「人生なんてそんなもの！」とか。
for they can be frightfully sarcastic,	木たちの口ぶりときたら、まったく嫌みになるときがあるのです。
but she felt sorry for those of them who had no crutches, and she said good-naturedly,	でもマイミーは、松葉杖をもっていない木たちのことをかわいそうに思ったので、いい子の発言をしました。
"Before I go to the fairies' ball, I should like to take you for a walk one at a time;	「妖精たちの舞踏会に行く前に、一人ずつ散歩に連れていってあげる。
you can lean on me, you know."	私にもたれかかればいいわ」
At this they clapped their hands,	これを聞いて、みんな拍手喝さいです。
and she escorted them up to the Baby Walk and back again,	マイミーは、みんなを赤ん坊の道まで連れていき戻ってきました。
one at a time,	一度に一人ずつ。
putting an arm or a finger round the very frail, setting their leg right when it got too ridiculous,	とてもよろよろしている木は腕や指でささえてやり、足元がおぼつかない木にはまっすぐ歩けるようにしました。
and treating the foreign ones quite as courteously as the English, though she could not understand a word they said.	外国の木が何を言ってるのかさっぱりマイミーは分かりませんでしたけど、英国の木と同じくらい礼儀正しく接しました。
They behaved well on the whole, though some whimpered that she had not taken them as far as she took Nancy or Grace or Dorothy,	木たちもみんなだいたい礼儀正しかったですが、なかにはナンシーやグレースやドロシーを連れて行ったところまで私をつれて行ってくれないの、とめそめそ泣くものもいました。
and others jagged her,	またマイミーにぎざぎざをつけるものもいました。
but it was quite unintentional, and she was too much of a lady to cry out.	ただわざとではありませんし、マイミーは礼儀正しい女の子でしたので叫び声はあげませんでした。
So much walking tired her and she was anxious to be off to the ball,	マイミーはあんまり歩いたので疲れましたし、舞踏会に遅れるのではと心配になりました。
but she no longer felt afraid.	でも、もう恐い気持ちは全然ありません。
The reason she felt no more fear was that it was now night-time,	恐くなくなったのは、夜の時間になったからでもあります。
and in the dark, you remember, Maimie was always rather strange.	暗くなると、そうです、マイミーはかなり変わった女の子になりますから。
They were now loath to let her go,	木たちはマイミーを行かせたがりません。
for,	それで
"If the fairies see you," they warned her, "they will mischief you,	「妖精たちがあなたを見たら、いたずらするよ。
stab you to death or compel you to nurse their children or turn you into something tedious, like an evergreen oak."	つついたり子供の面倒をみさせたり、なにか退屈なもの、一年中緑のかしの木なんかにかえてしまうかもしれないよ」と注意しました。
As they said this they looked with affected pity at an evergreen oak,	こういいながら、木たちは悪いなぁと思いながらかしの木を見ました。
for in winter they are very envious of the evergreens.	実は、一年中緑のかしの木をねたましく思っていたのです。
"Oh, la!"	「ふーん！」
replied the oak bitingly,	かしの木は辛らつに言い返しました。
"how deliciously cosy it is to stand here buttoned to the neck and watch you poor naked creatures shivering!"	「ここに首までボタンをしめて立っていて、君らがはだかでぶるぶる震えてるのを見るのはどんなに楽しいことか」
This made them sulky though they had really brought it on themselves,	自分たちで言い出したくせに、こう言われると他の木たちは、すっかりすねてしまいました。
and they drew for Maimie a very gloomy picture of the perils that faced her if she insisted on going to the ball.	そしてマイミーにもし舞踏会に行くとだだをこねると、どんな危険がまちうけているかさも憂鬱そうに説明するのでした。
She learned from a purple filbert that the court was not in its usual good temper at present,	マイミーは、すでにムラサキハシバミから宮殿はいつものような平穏な様子ではないということを聞いていました。
the cause being the tantalising heart of the Duke of Christmas Daisies.	それは、クリスマスひなぎく公爵のじりじりさせる心のせいなのです。
He was an Oriental fairy, very poorly of a dreadful complaint, namely, inability to love,	クリスマスひなぎく公爵は東洋の妖精で、ひどい病気にかかっており、つまり愛することができないためにとても不幸でした。
and though he had tried many ladies in many lands he could not fall in love with one of them.	いろいろな土地でさまざまな女の人を愛そうとしたのですが、誰も愛することができませんでした。
Queen Mab, who rules in the Gardens, had been confident that her girls would bewitch him,	ケンジントン公園を治めていたマブ女王は、自分の娘たちなら公爵をうっとりさせることができるだろうと自信をもっていました。
but alas, his heart, the doctor said, remained cold.	ただ医者がいうには、公爵の心は凍ったままなのでした。
This rather irritating doctor, who was his private physician, felt the Duke's heart immediately after any lady was presented, and then always shook his bald head	このかなりいらいらさせる医者は、公爵のかかりつけの医者で、女性が公爵の面前に現われるとすぐに公爵の心に手をあてて、はげあがった頭をいつも左右にふると、
and murmured, "Cold, quite cold!"	「冷たい、きわめて冷たいですな」とつぶやきました。
Naturally Queen Mab felt disgraced, and first she tried the effect of ordering the court into tears for nine minutes,	もちろんマブ女王は面目をつぶされたと感じて、最初は、９分間の間、宮殿を涙であふれさせることを試してみました。
and then she blamed the Cupids and decreed that they should wear fools' caps until they thawed the Duke's frozen heart.	それからキューピッドを責め、公爵の凍りついた心をとかすまで道化者の帽子をかぶるよう命令しました。
"How I should love to see the Cupids in their dear little fools' caps!"	「なんとしても、道化者の帽子をかぶったキューピッドをみたいわ」
Maimie cried, and away she ran to look for them very recklessly,	とマイミーはさけぶと、向こう見ずにもキューピッドを探しにかけだしました。
for the Cupids hate to be laughed at.	キューピッドというものは、笑われるのが大嫌いなのですが。
It is always easy to discover where a fairies' ball is being held,	妖精たちの舞踏会が開かれている場所を探し出すのは、いつも簡単なことです。
as ribbons are stretched between it and all the populous parts of the Gardens, on which those invited may walk to the dance without wetting their pumps.	というのも舞踏会の場所と公園の人通りがはげしい場所との間にはリボンがはりわたされていて、招待された人たちは舞踏用の靴が濡れないように、ダンスするところまでその上を歩いて行けましたから。
This night the ribbons were red and looked very pretty on the snow.	今夜のリボンは赤で、雪の上でひときわ映えました。
Maimie walked alongside one of them for some distance without meeting anybody,	マイミーは、誰にも出会うことなくしばらくリボンの一つにそって歩いて行きました。
but at last she saw a fairy cavalcade approaching.	しかしついにマイミーは妖精の大パレードが近づいてくるのを目にしました。
To her surprise they seemed to be returning from the ball,	びっくりしたことに、パレードは舞踏会から引き返してくるようでした。
and she had just time to hide from them by bending her knees and holding out her arms and pretending to be a garden chair.	マイミーは膝を折り両腕をのばし、公園の椅子のようなふりをしてぎりぎりパレードから姿を隠しました。
There were six horsemen in front and six behind, in the middle walked a prim lady wearing a long train held up by two pages, and on the train,	前に６人、後ろに６人が馬に乗っていて、真ん中に２人の小姓に服の長いすそをもたせている上品な女性が歩いていました。
as if it were a couch, reclined a lovely girl, for in this way do aristocratic fairies travel about.	まるで長いすに腰かけているようで、一人の愛らしい少女がもたれかかっており、これが上流階級の妖精たちが旅をするやり方でした。
She was dressed in golden rain, but the most enviable part of her was her neck,	女性は金色のドレスに身をつつんでいましたが、なんといってももっとも羨望の的なのは首でした。
which was blue in colour and of a velvet texture, and of course showed off her diamond necklace as no white throat could have glorified it.	色が青くビロードの手触りで、白いのどではそれほど映えないぐらい、ダイアモンドのネックレスをいっそう引き立たせていました。
The high-born fairies obtain this admired effect by pricking their skin,	生まれが高貴な妖精たちは、このみとれる効果を上げるために、肌に針をさすのです。
which lets the blue blood come through and dye them,	針をさすと、青い血が出てきて肌が青く染まるのです。
and you cannot imagine anything so dazzling unless you have seen the ladies' busts in the jewellers' windows.	そしてあなたが宝石商のショーウィンドウで女性の上半身でも見たことがない限り、それほど目がくらむものを想像することさえできないでしょう。
Maimie also noticed that the whole cavalcade seemed to be in a passion,	マイミーは、大パレードが怒っているようにも見えることにも気づきました。
tilting their noses higher than it can be safe for even fairies to tilt them,	妖精ができうるかぎり鼻をつんと上に向けていたのです。
and she concluded that this must be another case in which the doctor had said "Cold, quite cold!"	マイミーはまたあの医者に「冷たい、きわめて冷たいですな」と言われたにちがいないと思いました。
Well, she followed the ribbon to a place where it became a bridge over a dry puddle	さて、マイミーはリボンをたどって、水のかれた水たまりにかかっている橋のようになっている所までやってきました。
into which another fairy had fallen and been unable to climb out.	そこでは、ある妖精が水たまりにはまりこみ這い上がれなくなっていました。
At first this little damsel was afraid of Maimie, who most kindly went to her aid, but soon she sat in her hand chatting gaily and explaining	初めこの小さな少女はマイミーを恐がっていましたが、マイミーがやさしく彼女を助け出したので、すぐにマイミーの腕の中で楽しそうに話し出しました。
that her name was Brownie, and that though only a poor street singer she was on her way to the ball to see if the Duke would have her.	自分の名前はブローニーで、今はしがない街の歌い手だけど、舞踏会に行って公爵にお目にかかろうと思うのと話してくれたのです。
"Of course," she said, "I am rather plain,"	「もちろん、わたしは目立たない女の子よ」
and this made Maimie uncomfortable,	少女がそう言うのを聞いて、マイミーは居心地が悪くなってしまいました。
for indeed the simple little creature was almost quite plain for a fairy.	というのもこの飾り気のない小さな少女は、妖精としては全く地味でしたから。
It was difficult to know what to reply.	なんて答えていいのかわかりません。
"I see you think I have no chance,"	「あなたが、わたしにはチャンスがないって思ってるのはわかるわ」
Brownie said falteringly.	ブローニーはためらいながら言いました。
"I don't say that,"	「そんなこといってない」
Maimie answered politely,	マイミーは礼儀正しく答えました。
"of course your face is just a tiny bit homely, but--"	「もちろんあなたの顔は、少しばかり平凡だけどね、でもね」
Really it was quite awkward for her.	マイミーは、実際のところとても困ってしまいました。
Fortunately she remembered about her father and the bazaar.	運がいいことに、マイミーはお父さんとバザーのことを思い出しました。
He had gone to a fashionable bazaar	お父さんは社交界のバザーへ出かけて行ったのです。
where all the most beautiful ladies in London were on view for half-a-crown the second day,	そのバザーでは、２日目にはロンドン中の全ての美しい女性を半クラウンでみることができました。
but on his return home instead of being dissatisfied with Maimie's mother he had said,	でも家に帰ってくると、マイミーのお母さんにがっかりするどころが、こう言ったものでした。
"You can't think, my dear, what a relief it is to see a homely face again."	「また平凡な顔を目にするのが、どれほど落ち着くかわからないだろうなぁ」
Maimie repeated this story, and it fortified Brownie tremendously,	マイミーがこの話を繰り返すと、ブローニーはとても勇気づけられたようでした。
indeed she had no longer the slightest doubt that the Duke would choose her.	実際ブローニーは、公爵が自分を選ぶだろうということをこれっぽちも疑っていませんでした。
So she scudded away up the ribbon,	そして彼女はリボンの上を駆けていきました。
calling out to Maimie not to follow lest the Queen should mischief her.	マイミーには、女王がなにかするといけないから後をついてこないようにと言い残していきました。
But Maimie's curiosity tugged her forward,	でもマイミーの好奇心は、彼女の足を前へ前へと進ませます。
and presently at the seven Spanish chestnuts, she saw a wonderful light.	そして７本のスペインのクリの木のところで、素敵な明かりを見ました。
She crept forward until she was quite near it,	マイミーは明かりのごく近くまで、這って近づきました。
and then she peeped from behind a tree.	そして木の陰から覗き見しました。
The light, which was as high as your head above the ground, was composed of myriads of glow-worms all holding on to each other, and so forming a dazzling canopy over the fairy ring.	その明かりは、ちょうどあなたの頭ぐらいの高さのところにあり、無数のホタルがひとかたまりになって形作られているようで、妖精たちの輪の上で目も眩むようなパラシュートの傘の形をしていました。
There were thousands of little people looking on, but they were in shadow and drab in colour compared to the glorious creatures within that luminous circle	何千人もの小人が見物していましたが、あの光り輝く輪の中にいる燦然たる妖精に比べると陰になっていて、色もくすんで見えました。
who were so bewilderingly bright that Maimie had to wink hard all the time she looked at them.	妖精たちはどぎまぎするほど明るくて、マイミーは眺めている間はずっと、はげしく瞬きしなければなりませんでした。
It was amazing and even irritating to her that the Duke of Christmas Daisies should be able to keep out of love for a moment:	マイミーにとっては、クリスマスひなぎく公爵がほんのひとときでさえ人を愛することができないことが驚くべきことで、またいらいらさせられることでした。
yet out of love his dusky grace still was:	でも公爵の憂鬱な態度からは、まだ人を愛してないことがありありとわかります。
you could see it by the shamed looks of the Queen and court (though they pretended not to care),	気にしてはいないふうは装っても、辱められたような女王と宮殿のものたちの様子からもわかります。
by the way darling ladies brought forward for his approval burst into tears as they were told to pass on, and by his own most dreary face.	また公爵によい返事をもらうため連れてこられた魅力のある女性たちがだめだと言われて泣き出したことや、公爵自身のつまらなそうな顔からも人を愛していないことはわかります。
Maimie could also see the pompous doctor feeling the Duke's heart	マイミーは、公爵の心を触診しているもったいぶった医者の姿も見ることができました。
and hear him give utterance to his parrot cry,	医者がオウムの鳴き声みたいな声をだしているのが聞こえます。
and she was particularly sorry for the Cupids,	マイミーは、キューピッドたちのことは本当にかわいそうに思いました。
who stood in their fools' caps in obscure places and, every time they heard that "Cold, quite cold," bowed their disgraced little heads.	キューピッドたちは道化帽をかぶり、人目につかない場所に立ち、例の「冷たい、きわめて冷たいですな」を聞くたびに面目ないといった感じで小さな頭を垂れていましたから。
She was disappointed not to see Peter Pan,	マイミーはピーターパンを見ることができなくてがっかりしました。
and I may as well tell you now why he was so late that night.	ピーターがその夜はどうしてそんなに遅れたかお話ししておきましょう。
It was because his boat had got wedged on the Serpentine between fields of floating ice,	それは、ピーターのボートがサーペインタイン池で一面の流氷に囲まれて閉じ込められたからです。
through which he had to break a perilous passage with his trusty paddle.	ピーターは、頼みのかいで危険な道を切り開かなければなりませんでした。
The fairies had as yet scarcely missed him,	妖精たちは、今のところピーターがいないことに気づいていません。
for they could not dance, so heavy were their hearts.	というのもまだ心が重くなっていて踊るどころではありませんから。
They forget all the steps when they are sad and remember them again when they are merry.	妖精たちは悲しくなるとダンスのステップを忘れてしまい、楽しくなると思い出す生き物です。
David tells me	デビットがわたしに教えてくれました。
that fairies never say "We feel happy":	妖精たちは“幸せ”とは言わない、
what they say is, "We feel _dancey_."	“踊りたい”と言うんだと。
Well, they were looking very undancy indeed,	今のところ、妖精たちは全然踊りたくなさそうでした。
when sudden laughter broke out among the onlookers,	そのとき突然、見物人の中から笑い声が起こりました。
caused by Brownie,	ブローニーが引き起こした笑い声です。
who had just arrived and was insisting on her right to be presented to the Duke.	ブローニーは、いま到着したところで公爵にお目にかかりたいと申し出たのです。
Maimie craned forward eagerly to see how her friend fared,	マイミーは、友達のブローニーがどうなるか首を伸ばして見守りました。
though she had really no hope;	実際のところ見こみはなさそうでした。
no one seemed to have the least hope except Brownie herself who, however, was absolutely confident.	ブローニーは自信満々だったんですが、ブローニー以外には少しでも望みがあると思っているものはいませんでした。
She was led before his grace, and the doctor putting a finger carelessly on the ducal heart,	ブローニーは公爵の前につれて行かれ、そして医者が公爵の胸の上にそっけなく一本指をあてました。
which for convenience sake was reached by a little trap-door in his diamond shirt,	公爵のダイヤモンドのシャツの胸のところには、ちいさな扉がついていて指をあてるのに便利なようになっていました。
had begun to say mechanically, "Cold,	そして無意識に
"Cold, qui--,"	「冷たい、きわ、」と言いかけて、
when he stopped abruptly.	突然いいよどみました。
"What's this?"	「これはいったい？」
he cried, and first he shook the heart like a watch,	医者は叫んで、はじめ胸を時計のように揺さぶりました。
and then put his ear to it.	それから胸の上に耳をあてました。
"Bless my soul!"	「なんてことだ！」
cried the doctor, and by this time of course the excitement among the spectators was tremendous, fairies fainting right and left.	医者は叫ぶと、この時には見物人からのどよめきも大きくなり、妖精たちがあちこちで気を失いました。
Everybody stared breathlessly at the Duke, who was very much startled and looked as if he would like to run away.	全ての人が固唾をのんで公爵を見守り、公爵もとても注目をあびて、逃げ出したいようにも見えました。
"Good gracious me!"	「これは驚いた！」
the doctor was heard muttering,	医者がつぶやいているのが聞こえます。
and now the heart was evidently on fire,	そして今、心には明らかに火がついていました。
for he had to jerk his fingers away from it and put them in his mouth.	医者は公爵の心にあてていた指をひっこめて、口の中に入れて冷やしたぐらいです。
The suspense was awful!	興奮は絶頂でした！
Then in a loud voice, and bowing low,	そのとき医者は低い声で、頭をさげて
"My Lord Duke,"	「わが公爵どの」
said the physician elatedly,	と勢い込んで言いました。
"I have the honour to inform your excellency	「謹んで申し上げます。
that your grace is in love."	公爵どのは愛してらっしゃると存じます」
You can't conceive the effect of it.	あなたは、こう言われた後がどうなったかは想像できないでしょう。
Brownie held out her arms to the Duke and he flung himself into them,	ブローニーは両腕を公爵にさしのべ、公爵はその腕の中にとびこみました。
the Queen leapt into the arms of the Lord Chamberlain, and the ladies of the court leapt into the arms of her gentlemen,	女王は侍従長の腕の中にとびこみ、宮廷の女性たちは紳士の腕の中にとびこみました。
for it is etiquette to follow her example in everything.	全てのことにおいて女王のするとおりにするのが、エチケットでしたから。
Thus in a single moment about fifty marriages took place,	その瞬間に５０組の婚礼がとりおこなわれました。
for if you leap into each other's arms it is a fairy wedding.	お互いの腕の中にとびこむことが妖精の婚礼です。
Of course a clergyman has to be present.	もちろん牧師も一人はいなければなりませんが。
How the crowd cheered and leapt!	どんなに観衆は騒いで、とびはねたことでしょう。
Trumpets brayed, the moon came out,	らっぱが響き渡り、月が姿をあらわしました。
and immediately a thousand couples seized hold of its rays as if they were ribbons in a May dance and waltzed in wild abandon round the fairy ring.	そして、すぐさま数多くのカップルがまるで５月の踊りのときリボンをつかむように月の光を手につかみ、妖精たちの輪の周りで、はめをはずしてワルツをおどりました。
Most gladsome sight of all,	そのなかでも一番おおはしゃぎなのは、キューピッドでした。
the Cupids plucked the hated fools' caps from their heads and cast them high in the air.	あのいやな道化帽を脱ぎ捨て、宙高くほうり投げました。
And then Maimie went and spoiled everything.	それからマイミーが姿をあらわし、全てを台無しにしていまいました。
She couldn't help it.	マイミーもそうせずにはいられなかったのです。
She was crazy with delight over her little friend's good fortune, so she took several steps forward and cried in an ecstasy,	マイミーは、自分の小さな友達の幸せに大喜びで、思わず足が前にでてうれしそうに叫んだのでした。
"Oh, Brownie, how splendid!"	「あぁブローニー、なんてすばらしいの！」
Everybody stood still,	全員がたちすくみました。
the music ceased, the lights went out, and all in the time you may take to say "Oh dear!"	音楽はやみ、明かりは消え、全てはあなたが「まあ」というぐらいの時間で起こりました。
An awful sense of her peril came upon Maimie, too late she remembered that she was a lost child in a place where no human must be between the locking and the opening of the gates,	マイミーはあぶないわと思いましたが、自分が閉門から開門までの時間に禁じられた場所にいる迷子だと思い出すには遅すぎました。
she heard the murmur of an angry multitude, she saw a thousand swords flashing for her blood,	怒りに満ちた観衆のぶつぶつ言う声がマイミーの耳に入り、数多くの剣がマイミーの血を求めてきらりと光りました。
and she uttered a cry of terror and fled.	マイミーは恐怖のあまり叫び声をあげ、逃げ出しました。
How she ran!	どれほど走ったことでしょう！
and all the time her eyes were starting out of her head.	走っている間マイミーの両目は、顔から飛び出しそうになったほどです。
Many times she lay down, and then quickly jumped up and ran on again.	何回も転んで、その度に飛び起きてまた走りつづけました。
Her little mind was so entangled in terrors that she no longer knew she was in the Gardens.	その小さな心は恐怖に絡め取られて、もはや公園にいることもわからないありさまでした。
The one thing she was sure of was that she must never cease to run,	ひとつだけ確かだったことは、走る足をとめてはいけないということでした。
and she thought she was still running long after she had dropped in the Figs and gone to sleep.	なので、マイミーはイチジクの森に転がり込んで、眠りに落ちたあともずっと走りつづけてるんだと思ったぐらいでした。
She thought the snowflakes falling on her face were her mother kissing her good-night.	自分の顔に降り積もる雪をお母さんがお休みのキスをしてくれてるんだと思ったのでした。
She thought her coverlet of snow was a warm blanket, and tried to pull it over her head.	積もった雪を暖かい毛布だと思って、頭までかぶろうとしたぐらいです。
And when she heard talking through her dreams she thought it was mother bringing father to the nursery door to look at her as she slept.	夢の中で話し声が聞こえましたが、それはマイミーが寝ている時に、お母さんがお父さんを子供部屋のドアのところまで寝顔を見せにつれてきたのだと思いました。
But it was the fairies.	しかしそれは妖精の声でした。
I am very glad to be able to say that they no longer desired to mischief her.	すでに妖精たちがマイミーに危害を及ぼす意思がないことをお話しできるのは、とてもうれしいことです。
When she rushed away they had rent the air with such cries as "Slay her!" "Turn her into something extremely unpleasant!" and so on, but the pursuit was delayed while they discussed who should march in front,	マイミーが走り去ったとき、「殺しちゃえ！」「なにかヘンなものに変えろ！」なんて叫び声が響き渡りましたが、誰が最初に追いかけるべきかなんてことを相談している間に追跡するのが遅れてしまいました。
and this gave Duchess Brownie time to cast herself before the Queen and demand a boon.	そうしていると公爵夫人のブローニーが女王の前にひれ伏して、贈り物をいただきたいと申し出ました。
Every bride has a right to a boon,	花嫁には、贈り物をもらう権利があるのです。
and what she asked for was Maimie's life.	ブローニーが望んだのは、マイミーの命でした。
"Anything except that,"	「それ以外のものを」
replied Queen Mab sternly,	マブ女王は厳しく答えました。
and all the fairies chanted	そして全ての妖精たちが口々に
"Anything except that."	「それ以外のものを」と気勢をあげました。
But when they learned how Maimie had befriended Brownie and so enabled her to attend the ball to their great glory and renown, they gave three huzzas for the little human,	でもどれほどマイミーがブローニーに力を貸したかが分かりましたし、マイミーを舞踏会に招待することが自分たちの栄誉と名声に結びつくことがわかりましたので、小さい人間の子のために妖精たちは万歳三唱しました。
and set off, like an army, to thank her,	そしてマイミーに感謝するため、軍隊みたいに出発しました。
the court advancing in front and the canopy keeping step with it.	宮殿のものたちが先頭で、傘のような明かりがそれに歩調を合わせます。
They traced Maimie easily by her footprints in the snow.	雪の上の足跡でマイミーの跡をつけるのは簡単なことでした。
But though they found her deep in snow in the Figs, it seemed impossible to thank Maimie,	イチジクの森の雪ふかくにマイミーを見つけましたが、マイミーに感謝の言葉は伝えられそうにありません。
for they could not waken her.	というのもマイミーを起こすことができないのです。
They went through the form of thanking her,	みんなは、マイミーに感謝をする式典を始めました。
that is to say, the new King stood on her body and read her a long address of welcome,	つまり新しい王様がマイミーの体の上に立ち、長い歓迎の挨拶を読みあげるのです。
but she heard not a word of it.	マイミーの耳には、その挨拶の一言さえも届きませんでしたが。
They also cleared the snow off her, but soon she was covered again,	マイミーの上に降り積もった雪もどかしたのですが、すぐにまた降り積もってしまいました。
and they saw she was in danger of perishing of cold.	そしてマイミーが寒さで危険なことが、妖精たちにはわかりました。
"Turn her into something that does not mind the cold,"	「寒さを気にしないものにかえてはどうだい」
seemed a good suggestion of the doctor's, but the only thing they could think of that does not mind cold was a snowflake.	医者の提案はよいものに思えましたが、彼らが寒さを気にしないものとして思いついたのは雪だけでした。
"And it might melt,"	「雪ではとけてしまうよ」
the Queen pointed out,	女王が注意を促しました。
so that idea had to be given up.	そこでなにかにかえてしまう案は、あきらめなければなりませんでした。
A magnificent attempt was made to carry her to a sheltered spot, but though there were so many of them she was too heavy.	屋根があるところまでマイミーを運ぼうというのもいい案でしたが、おおぜいの妖精がいたにもかかわらず、マイミーは重すぎました。
By this time all the ladies were crying in their handkerchiefs,	すでにこの時、女性たちはハンカチを目にあてていました。
but presently the Cupids had a lovely idea.	そこでキューピッドが素敵な案を思いつき、声を大きくしていいました。
"Build a house round her,"	「彼女の周りに家をたてればいいよ」
they cried, and at once everybody perceived that this was the thing to do;	すぐに全員が、それこそしなければならないことだということが分かりました。
in a moment a hundred fairy sawyers were among the branches, architects were running round Maimie, measuring her;	ただちに百人の木こりの妖精が木々の間に入っていき、建築家はマイミーの周りを走りまわり、測量をします。
a bricklayer's yard sprang up at her feet,	れんが職人もマイミーの足元で作業を始めました。
seventy-five masons rushed up with the foundation stone and the Queen laid it,	７５人の石工が家の基礎になる石の作業に急いでとりかかり、女王がそれを積み上げました。
overseers were appointed to keep the boys off,	そして子供たちを近づけないように、監督員が任命されました。
scaffoldings were run up, the whole place rang with hammers and chisels and turning lathes, and by this time the roof was on and the glaziers were putting in the windows.	足場が組み上げられ、かなづちやのみや旋盤の音があたり一面になり響き、こうして屋根が架けられ、ガラス工は窓にガラスをはめこんでいきました。
The house was exactly the size of Maimie and perfectly lovely.	家はちょうどマイミーのサイズにぴったりで、まったくかわいらしいものでした。
One of her arms was extended and this had bothered them for a second, but they built a verandah round it,	マイミーの片腕は伸びていたので、これがいっとき妖精たちを悩ませましたが、腕の周りにベランダをつくることにしました。
leading to the front door.	それが玄関につながるようにしたのです。
The windows were the size of a coloured picture-book and the door rather smaller,	窓は色がついた絵本の大きさで、ドアはそれよりいくぶん小さめです。
but it would be easy for her to get out by taking off the roof.	ただマイミーが外にでたければ、屋根を取り外した方が簡単でしょう。
The fairies, as is their custom, clapped their hands with delight over their cleverness,	妖精たちはいつもの癖で、自分たちの賢さにうれしくなって手をたたきました。
and they were all so madly in love with the little house that they could not bear to think they had finished it.	そしてその小さい家に夢中になって、もう作り終えたとは考えたくないほどでした。
So they gave it ever so many little extra touches,	そこで家にいつまでもたくさん小さな修正を加えました。
and even then they added more extra touches.	そして加えた後にも、もっとつけ加えたのです。
For instance, two of them ran up a ladder and put on a chimney.	たとえば、妖精のうち２人がはしごを登って煙突をつけて、
"Now we fear it is quite finished,"	「もうすっかり終わりだな」
they sighed.	とため息をつきました。
But no, for another two ran up the ladder, and tied some smoke to the chimney.	でも他の２人がはしごを登って、煙突にけむりを少しつけ加え、
"That certainly finishes it,"	「これでおしまい」
they cried reluctantly.	としぶしぶ言いました。
"Not at all,"	「いやいや」
cried a glow-worm,	あるホタルが大きな声でいいました。
"if she were to wake without seeing a night-light she might be frightened,	「もし目をさまして明かりがなかったら、こわがると思うよ。
so I shall be her night-light."	だから僕が彼女の明かりになるよ」
"Wait one moment,"	「ちょっとお待ち」
said a china merchant,	ある瀬戸物の商人が口をはさみました。
"and I shall make you a saucer."	「わたしが明かりのお皿を用立てよう」
Now alas, it was absolutely finished.	さぁ、もうこれで本当のおしまいでしょうか？
Oh, dear no!	いいえ、ちがいました！
"Gracious me,"	「しまった」
cried a brass manufacturer,	と一人のしんちゅうの金具屋がさけびました。
"there's no handle on the door,"	「ドアに取ってがないや」
and he put one on.	そしてすぐに、取ってをつけました。
An ironmonger added a scraper and an old lady ran up with a door-mat.	金物屋は玄関の中にくつのよごれをおとすマットを、ある老婦人は玄関の外にくつのよごれをおとすマットを備え付けました。
Carpenters arrived with a water-butt, and the painters insisted on painting it.	大工は雨水をためる樽を持ってきますし、ペンキ屋はそれにペンキをぬらなきゃと言い張りました。
Finished at last!	とうとう終わりです！
"Finished!	「おしまいだって！
how can it be finished,"	どうして終わったっていえるんだい、」
the plumber demanded scornfully,	鉛管屋があざ笑うようにいいました。
"before hot and cold are put in?"	「お湯と水がなくてね？」
and he put in hot and cold.	そしてお湯と水がでるようにしました。
Then an army of gardeners arrived with fairy carts and spades and seeds and bulbs and forcing-houses, and soon they had a flower garden to the right of the verandah and a vegetable garden to the left,	庭師の一団が妖精の手押しと鍬と種と球根と温室をもって駆けつけて、すぐにベランダの右側に花壇を左側に野菜園を作りました。
and roses and clematis on the walls of the house,	家の壁は、ばらとぼたんづるで飾り立てます。
and in less time than five minutes all these dear things were in full bloom.	そして数分もしないうちに、家も庭も花が咲き誇ったのでした。
Oh, how beautiful the little house was now!	まぁ、どれほどその小さな家は美しかったことでしょう！
But it was at last finished true as true,	でもとうとう本当のおしまいです。
and they had to leave it and return to the dance.	妖精たちはその場を離れて、ダンスに戻りました。
They all kissed their hands to it as they went away, and the last to go was Brownie.	去るときは家にむかって投げキッスをして、最後に家を離れるのはブローニーでした。
She stayed a moment behind the others to drop a pleasant dream down the chimney.	ブローニーは、煙突から楽しい夢を投げ込むために、他の妖精たちより少しあとまでとどまっていたのでした。
All through the night the exquisite little house stood there in the Figs taking care of Maimie,	よくできた小さな家はイチジクの森のその場所にマイミーを守るようにして、夜通し立っていました。
and she never knew.	マイミーはまったくそのことを知りませんでした。
She slept until the dream was quite finished and woke feeling deliciously cosy just as morning was breaking from its egg,	マイミーは夢がすっかり終わるまでぐっすり寝ており、まるで朝がたまごから生まれてきたようなとても快適な気分で目をさましました。
and  then she almost fell asleep again,	そしてそれから再び眠くなって、
and then she called out, "Tony,"	「トニー」と声をかけました。
for she thought she was at home in the nursery.	マイミーはすっかり家の子供部屋にいると思い込んでいましたから。
As Tony made no answer, she sat up, whereupon her head hit the roof,	トニーがなんの返事もしないので、マイミーは起き上がると、屋根に頭をぶつけてしまいました。
and it opened like the lid of a box,	すると屋根は箱のふたみたいに開きました。
and to her bewilderment she saw all around her the Kensington Gardens lying deep in snow.	さらにマイミーを驚かせたことに、ケンジントン公園はあたり一面雪景色でした。
As she was not in the nursery she wondered whether this was really herself, so she pinched her cheeks,	マイミーは自分が子供部屋にいないので、本当にこれが夢じゃないかと、自分のほおをつねってみました。
and then she knew it was herself,	そして現実だということがわかりました。
and this reminded her that she was in the middle of a great adventure.	頬をつねって、マイミーがすごい冒険の真っ最中だということも思い出しました。
She remembered now everything that had happened to her from the closing of the gates up to her running away from the fairies,	マイミーは、閉門以降、妖精たちから逃げ出すまでに起こったこと全てを思い出しました。
but however, she asked herself,	でもマイミーは自問自答してみました。
had she got into this funny place?	このすてきな場所にはどうやってはいりこんだのかしら？
She stepped out by the roof, right over the garden, and then she saw the dear house in which she had passed the night.	屋根から外へ、庭の右のあたりにでてみると、一晩をすごしたその素敵な家を見ることができました。
It so entranced her that she could think of nothing else.	あまりに魅力的だったので、他のことはなにも考えられないくらいでした。
"Oh, you darling, oh, you sweet, oh, you love!"	「あらまぁ、素敵、なんてきれいなお家なの！」
she cried.	マイミーはおもわず声をあげました。
Perhaps a human voice frightened the little house, or maybe it now knew that its work was done,	たぶん人の声が小さな家を驚かせたのでしょう、あるいは役目は果たしたと思ったのかもしれません。
for no sooner had Maimie spoken than it began to grow smaller;	マイミーが話しかけると、すぐにその家は小さくなりました。
it shrank so slowly that she could scarce believe it was shrinking,	とてもゆっくり小さくなったので、マイミーには小さくなっているのが信じられませんでした。
yet she soon knew that it could not contain her now.	でもすぐにもう自分が中には入れないことはわかりました。
It always remained as complete as ever, but it became smaller and smaller,	全てが前と同じなのですが、ただだんだん小さくなっていくのです。
and the garden dwindled at the same time,	そして庭も同時にだんだん小さくなるのでした。
and the snow crept closer, lapping house and garden up.	雪がしのびよってきて、家と庭をすっかり包んでしまいました。
Now the house was the size of a little dog's kennel, and now of a Noah's Ark,	もう家は犬小屋と同じ大きさぐらい、そしてノアの箱舟と同じ大きさになりました。
but still you could see the smoke and the door-handle and the roses on the wall, every one complete.	でもまだ煙突の煙やドアの取ってや壁のばらはみることができましたし、全てがそのままでした。
The glow-worm fight was waning too, but it was still there.	ホタルの明かりも青白くともっています。
"Darling, loveliest, don't go!"	「ねぇ、きれいなお家、行かないで！」
Maimie cried, falling on her knees,	マイミーはひざまずいてさけびました。
for the little house was now the size of a reel of thread, but still quite complete.	小さな家は、今や糸巻きくらいの大きさになりましたが、まだ全てがそのままでした。
But as she stretched out her arms imploringly the snow crept up on all sides until it met itself,	マイミーがお願いするように両手をのばしたとき、雪があちらこちらから忍び寄りました。
and where the little house had been was now one unbroken expanse of snow.	そして小さな家があった所は、まっさらな雪が広がっているだけでした。
Maimie stamped her foot naughtily, and was putting her fingers to her eyes, when she heard a kind voice say,	マイミーはやんちゃにも足を踏みならしましたが、指で涙を拭おうとしたときに、やさしい声が聞こえました。
"Don't cry, pretty human, don't cry,"	「泣かないで、かわいい子、泣かないで」
and then she turned round and saw a beautiful little naked boy regarding her wistfully.	マイミーが振り返ると、彼女の方を何かを求めるように見つめる、美しい小さなはだかの男の子を目にしました。
She knew at once that he must be Peter Pan.	マイミーは、すぐにピーターパンにちがいないと分かりました。
Lock-out Time	４章　閉門の時間
It is frightfully difficult to know much about the fairies,	妖精について詳しくなろうとすることは、恐ろしく難しいことです。
and almost the only thing known for certain is that there are fairies wherever there are children.	ただ一つはっきりしていることは、子供がいるところには妖精がいるということです。
Long ago children were forbidden the Gardens,	ずっと昔、子供はケンジントン公園にはいることを禁じられていました。
and at that time there was not a fairy in the place;	そのとき、公園に妖精は一人もいませんでした。
then the children were admitted, and the fairies came trooping in that very evening.	子供が公園に入ることを許されると、まさにその晩に妖精たちもぞろぞろ集まってきました。
They can't resist following the children,	妖精たちは我慢できず、子供たちのあとをついて行ってしまうのです。
but you seldom see them, partly because they live in the daytime behind the railings, where you are not allowed to go, and also partly because they are so cunning.	ただあなたがめったに妖精を目にすることがないのは、一つには、昼間、妖精たちは子供が行くのを禁じられている垣根の裏に住んでいるからですし、もう一つには妖精たちがずるがしこいからでした。
They are not a bit cunning after Lock-out,	妖精たちは、閉門後はこれっぽちもずるがしこいということはありません。
but until Lock-out, my word!	でも閉門までといったら、言葉にしがたいほどです！
When you were a bird you knew the fairies pretty well,	あなたが鳥だったときは、妖精たちのことをとてもよく知っています。
and you remember a good deal about them in your babyhood, which it is a great pity you can't write down,	そしてあなたがあかんぼうのときは、妖精について多くのことを覚えていますが、ただそれを書き記すことができないのは、とても残念なことです。
for gradually you forget,	だんだんあなたは忘れて行きます。
and I have heard of children who declared that they had never once seen a fairy.	妖精なんて一人もみたことないや、と言いはる子供のことをわたしは耳にしたことがあります。
Very likely if they said this in the Kensington Gardens, they were standing looking at a fairy all the time.	とてもありそうなことですが、もしケンジントン公園でそういったなら、始終妖精を目にしながらそこに立っていることになるのです。
The reason they were cheated was that she pretended to be something else.	子供たちがだまされてしまうのは、妖精がなにか別のもののふりをしているからです。
This is one of their best tricks.	これが妖精のよくつかう手口のひとつで、
They usually pretend to be flowers,	妖精はふつう花のふりをします。
because the court sits in the Fairies' Basin,	なぜならその場所は、妖精の溜まり場に位置していましたから。
and there are so many flowers there, and all along the Baby Walk, that a flower is the thing least likely to attract attention.	そして赤ん坊の道沿いにはたくさんの花があったので、一本の花ではまったく興味をひかないのです。
They dress exactly like flowers, and change with the seasons, putting on white when lilies are in and blue for blue-bells, and so on.	妖精たちはまさに花のように着飾り、ゆりがさいているときは白く、ツリガネスイセンが咲いているときは青くといった具合に季節によって装いをかえました。
They like crocus and hyacinth time best of all, as they are partial to a bit of colour,	妖精たちはクロッカスとヒヤシンスの色が大好きで、その季節が一番お気に入りでした。
but tulips (except white ones, which are the fairy-cradles) they consider garish, and they sometimes put off dressing like tulips for days,	でもチューリップ（白以外です、白いチューリップは妖精のゆりかごです）は派手すぎると妖精たちは思っていたので、時々チューリップみたいに着飾ることを何日も先延ばしにしました。
so that the beginning of the tulip weeks is almost the best time to catch them.	なので、だいたいチューリップが咲き始める最初の数週間が、妖精たちを見つける一番いい季節だったりします。
When they think you are not looking they skip along pretty lively,	妖精たちは、あなたが見ていないと思っているときは、とてもいきいきとスキップをしています。
but if you look and they fear there is no time to hide, they stand quite still, pretending to be flowers.	しかしあなたが目をやって、隠れるひまがないと、妖精は花のふりをしてぴくりとも動きません。
Then, after you have passed without knowing that they were fairies, they rush home and tell their mothers they have had such an adventure.	そしてあなたが妖精たちだとは気づかずに通り過ぎると、いそいで家に帰ってお母さんにこんな大冒険をしたんだよと報告するのでした。
The Fairy Basin, you remember, is all covered with ground-ivy (from which they make their castor-oil),	覚えてらっしゃるでしょうか、妖精の溜まり場はツタで覆われていて、妖精たちはツタからヒマシ油を作りました。
with flowers growing in it here and there.	そのあちらこちらに花が育っていました。
Most of them really are flowers, but some of them are fairies.	花のほとんどは本当の花でしたが、いくらかは妖精でした。
You never can be sure of them, but a good plan is	あなたは、どれが妖精か決してはっきりとはわからないでしょう、でもよい方法があります。
to walk by looking the other way, and then turn round sharply.	別の方を見ながら歩いていて、突然振り返るのです。
Another good plan, which David and I sometimes follow, is to stare them down.	もう一つのよい方法は、デビットとわたしが時々やった方法ですが、じっと見つめることです。
After a long time they can't help winking,	ずっと見つめていると、妖精たちはまばたきしてしまいます。
and then you know for certain that they are fairies.	そうすれば、確かにそれが妖精だということがわかるでしょう。
There are also numbers of them along the Baby Walk,	赤ん坊の道沿いにも何人もの妖精がいます。
which is a famous gentle place, as spots frequented by fairies are called.	赤ん坊の道は有名な場所で、妖精たちがよく訪れるところといわれています。
Once twenty-four of them had an extraordinary adventure.	かつて２４人の妖精が、そこで大冒険をくりひろげました。
They were a girls' school out for a walk with the governess,	妖精たちは、女教師といっしょに女学校から散歩に出かけました。
and all wearing hyacinth gowns,	みんなヒヤシンスのガウンを着ていました。
when she suddenly put her finger to her mouth, and then they all stood still on an empty bed and pretended to be hyacinths.	突然教師が口に指をあてると、全員花壇の空いているところに立って、ヒヤシンスのふりをしました。
Unfortunately, what the governess had heard was two gardeners coming to plant new flowers in that very bed.	ついていないことに、教師がききつけたのは、２人の庭師がまさにその花壇の空いている所に花を植えにきた音でした。
They were wheeling a handcart with flowers in it,	かれらは手押し車に花をのせてやってきました。
and were quite surprised to find the bed occupied.	そしてその場所に花が植えられているのをみてとても驚きました。
"Pity to lift them hyacinths,"	「ヒヤシンスを抜くのはかわいそうだなぁ」
said the one man.	一人がいいましたが
"Duke's orders,"	「公爵の命令だからな」
replied the other,	ともう一人が応えました。
and, having emptied the cart, they dug up the boarding-school and put the poor, terrified things in it in five rows.	そして手押し車から花を下ろすと、その寄宿学校を掘り起こして、とてもかわいそうなことに妖精たちを５列にして手押し車にのせました。
Of course, neither the governess nor the girls dare let on that they were fairies,	もちろん教師も生徒もあえて自分たちが妖精だとばらすものはいません。
so they were carted far away to a potting-shed, out of which they escaped in the night without their shoes,	そして遠くの小屋まで運ばれていきましたが、夜のうちに、そこからくつもはかずに逃げ出しました。
but there was a great row about it among the parents, and the school was ruined.	でも親たちの間ではそのことで大さわぎになり、学校はつぶれてしまいました。
As for their houses, it is no use looking for them,	妖精たちの家を探しても無駄なことです。
because they are the exact opposite of our houses.	なぜならわたしたちの家とは似ても似つかないものだからです。
You can see our houses by day but you can't see them by dark.	わたしたちの家は、昼間はみえますが、暗くなるとみることができません。
Well, you can see their houses by dark,	でも妖精たちの家は、暗くなると見えるものなのです。
but you can't see them by day,	でも昼間はみることができません。
for they are the colour of night,	妖精たちの家は、夜の色なのです。
and I never heard of anyone yet who could see night in the daytime.	昼間に夜を見たことがある人の話は聞いたことがないでしょう。
This does not mean that they are black,	妖精たちの色が黒というわけではありません。
for night has its colours just as day has, but ever so much brighter.	夜にも昼とおなじように色があるのです、ただ昼の方がはるかに明るいだけなんです。
Their blues and reds and greens are like ours with a light behind them.	妖精たちの青や赤や緑は、わたしたちのものと同じようなもので、背後から光でてらされているのです。
The palace is entirely built of many-coloured glasses, and is quite the loveliest of all royal residences,	妖精の宮殿はあたり一面がいろいろな色のガラスで作られていて、どんな王族の住居と比べてもひけをとらないものです。
but the queen sometimes complains because the common people will peep in to see what she is doing.	でも女王は自分が何をしているか一般の人が覗いていると、ときどき文句をいいました。
They are very inquisitive folk, and press quite hard against the glass,	妖精たちはとても知りたがりやだったので、ガラスに強く顔を押しつけるのでした。
and that is why their noses are mostly snubby.	それが妖精たちの鼻が、たいがいしし鼻である理由だったりします。
The streets are miles long and very twisty,	宮殿の道は何マイルも続いていて、とても曲がりくねっています。
and have paths on each side made of bright worsted.	両側には、はなやかな毛糸でつくられた小道がありました。
The birds used to steal the worsted for their nests, but a policeman has been appointed to hold on at the other end.	鳥たちは毛糸を自分たちの巣をつくるために盗んでいったので、警官が一人、一方の端をきちんとつかんでいるように任命されたぐらいです。
One of the great differences between the fairies and us is that they never do anything useful.	妖精たちとわたしたちの大きく違うところの一つは、妖精たちは役にたつことはなにもしないということです。
When the first baby laughed for the first time, his laugh broke into a million pieces, and they all went skipping about.	最初のあかんぼうが生まれて最初に微笑むとき、その笑いが無数の破片になって、とびはねます。
That was the beginning of fairies.	それこそが、妖精の生まれるところです。
They look tremendously busy, you know,	あなたも知ってるように、妖精たちはいつもとても忙しそうに見えました。
as if they had not a moment to spare,	まるで余分な時間は少しもないといった具合です。
but if you were to ask them what they are doing, they could not tell you in the least.	でももし妖精たちに何をしているのかを尋ねたら、何一つ説明できなかったでしょう。
They are frightfully ignorant,	妖精たちはびっくりするほど無知です。
and everything they do is make-believe.	そしてやっていることといったら、してるふりだけなのです。
They have a postman,	妖精たちには郵便屋がいます。
but he never calls except at Christmas with his little box,	でもクリスマスのとき小さな箱を持ってくる以外は、やってくることはまずありません。
and though they have beautiful schools, nothing is taught in them;	すてきな学校がありましたが、そこではなにも教えていないのです。
the youngest child being chief person is always elected mistress,	もっとも幼い子供がいつも教師として選ばれました。
and when she has called the roll, they all go out for a walk and never come back.	でも教師が出席をとると、生徒は外に歩きに出かけてしまい、戻ってこないのです。
It is a very noticeable thing that, in fairy families, the youngest is always chief person, and usually becomes a prince or princess,	妖精の家族ではもっとも年が若い者が必ず主人であり、たいてい王子や王女になることはとても注目すべきことです。
and children remember this, and think it must be so among humans also,	子供はそのことを覚えているので、人間の世界でもそうに違いないと考えるのです。
and that is why they are often made uneasy when they come upon their mother furtively putting new frills on the basinette.	そしてそれがお母さんにひそかにゆりかごに新しいフリルをつけているのを見ると、不機嫌になる理由でしょう。
You have probably observed that your baby-sister wants to do all sorts of things that your mother and her nurse want her not to do:	あなたはたぶん、あなたのあかんぼうの妹がお母さんや乳母がしてほしくないと思うことなら何でもしたがることに気づいていることでしょう。
to stand up at sitting-down time, and to sit down at standing-up time, for instance, or to wake up when she should fall asleep, or to crawl on the floor when she is wearing her best frock, and so on,	座っていなければならないときに立ち上がり、立ち上がるときには座り込み、寝なければならないときには目を覚まし、一番いい服をきているときに床をはいまわったりといった具合です。
and perhaps you put this down to naughtiness.	たぶんあなたは、それをやんちゃなせいにするかもしれません。
But it is not;	でもそうではないのです。
it simply means that she is doing as she has seen the fairies do;	それは単に、妖精たちがしていることをみたままに真似しているだけです。
she begins by following their ways, and it takes about two years to get her into the human ways.	生まれたては妖精のやり方を真似して、人間のやり方になれるまでにはだいたい２年ぐらいかかるものです。
Her fits of passion, which are awful to behold, and are usually called teething, are no such thing;	あかんぼうのかんしゃくのけいれんは、見ているのは恐ろしいもので、しばしば歯が生えてくるからと言われていますが、ぜんぜんそんな理由ではありません。
they are her natural exasperation,	それはあかんぼうにとってごく自然な怒りのしるしなのです。
because we don't understand her, though she is talking an intelligible language.	とてもわかりやすい言葉だというのに、わたしたちが理解できないから、怒っているのです。
She is talking fairy.	子供は話す妖精です。
The reason mothers and nurses know what her remarks mean, before other people know, as that "Guch" means "Give it to me at once," while "Wa" is "Why do you wear such a funny hat?" is because, mixing so much with babies, they have picked up a little of the fairy language.	他の人が気づく前に母親や乳母があかんぼうの言ってること、たとえば“ちょ”が“わたしにすぐそれをちょうだい”とか“なっ”が“なぜそんなにおかしな帽子をかぶっているの”に気づくのは、あかんぼうとふれあっているので、妖精のことばをすこしばかり理解しているということなのです。
Of late David has been thinking back hard about the fairy tongue, with his hands clutching his temples,	最近、デビットは、両手でこめかみを強く押さえて昔を振り返り、妖精の言葉を思い出そうとしました。
and he has remembered a number of their phrases which I shall tell you some day if I don't forget.	そしてわたしが忘れなければ、いつかお話しできるいくつかの言い回しを思い出しました。
He had heard them in the days when he was a thrush,	デビットは、自分がつぐみだったときにその言い回しを聞いたということです。
and though I suggested to him that perhaps it is really bird language he is remembering, he says not,	わたしが、たぶんそれは鳥の言葉じゃないかなとほのめかしたときも、彼はそうじゃないといいはりました。
for these phrases are about fun and adventures, and the birds talked of nothing but nest-building.	そしてその言い回しは、おもしろいことと冒険のことだということ、そして鳥たちは巣作りのこと以外はなにも話さないということを思い出しました。
He distinctly remembers	デビットははっきり思い出しました。
that the birds used to go from spot to spot like ladies at shop-windows,	鳥たちが、店のウィンドウからウィンドウへと歩き回る女性のように
looking at the different nests and saying, "Not my colour, my dear," and "How would that do with a soft lining?" and "But will it wear?" and "What hideous trimming!" and so on.	「この巣は色が気に入らない」、「中がこんなにやわらかいんじゃ」とか「でも着てみようかしら」とか「なんてひどい具合なの！」といいながら別の巣を探して、ある場所から別の場所へと落ち着かないものであることを。
The fairies are exquisite dancers,	妖精たちは、見事な踊り手でした。
and that is why one of the first things the baby does is to sign to you to dance to him and then to cry when you do it.	それが、あかんぼうが生まれて最初にすることの一つが、あなたに自分にあわせてダンスするようにと合図して、あなたがそうしたときに泣き声をあげることである理由です。
They hold their great balls in the open air,	妖精たちは戸外で大舞踏会を行いました。
in what is called a fairy-ring.	それは妖精のリングと呼ばれています。
For weeks afterward you can see the ring on the grass.	そのあと何週間もの間、芝生でそのリングをみることができるでしょう。
It is not there when they begin,	妖精たちが踊りはじめたときには、リングはありません。
but they make it by waltzing round and round.	でも妖精たちがくるくるまわりながら踊ることでリングが形作られるのでした。
Sometimes you will find mushrooms inside the ring,	リングのなかにマッシュルームを見つけるかもしれません。
and these are fairy chairs that the servants have forgotten to clear away.	それは、妖精の召使たちが片付け忘れた妖精のいすでした。
The chairs and the rings are the only tell-tale marks these little people leave behind them,	いすとリングが、妖精たちがあとに残して行く唯一の秘密をばらすものでした。
and they would remove even these were they not so fond of dancing that they toe it till the very moment of the opening of the gates.	もし妖精たちが、門が開くぎりぎりまで爪先立って踊るほどダンスが好きでなければ、いすやリングは片付けたでしょう。
David and I once found a fairy-ring quite warm.	デビットとわたしは、一度妖精のリングがきわめてあたたかかったことに気づいたものです。
But there is also a way of finding out about the ball before it takes place.	でも、舞踏会がとりおこなわれることを事前に知るｋ方法は他にもあります。
You know the boards which tell at what time the Gardens are to close to-day.	公園が今日何時に閉まるかを知らせる掲示はごぞんじでしょう。
Well, these tricky fairies sometimes slyly change the board on a ball night,	さて、ずるがしこい妖精たちは、ときどき茶目っ気たっぷりに舞踏会の夜は掲示を変えてしまうのです。
so that it says the Gardens are to close at six-thirty for instance, instead of at seven.	つまりたとえば掲示が公園は７：００に閉まるとなっている代わりに、６：３０に閉まるとしてしまうのです。
This enables them to get begun half an hour earlier.	そうすることで、妖精たちは３０分早く舞踏会を始めることができました。
If on such a night we could remain behind in the Gardens, as the famous Maimie Mannering did, we might see delicious sights,	もしそんな夜に、あの有名なマイミー・マナリングがしたようにわたしたちが公園に残っていたとすれば、すばらしい光景をみることができるでしょう。
hundreds of lovely fairies hastening to the ball, the married ones wearing their wedding-rings round their waists, the gentlemen, all in uniform, holding up the ladies' trains,	何百もの美しい妖精たちが舞踏会に急ぎ、結婚している妖精は腰に結婚指輪をして、男の人は全員正装で、 女性のすそを持ち上げていました。
and linkmen running in front carrying winter cherries,	そしてたいまつ持ちたちは先頭を走って、妖精のたいまつである冬のさくらんぼを運んでいました。
which are the fairy-lanterns, the cloakroom where they put on their silver slippers and get a ticket for their wraps,	クロークでは 銀のスリッパにはきかえて、オーバーを預け、引換券をうけとります。
the flowers streaming up from the Baby Walk to look on, and always welcome	花たちは赤ん坊の道から見物するために押しよせてきて、いつも歓迎されました。
because they can lend a pin,	なぜなら花たちはピンをかしてくれたからです。
the supper-table, with Queen Mab at the head of it, and behind her chair the Lord Chamberlain, who carries a dandelion on which he blows when Her Majesty wants to know the time.	夕食用のテーブルは上席にマブ女王がすわり、女王の椅子の後ろには王室長官がつづき、たんぽぽをもって女王陛下が時間を知りたいときは、それを吹くのでした。
The table-cloth varies according to the seasons,	テーブルクロスも季節によってかわります。
and in May it is made of chestnut-blossom.	５月には栗の花から作ります。
The way the fairy-servants do is this:	妖精の召使はこうやってテーブルクロスを作ります。
The men, scores of them, climb up the trees and shake the branches, and the blossom falls like snow.	召使の２０人ほどが木にのぼり、枝をゆらすと、花が雪のように落ちてきます。
Then the lady servants sweep it together by whisking their skirts until it is exactly like a table-cloth,	そして女性の召使がスカートを払うことで花をはき集めて、ちょうどテーブルクロスになるようにするのでした。
and that is how they get their table-cloth.	それが妖精たちのテーブルクロスを手に入れる方法です。
They have real glasses and real wine of three kinds,	妖精たちは、本物のグラスと３種類のワインを持っていました。
namely, blackthorn wine, berberris wine, and cowslip wine,	つまり黒い棘のワインとバーバリーのワイン、プリムローズのワインです。
and the Queen pours out, but the bottles are so heavy that she just pretends to pour out.	そして女王が注ぐのがきまりですが、ボトルがあまりに重いので女王は注ぐふりをするだけでした。
There is bread and butter to begin with, of the size of a threepenny bit;	はじめは、３ペンスばっかりの大きさのパンとバターがあり、
and cakes to end with,	最後にはケーキがでてきました。
and they are so small that they have no crumbs.	ただそれはとても小さいので、かけらもでないくらいでした。
The fairies sit round on mushrooms, and at first they are very well-behaved and always cough off the table, and so on,	妖精たちはマッシュルームの上に丸く座って、最初はとても礼儀正しくて、テーブルを外して咳きこみます。
but after a bit they are not so well-behaved and stick their fingers into the butter, which is got from the roots of old trees,	しかししばらくすると、それほど礼儀正しくなくなって、古い木の根っこから取ってきたバターに指を突っ込む始末です。
and the really horrid ones crawl over the table-cloth chasing sugar or other delicacies with their tongues.	そしてひどい妖精になるとテーブルクロスの上にあがりこむと、砂糖や他のおいしいものをなめたりしました。
When the Queen sees them doing this she signs to the servants to wash up and put away,	女王はそんな様子を目にすると、召使にさっさとかたづけなさいと合図するのでした。
and then everybody adjourns to the dance, the Queen walking in front	そしてみんながダンスするために立ち上がり、女王が先頭を歩きます。
while the Lord Chamberlain walks behind her, carrying two little pots,	王室長官が後に従い、２つの小さな壺を運んでいました。
one of which contains the juice of wall-flower and the other the juice of Solomon's Seals.	壺のひとつには、ニオイアラセイトウのジュースが、もうひとつにはユリのジュースが入っています。
Wall-flower juice is good for reviving dancers who fall to the ground in a fit, and Solomon's Seals juice is for bruises.	ニオイアラセイトウのジュースは、気を失ってたおれこんだ踊り子を気づかせるのに、ユリのジュースはうち傷にききます。
They bruise very easily	妖精たちはすぐにうち傷を作ってしまいます。
and when Peter plays faster and faster they foot it till they fall down in fits.	ピーターが笛を早くふけばふくほど、妖精たちは気を失ってたおれるまで踊りました。
For, as you know without my telling you, Peter Pan is the fairies' orchestra.	わたしが言うまでもなくおわかりでしょうが、ピーターパンは妖精たちのオーケストラでした。
He sits in the middle of the ring, and they would never dream of having a smart dance nowadays without him.	ピーターは妖精のリングの中心に腰をおろして、ピーターなしではすてきなダンスをするなんて思いもよらないことです。
"P. P." is written on the corner of the invitation-cards sent out by all really good families.	本当にいい家からの招待状の隅にはかならず、「Ｐ．Ｐ」（ピーターパン）とかかれていました。
They are grateful little people, too, and at the princess's coming-of-age ball (they come of age on their second birthday and have a birthday every month) they gave him the wish of his heart.	妖精たちは、また感謝の心をもっていて、王女の舞踏会へのデビューのときには（妖精は２才の誕生日にデビューします、そして誕生日は毎月あります）ピーターの望みをかなえてくれるのでした。
The way it was done was this.	その様子はこのようでした。
The Queen ordered him to kneel, and then said that for playing so beautifully she would give him the wish of his heart.	女王がピーターにひざまずくように命じて、それからとてもきれいな笛をふいてくれるなら、なんでもほしいものをあげようといいます。
Then they all gathered round Peter to hear what was the wish of his heart,	妖精たちはみんなピーターのまわりに、何がほしいのか聞くために集まりました。
but for a long time he hesitated,	しかしピーターは長い間迷っていました。
not being certain what it was himself.	自分でも何がほしいのかはっきりしていなかったのです。
"If I chose to go back to mother,"	「もしぼくがおかあさんのところにもどりたいとしたら、」
he asked at last,	とうとうピーターはこうたずねました。
"could you give me that wish?"	「ぼくのお願いをかなえてくれますか？」
Now this question vexed them,	さあ、この質問にはみんな頭を抱えてしまいました。
for were he to return to his mother they should lose his music,	もしピーターがおかあさんの所に帰ってしまったらもう笛の音を聞くことはできませんから。
so the Queen tilted her nose contemptuously and said,	そして女王が鼻をばかにしたようにつんと上を向けると、こういいました。
"Pooh, ask for a much bigger wish than that."	「やれやれ、もっとましなお願いができないものかね」
"Is that quite a little wish?"	「これはほんのささやかなお願いですか？」
he inquired.	ピーターは尋ねました
"As little as this,"	「これくらいささやかだね」
the Queen answered, putting her hands near each other.	女王は両手を近づけて、その小ささを示しながら答えました。
"What size is a big wish?"	「どれくらいの大きさなら、大きな願いといえるんですか？」
he asked.	とピーターが尋ねると、
She measured it off on her skirt	女王はスカートの上でその大きさを示しました。
and it was a very handsome length.	それはとても大きいものでした。
Then Peter reflected and said,	そしてピーターはよく考えて、言いました。
"Well, then, I think I shall have two little wishes instead of one big one."	「ええ、じゃあ、１つ大きなお願いをする代わりに２つのささやかなお願いをしたいと思うのですが」
Of course, the fairies had to agree, though his cleverness rather shocked them,	妖精たちはピーターがかしこいのにかなりびっくりはしましたが、もちろん承知せざるをえません。
and he said	そしてピーターは続けました。
that his first wish was to go to his mother,	最初のお願いはおかあさんのところにいくことです。
but with the right to return to the Gardens if he found her disappointing. His second wish he would hold in reserve.	でもおかあさんに会ってがっかりしたときに、公園に帰ってくることを許してもらう２つ目のお願いはしばらく言わないことにしました。
They tried to dissuade him, and even put obstacles in the way.	妖精たちはピーターを思いとどまらせようとして、いろいろ邪魔をしようとさえしました。
"I can give you the power to fly to her house,"	「わたしはおまえに家まで飛んでいく力を与えよう」
the Queen said,	女王は言いました。
"but I can't open the door for you."	「でもドアは開けてやらないよ」
"The window I flew out at will be open,"	「出てきた窓が開いてるでしょう」
Peter said confidently.	ピーターは自信をもって言いました。
"Mother always keeps it open in the hope that I may fly back.	「おかあさんはぼくが戻ってくると思って、窓をいつも開けておいてくれるんだ」
"How do you know?"	「どうしてそんなことがわかるんだい？」
they asked, quite surprised,	妖精たちは、とても驚いてたずねました。
and, really, Peter could not explain how he knew.	そして実際ピーターにも、どうしてわかるのかは説明できませんでした。
"I just do know,"	「わかるんだい」
he said.	ピーターはいいはりました。
So as he persisted in his wish, they had to grant it.	そしてピーターは自分の願いもいいはったので、願いを聞かないわけにはいきません。
The way they gave him power to fly was this:	飛ぶ力を与える方法は、
They all tickled him on the shoulder,	妖精がピーターの肩のあたりをくすぐることでした。
and soon he felt a funny itching in that part and then up he rose higher and higher	そしてピーターが肩の辺りにむずむずするものを感じると、だんだん空高く飛び上がりました。
and flew away out of the Gardens and over the house-tops.	そして公園から飛び出して家の屋根を越えていきました。
It was so delicious that instead of flying straight to his old home he skimmed away over St. Paul's to the Crystal Palace and back by the river and Regent's Park,	自分の家までまっすぐ飛んでいくのではなく、セント・ポールをかすめて飛び越えて、クリスタルパレスへ行って、川へもどり、リージェント公園へ飛んで行くのは楽しいことでした。
and by the time he reached his mother's window he had quite made up his mind that his second wish should be to become a bird.	ピーターがおかあさんの窓のところまでたどりついた時には、２つ目のお願いは鳥になることとすっかり決めていたぐらいでした。
The window was wide open,	窓は大きく外に開かれていました。
just as he knew it would be,	まさにピーターがそう思った通りです。
and in he fluttered, and there was his mother lying asleep.	そしてピーターは羽ばたいて中に入り、そこではおかあさんがねむっていました。
Peter alighted softly on the wooden rail at the foot of the bed and had a good look at her.	ピーターはベッドの足の方の木製の枠の上にゆっくり降り立つと、おかあさんにやさしく目をやりました。
She lay with her head on her hand, and the hollow in the pillow was like a nest lined with her brown wavy hair.	おかあさんは腕にあたまをのせて、まくらのへこんだところは鳥の巣みたいで、おかあさんのブラウンの波打った髪で縁取られていました。
He remembered, though he had long forgotten it, that she always gave her hair a holiday at night.	ピーターは、長い間忘れていましたが、おかあさんが夜はいつも髪をしばらないのを思い出しました。
How sweet the frills of her night-gown were.	おかあさんのナイトガウンのフリルは、なんてすばらしいんでしょう。
He was very glad she was such a pretty mother.	ピーターは、自分のおかあさんがこんなに素敵なおかあさんであることをとても喜びました。
But she looked sad,	でもおかあさんは悲しげにみえました。
and he knew why she looked sad.	ピーターには、どうしておかあさんが悲しげにみえるのか分かっていました。
One of her arms moved as if it wanted to go round something,	片腕がまるで何かを抱くように動きました。
and he knew what it wanted to go round.	ピーターには、何を抱こうとしているのか分かっていました。
"Oh, mother,"	「あぁ、おかあさん」
said Peter to himself,	ピーターはつぶやきました。
"if you just knew who is sitting on the rail at the foot of the bed."	「もしベッドの足の枠のところに座っているのが、だれかわかりさえすればねぇ」
Very gently he patted the little mound that her feet made,	ピーターは、おかあさんの足の少し盛り上がっているところをとてもやさしくなでました。
and he could see by her face that she liked it.	そしておかあさんがそれを喜んでいることが顔をみていてわかりました。
He knew he had but to say "Mother" ever so softly, and she would wake up.	でも「おかあさん」と声に出していうのは、いくらやさしく言ってもおかあさんが起きてしまうのでいけないと思っていました。
They always wake up at once if it is you that says their name.	おかあさんというものは子供に名前を呼ばれれば、いつもすぐに目をさますものですから。
Then she would give such a joyous cry and squeeze him tight.	そしてよろこびのあまりさけんで、きつくピーターをだきしめたことでしょう。
How nice that would be to him,	そうであればピーターにとってもどんなによかったことでしょう。
but oh, how exquisitely delicious it would be to her.	そしておかあさんにとっては、どれほどうれしいことだったでしょう。
That I am afraid is how Peter regarded it.	わたしが心配なのは、ピーターがそれくらいそのことを分かっていたかということでした。
In returning to his mother he never doubted that he was giving her the greatest treat a woman can have.	おかあさんのところに戻るにあたっても、ピーターは自分がおかあさんに女の人としての最大限の喜びを与えているんだということを疑ってみもしませんでした。
Nothing can be more splendid, he thought, than to have a little boy of your own.	ピーターは、自分の子供をもつほどすばらしいことはないと思っていたのでした。
How proud of him they are;	おかあさんというものは、どれほど子供をほこりに思うことでしょう。
and very right and proper, too.	それはたしかに正しいし、当たり前のことでもあるのです。
But why does Peter sit so long on the rail, why does he not tell his mother that he has come back?	でもピーターはなぜそれほど長い間ベッドの枠に座っていたのでしょう、なぜおかあさんに帰ってきたよと声をかけなかったのでしょう？
I quite shrink from the truth,	わたしは、本当のことを言うのはとても気が引けます。
which is that he sat there in two minds.	つまりピーターは、２つのことを考えてそこに座っていたのでした。
Sometimes he looked longingly at his mother, and sometimes he looked longingly at the window.	おかあさんをなつかしげにみている一方で、窓の方もあきらめきれないようにみていたのでした。
Certainly it would be pleasant to be her boy again,	たしかにおかあさんの子供に再び戻るのは、楽しいことに違いありません。
but, on the other hand, what times those had been in the Gardens!	でもその一方で、公園もどれほど楽しかったことでしょう！
Was he so sure that he would enjoy wearing clothes again?	また服をきてもたしかに楽しいかどうか自信がもてませんでした。
He popped off the bed and opened some drawers to have a look at his old garments.	ピーターはベッドを急に離れると、自分の昔の服をみるためにいくつか引出しをあけてみました。
They were still there, but he could not remember how you put them on.	自分の服はまだそこにありましたが、どうやって着るのかはもう思い出せません。
The socks, for instance, were they worn on the hands or on the feet?	たとえば靴下は、手にはめるのかな、足にはくのかなといった具合です。
He was about to try one of them on his hand,	靴下の片方を手にはめようとしていたときです。
when he had a great adventure.	ピーターはびっくりしました。
Perhaps the drawer had creaked;	たぶん引出しが音を立てたのでしょう。
at any rate, his mother woke up,	とにかくおかあさんが起きてしまいました。
for he heard her say "Peter,"	おかあさんが「ピーター」というのが聞こえます。
as if it was the most lovely word in the language.	言葉の中でも一番美しい単語です。
He remained sitting on the floor and held his breath,	ピーターは床にすわりこんだまま、かたずをのんでいました。
wondering how she knew that he had come back.	ピーターはどうして自分がもどってきたことがわかったのか不思議に思っていました。
If she said "Peter" again, he meant to cry "Mother" and run to her.	もしおかあさんが再び「ピーター」と呼んだなら、自分もおかあさんとさけんでおかあさんのところにかけていくつもりでした。
But she spoke no more, she made little moans only,	でもおかあさんはそれ以上ひとこともしゃべらず、ただうめき声をあげただけでした。
and when next he peeped at her she was once more asleep, with tears on her face.	ピーターがのぞきこんだときは、おかあさんはまたねむりこんでいましたが、その顔にはなみだが流れていました。
It made Peter very miserable, and what do you think was the first thing he did?	ピーターはとてもみじめな気持ちになり、そしてどうしたと思います？
Sitting on the rail at the foot of the bed, he played a beautiful lullaby to his mother on his pipe.	ベッドの足の方の枠に座って、おかあさんのために美しい子守唄を笛でふきました。
He had made it up himself out of the way she said "Peter,"	おかあさんが「ピーター」とよぶように、自分で唄をつくりました。
and he never stopped playing until she looked happy.	ピーターは、おかあさんが幸せそうに見えるまで笛をふくのをやめませんでした。
He thought this so clever of him that he could scarcely resist wakening her	ピーターは自分のことをとてもかしこいと思ったので、もうすこしでおかあさんを起こして、
to hear her say, "Oh, Peter, how exquisitely you play."	「ピーター、なんて上手に笛がふけるんでしょう」といってもらうところでした。
However, as she now seemed comfortable, he again cast looks at the window.	でもおかあさんがだんだん満足そうに見えたので、また窓の方を見やりました。
You must not think that he meditated flying away and never coming back.	ピーターが飛び出して、二度と帰ってこないつもりだとは、考えないでください。
He had quite decided to be his mother's boy,	ピーターはおかあさんの子供にもどることはすっかり決めていたのです。
but hesitated about beginning to-night.	でも今夜にしようか迷っていたのでした。
It was the second wish which troubled him.	頭をなやましているのは、２つ目のお願いのことでした。
He no longer meant to make it a wish to be a bird, but not to ask for a second wish seemed wasteful,	もう鳥になりたいというお願いをするつもりはありませんが、２つ目のお願いをしないのもなんだか無駄に思えたのでした。
and, of course, he could not ask for it without returning to the fairies.	もちろん妖精たちのところにもどらなければ、お願いすることもできないのですが。
Also, if he put off asking for his wish too long it might go bad.	でももしあんまり長い間お願いを先延ばししていると、めんどうなことになるかもしれません。
He asked himself if he had not been hard-hearted to fly away without saying good-bye to Solomon.	ソロモンにさようならもいわずに別れてしまうのも、心残りでした。
"I should like awfully to sail in my boat just once more,"	「もう一回だけボートに乗りたいんだよ」
he said wistfully to his sleeping mother.	ピーターは、眠っているおかあさんに悲しそうに話しました。
He quite argued with her as if she could hear him.	ピーターはまるでおかあさんが話を聞いているかのように、話しつづけました。
"It would be so splendid to tell the birds of this adventure,"	「鳥たちにこの冒険のことをはなしてやるのは素敵だろうなぁ」
he said coaxingly.	ピーターはなだめすかすように言いました。
"I promise to come back,"	「帰ってくると約束するよ」
he said solemnly and meant it, too.	ピーターははっきりそういうと、本当にそうするつもりでした。
And in the end, you know, he flew away.	そしてやっぱり、最後にはピーターは飛んでいったのです。
Twice he came back from the window, wanting to kiss his mother, but he feared the delight of it might waken her, so at last he played her a lovely kiss on his pipe, and then he flew back to the Gardens.	２回おかあさんにキスしようと思って、窓のところまで舞いもどりましたが、おかあさんを起こしてはいけないと思って、笛ですてきなキスをする曲をひくことにして、公園に飛んでかえっていったのです。
Many nights and even months passed before he asked the fairies for his second wish;	ピーターが２つ目のお願いを妖精たちにするのは、いく晩さらにいく月もたってからでした。
and I am not sure that I quite know why he delayed so long.	それほどピーターが遅くなったのはどうしてか、わたしにもはっきりしたことは分かりません。
One reason was that he had so many good-byes to say, not only to his particular friends, but to a hundred favourite spots.	理由の１つは、特別な友達だけではなく、たくさんの大好きな場所にもさようならを言わなければならなかったことです。
Then he had his last sail,	それから最後の航海にでかけました。
and his very last sail, and his last sail of all, and so on.	まさにピーターにとって本当の最後の航海でした。
Again, a number of farewell feasts were given in his honour;	それからピーターの前途を祝して、お別れの宴が何回も開かれました。
and another comfortable reason was that, after all, there was no hurry,	もう一つゆっくりしててもいい理由としては、結局のところ、急ぐ必要がなかったのでした。
for his mother would never weary of waiting for him.	なぜなら、おかあさんがピーターを待っていることにうんざりすることは決してなかったからでした。
This last reason displeased old Solomon,	その理由は、ソロモンを不機嫌にさせました。
for it was an encouragement to the birds to procrastinate.	なぜなら鳥たちにもぐずぐずしろといっているのと同じだったからです。
Solomon had several excellent mottoes for keeping them at their work, such as	ソロモンは鳥たちに仕事をさせるために、いくつものすばらしいことわざをもっていました。
"Never put off laying to-day, because you can lay to-morrow,"	「明日産めるからといって、今日産めるのをのばさない」、
and "In this world there are no second chances,"	「この世では、チャンスは二度とは来ない」などです。
and yet here was Peter gaily putting off and none the worse for it.	それだけにピーターが楽しそうに先延ばししているのは、いっそう悪いことでした。
The birds pointed this out to each other, and fell into lazy habits.	鳥たちはこのことをいろいろ言いましたが、だんだんなまけぐせがついてきました。
But, mind you, though Peter was so slow in going back to his mother, he was quite decided to go back.	しかし、覚えておいてください、ピーターがおかあさんの所に帰るのをいくら遅らせているとしても、帰ることははっきり決めていたのです。
The best proof of this was his caution with the fairies.	このはっきりとした証拠に、ピーターは妖精たちには注意を払っていたのです。
They were most anxious that he should remain in the Gardens to play to them,	妖精たちは、ピーターに公園に残って笛をふいてほしいと望んでいました。
and to bring this to pass they tried to trick him into making such a remark as	これを実現するために、こんな風に言わせることでピーターをだまそうとしたのです。
"I wish the grass was not so wet,"	「ぼくは芝生がこんなに濡れていないほうがいいなぁ」とか妖精の何人かはピーターが思わず
and some of them danced out of time in the hope that he might cry, "I do wish you would keep time!"	「もっとリズムに乗ってダンスしてほしいね」というように、リズムをはずしてダンスをしたりしました。
Then they would have said that this was his second wish.	それから、それがピーターの２つめの願いだと言おうとしたのです。
But he smoked their design,	しかしピーターは妖精たちのたくらみには乗りません。
and though on occasions he began, "I wish--" he always stopped in time.	ときどき「ぼくの願いは」と言いかけるのですが、いつもすぐに言葉をとめてしまうのでした。
So when at last he said to them bravely,	ただとうとう最後に勇気をふりしぼって、
"I wish now to go back to mother for ever and always,"	「ずっとおかあさんのところに戻っていたい」と言った時には、
they had to tickle his shoulder and let him go.	肩のところをくすぐって、行かせてやらなければなりませんでした。
He went in a hurry in the end	ピーターは最後には、急いで行くことにしました。
because he had dreamt that his mother was crying,	おかあさんが泣いている夢を見たからです。
and he knew what was the great thing she cried for,	おかあさんが何を求めて泣いているかは知っていました。
and that a hug from her splendid Peter would quickly make her to smile.	そしてすばらしいピーターを抱きしめられさえすれば、すぐにでもおかあさんが微笑むのも知っていました。
Oh, he felt sure of it,	ピーターは、そのことを確信してたのです。
and so eager was he to be nestling in her arms that this time he flew straight to the window, which was always to be open for him.	ピーターは、おかあさんの腕によりそいたかったので、今回はいつも自分のために外に開かれている窓のところまでまっすぐ飛んでいきました。
But the window was closed,	しかし窓は閉じていました。
and there were iron bars on it,	そして鉄のかんぬきがそこにかかっていたのです。
and peering inside he saw his mother sleeping peacefully with her arm round another little boy.	中をのぞいてみると、おかあさんが腕の中に別のあかんぼうを抱いて、幸せそうにねているのが見えました。
Peter called,	ピーターは叫びました。
"Mother!	「おかあさん！
mother!"	おかあさん！」
but she heard him not;	ただ、おかあさんの耳にはとどきません。
in vain he beat his little limbs against the iron bars.	自分の小さな翼で鉄のかんぬきをがたがたさせてみましたが、無駄でした。
He had to fly back, sobbing, to the Gardens,	ピーターはすすりなきながら、公園に戻って来なければなりませんでした。
and he never saw his dear again.	そして二度とおかあさんを見ることもありませんでした。
What a glorious boy he had meant to be to her.	ピーターが、どれほどおかあさんにとっていい子になろうとしたことでしょう。
Ah, Peter, we who have made the great mistake, how differently we should all act at the second chance.	わたしたちは大きな失敗をすると、二度目のチャンスにはどれほどのことをしなければならないんでしょう。
But Solomon was right;	しかしソロモンは正しいことを言いました。
there is no second chance,	二度目のチャンスはなし。
not for most of us.	わたしたちにとっても二度目のチャンスはありません。
When we reach the window it is Lock-out Time.	窓のところまで来たときには、もう閉門の時間でした。
The iron bars are up for life.	鉄のかんぬきで、死ぬまで締め出されてしまうのです。
