THE PIT AND THE PENDULUM	落穴と振子
Edgar Allan Poe	エドガー・アラン・ポー
Impia tortorum longos hic turba furores	「ここにかつて神を恐れざる拷問者の群れ、飽くことなく、
Sanguinis innocui, non satiata, aluit.	罪なき者の血に、長くそが狂暴の呪文（じゅもん）を育（はぐく）みぬ。
Sospite nunc patria, fracto nunc funeris antro,	今や国土やすらかに、恐怖の洞穴はうちこわされ、
Mors ubi dira fuit vita salusque patent.	恐ろしき死のありしところ、生命と平安と現われたり」
- Quatrain composed for the gates of a market to be erected upon the site of the Jacobin Club House in Paris.	〔パリのジャコバン倶楽部の遺趾（いし）に建てらるべき市場の門扉にしるすために作られた四行詩〕
I WAS sick,	私は弱っていた、
sick unto death, with that long agony,	――あの長いあいだの苦痛のために、死にそうなくらいひどく弱っていた。
and when they at length unbound me, and I was permitted to sit, I felt that my senses were leaving me.	そして彼らがやっと私の縛（いまし）めを解いて、坐ることを許してくれたときには、もう知覚が失われるのを感じた。
The sentence, the dread sentence of death, was the last of distinct accentuation which reached my ears.	宣告――恐ろしい死刑の宣告――が私の耳にとどいた最後のはっきりした言葉であった。
After that, the sound of the inquisitorial voices seemed merged in one dreamy indeterminate hum.	それからのちは、宗教裁判（１）官たちの声が、なにか夢のような、はっきりしない、がやがやという音のなかに呑みこまれてしまうように思われた。
It conveyed to my soul the idea of REVOLUTION,	それは私の心に回転という観念を伝えた。
perhaps from its association in fancy with the burr of a mill-wheel.	――たぶん、水車の輪のぎいぎいまわる音を連想したからであったろう。
This only for a brief period, for presently I heard no more.	それもほんのちょっとのあいだであった、やがてもう私にはなにも聞えなくなったから。
Yet, for a while, I saw,	しかし少しのあいだはまだ、私には眼が見えた、
but with how terrible an exaggeration !	――がなんという恐ろしい誇張をもって見えたことであろう！
I saw the lips of the black-robed judges.	私には黒い法服を着た裁判官たちの唇が見えた。
They appeared to me white -- whiter than the sheet upon which I trace these words -- and thin even to grotesqueness;	その唇は白く――いまこれらの言葉を書きつけている紙よりも真っ白に――そして怪奇なほど薄く、その冷酷――動かしがたい決意
thin with the intensity of their expression of firmness, of immovable resolution, of stern contempt of human torture.	――人間の苦痛にたいするむごたらしい軽侮を強く示してあくまでも薄く、私の眼にうつった。
I saw that the decrees of what to me was fate were still issuing from those lips.	私は、自分にとっては運命であるところの判決が、なおその唇から出ているのを見た。
I saw them writhe with a deadly locution.	その唇が恐ろしい話しぶりでねじれるのを見た。
I saw them fashion the syllables of my name,	その唇が私の名の音節を言う形になるのを見た。
and I shuddered, because no sound succeeded.	そしてそれにはなんの音もないので私は戦慄（せんりつ）した。
I saw, too, for a few moments of delirious horror, the soft and nearly imperceptible waving of the sable draperies which enwrapped the walls of the apartment;	私はまた、この無我夢中の恐怖の数瞬間に、その部屋の壁を蔽（おお）うている黒い壁掛けが静かに、ほとんど眼にたたぬほどかすかに、揺れるのを見た。
and then my vision fell upon the seven tall candles upon the table.	それから私の視線はテーブルの上にある七本の高い蝋燭（ろうそく）に落ちた。
At first they wore the aspect of charity, and seemed white slender angels who would save me:	最初はその蝋燭が慈悲深い様子をしていて、自分を救ってくれそうな白いほっそりとした天使たちのように思われた。
but then all at once there came a most deadly nausea over my spirit, and I felt every fibre in my frame thrill, as if I had touched the wire of a galvanic battery, while the angel forms became meaningless spectres, with heads of flame, and I saw that from them there would be no help.	だがその次には、たちまち非常に恐ろしい嫌悪の情が私の心をおそってきて、体じゅうのあらゆる繊維が流電池の線にでも触れたようにぴりぴりと震えるのを感じ、同時に天使の姿は炎の頭をした無意味な妖怪（ようかい）となってしまい、彼らからはなんの救いも得られないということがわかった。
And then there stole into my fancy, like a rich musical note, the thought of what sweet rest there must be in the grave.	それから私の空想のなかへは、墓のなかにはさぞ甘美な休息があるにちがいないという考えが、美しい音楽の調べのように、しのびこんできた。
The thought came gently and stealthily, and it seemed long before it attained full appreciation;	この考えはゆっくりと、またこっそりとやってきて、それを十分味わえるようになるまでにはだいぶ長くかかったようであった。
but just as my spirit came at length properly to feel and entertain it, the figures of the judges vanished, as if magically, from before me;	だが私の心がやっとはっきりとその考えを感じ、それを味わったちょうどその瞬間、裁判官たちの姿は魔法のように私の前から消えた。
the tall candles sank into nothingness;	高い蝋燭は虚無のなかへ沈み、
their flames went out utterly;	その炎もすっかり消えうせてしまった。
the blackness of darkness superened ;	真っ黒な暗闇がそれにつづいた。
all sensations appeared swallowed up in a mad rushing descent as of the soul into Hades.	あらゆる感覚は冥府（めいふ）へ落ちる霊魂のように、狂おしい急激な下降のなかに嚥（の）みこまれるように思われた。
Then silence, and stillness, and night were the universe.	そのあとはただ、沈黙と、静止と、夜とが、宇宙全体であった。
I had swooned;	私は気絶していたのであった。
but still will not say that all of consciousness was lost.	しかしそれでも意識がすっかり失われていたとは言いたくない。
What of it there remained I will not attempt to define, or even to describe;	それがどれくらい残っていたかということは、ここで断定しようとは思わないし、書こうとも思わない。
yet all was not lost.	だがすべてが失われていたのではなかった。
In the deepest slumber -- no!	深い眠りのなかでも――いや！
In delirium -- no!	無我夢中のときでも――いや！
In a swoon -- no!	気絶しているときでも――いや！
In death -- no!	死んでいても――いや！
Even in the grave all was not lost.	墓のなかにあってさえも、すべてが失われるものではないのだ。
Else there is no immortality for man.	でなければ人間にとって不滅ということがなくなる。
Arousing from the most profound of slumbers, we break the gossamer web of some dream.	もっとも深い眠りから覚めるとき、我々はなにかしら薄紗（うすもの）のような夢を破るものである。
Yet in a second afterwards (so frail may that web have been) we remember not that we have dreamed.	しかし一秒もたつと（その薄いものはそれほど脆（もろ）いものであろう）我々はいままで夢をみていたことをもう覚えていない。
In the return to life from the swoon there are two stages;	気絶からよみがえるまでには二つの段階がある。
first, that of the sense of mental or spiritual;	第一は、心的もしくは精神的存在の知覚の段階であり、
secondly, that of the sense of physical existence.	第二は、肉体的存在の知覚のそれである。
It seems probable that if, upon reaching the second stage, we could recall the impressions of the first, we should find these impressions eloquent in memories of the gulf beyond.	もし我々がこの第二の段階に達したときに、第一の段階の印象を思い起すことができるとするなら、これらの印象が彼岸の深淵（しんえん）の記憶を雄弁に語っていると言ってもよいようだ。
And that gulf is, what?	そしてその深淵とは――なんであるか？
How at least shall we distinguish its shadows from those of the tomb?	我々はどうして、少なくともその深淵の影を死の影と区別したらいいか？
But if the impressions of what I have termed the first stage are not at will recalled, yet, after long interval, do they not come unbidden, while we marvel whence they come?	しかし私が第一の段階と名づけたものの印象がもし意のままに思い起されないものとしても、長いあいだたったのちに、それらの印象が自然にやってきて、どこからやってきたのかと怪しむようなことはあるまいか？
He who has never swooned is not he who finds strange palaces and wildly familiar faces in coals that glow;	かつて一度も気絶したことのない人は、赤々と燃え輝いている石炭のなかに、不思議な宮殿やどこか見知ったような顔などを見る人ではない。
is not he who beholds floating in mid-air the sad visions that the many may not view;	世の多くの人々の眼にはうつらないような悲しげな幻影が空中に浮んでいるのを見る人でもない。
is not he who ponders over the perfume of some novel flower;	なにかの珍しい花の香を嗅（か）いでもの思いにふける人でもない。
is not he whose brain grows bewildered with the meaning of some musical cadence which has never before arrested his attention.	いままではなんの注意もひいたことのないような音楽の韻律の意味を考えて頭が乱される人でもない。
Amid frequent and thoughtful endeavours to remember, amid earnest struggles to regather some token of the state of seeming nothingness into which my soul had lapsed, there have been moments when I have dreamed of success;	思い出そうとする考え深いいくたびもの試みの最中に、私の霊魂が落ちていったあの虚無らしい状態の形跡をよせ集めようとする熱心な努力の最中に、ときどきうまく思い出せたと思う瞬間があった。
there have been brief, very brief periods when I have conjured up remembrances which the lucid reason of a later epoch assures me could have had reference only to that condition of seeming unconsciousness.	あとになって明晰（めいせき）な理性の保証するところによると、その無意識らしい状態にだけ関している記憶を、呼び起した短い、ごく短い時期があった。
These shadows of memory tell indistinctly of tall figures that lifted and bore me in silence down -- down -- still down -- till a hideous dizziness oppressed me at the mere idea of the interminableness of the descent.	この影のような記憶がぼんやりと語っているところによると、背の高い者たちが、無言のまま私の体を持ち上げて、下の方へ――下の方へ――なおも下の方へと運んでいったので、とうとう私はその果てしない下降ということを考えただけで気持の悪い眩暈（めまい）に圧倒されてしまったのだ。
They tell also of a vague horror at my heart on account of that heart's unnatural stillness.	また私は、心が不自然なほど静かだったので、漠然とした恐怖を感じたのだ。
Then comes a sense of sudden motionlessness throughout all things;	次にはすべてのものがみな急に動かなくなったという知覚がきた。
as if those who bore me (a ghastly train!) had outrun, in their descent, the limits of the limitless , and paused from the wearisomeness of their toil.	まるで私を運んでいる者たち（恐ろしい一行！）が下降しながらとっくに限りないものの限界をも越えてしまって、彼らの労苦に疲れはてた歩みをとどめたかのように。
After this I call to mind flatness and dampness;	そののちに思い起すのは平坦と湿気との感じである。
and then all is MADNESS -- the madness of a memory which busies itself among forbidden things.	それからはすべてが狂乱――考えることを許されないいまわしいもののあいだを忙しくとびまわる記憶の狂乱である。
Very suddenly there came back to my soul motion and sound -- the tumultuous motion of the heart, and in my ears the sound of its beating.	まったくとつぜんに、私の魂に運動と音とが――心臓のはげしい運動と、耳に響くその鼓動の音とが、戻ってきた。
Then a pause in which all is blank.	それからいっさいが空白である合間。
Then again sound, and motion, and touch, a tingling sensation pervading my frame.	やがてまた音と、運動と、触覚――体じゅうにしみわたるぴりぴり疼（うず）く感覚。
Then the mere consciousness of existence, without thought, a condition which lasted long.	次に思考力を伴わない単なる生存の意識、――この状態は長くつづいた。
Then, very suddenly, THOUGHT, and shuddering terror, and earnest endeavour to comprehend my true state.	それからまったくとつぜんに、思考力と、戦慄するような恐怖感と、自分のほんとうの状態を知りつくそうとする熱心な努力。
Then a strong desire to lapse into insensibility.	つぎには無感覚になってしまいたいという強烈な願望。
Then a rushing revival of soul and a successful effort to move.	それから魂の急速なよみがえりと、動こうとする努力の成功。
And now a full memory of the trial, of the judges, of the sable draperies, of the sentence, of the sickness, of the swoon.	そして今度は審問や、裁判官たちや、黒い壁掛けや、宣告や、衰弱や、気絶などの完全な記憶。
Then entire forgetfulness of all that followed; of all that a later day and much earnestness of endeavour have enabled me vaguely to recall.	それからは、その後につづいたすべてのことの、後日になって熱心な努力でやっと漠然と思い起すことのできたすべてのことの、完全な忘却。
So far I had not opened my eyes.	これまでは私は眼を開かなかった。
I felt that I lay upon my back unbound.	私は縛めを解かれて仰向けに横たわっているのを感じた。
I reached out my hand, and it fell heavily upon something damp and hard.	手を伸ばすと、何かじめじめした硬いものにどたりと落ちた。
There I suffered it to remain for many minutes, while I strove to imagine where and what I could be.	何分間もそこに手を置いたまま、自分がどこにいてどうなっているのか想像しようと努めた。
I longed, yet dared not, to employ my vision.	眼を開いて見たかったが、そうするだけの勇気がなかった。
I dreaded the first glance at objects around me.	身のまわりのものを最初にちらと見ることを私は恐れたのだ。
It was not that I feared to look upon things horrible,	恐ろしいものを見るのを恐れたのではない。
but that I grew aghast lest there should be NOTHING to see.	なにも見るものがないのではあるまいかと思って恐ろしくなったのだった。
At length, with a wild desperation at heart, I quickly unclosed my eyes.	とうとう、はげしい自暴自棄の気持で、眼をぱっとあけてみた。
My worst thoughts, then, were confirmed.	すると私のいちばん恐れていた考えが事実となってあらわれた。
The blackness of eternal night encompassed me.	永遠の夜の暗黒が私を包んでいるのだ。
I struggled for breath.	私は息をしようとしてもがいた。
The intensity of the darkness seemed to oppress and stifle me.	濃い暗闇は私を圧迫し窒息させるように思われた。
The atmosphere was intolerably close.	空気は堪えがたいほど息づまるようであった。
I still lay quietly, and made effort to exercise my reason.	私はなおじっと横たわって、理性を働かせようと努めた。
I brought to mind the inquisitorial proceedings, and attempted from that point to deduce my real condition.	宗教裁判官のやり方を思い出して、その点から自分のほんとうの状態を推定してみようと試みた。
The sentence had passed, and it appeared to me that a very long interval of time had since elapsed.	宣告が言いわたされ、それから非常に長い時間がたっているような気がした。
Yet not for a moment did I suppose myself actually dead.	しかし自分が実際に死んでいると想像したことは一瞬時もなかった。
Such a supposition, notwithstanding what we read in fiction , is altogether inconsistent with real existence;	そのような想像は、物語では読むことはあるが、ほんとうの生存とはぜんぜん矛盾するものである。
-- but where and in what state was I?	――だが、いったい私はどこに、どんな状態でいるのであろう？
The condemned to death, I knew, perished usually at the auto-da-fes,	死刑を宣告された者が通常 autos-da-f（「信仰の行為（２）」）で殺されることは私も知っていた。
and one of these had been held on the very night of the day of my trial.	そしてそれが私の審問された日のちょうどその夜にも執行されたのであった。
Had I been remanded to my dungeon, to await the next sacrifice, which would not take place for many months?	私は自分の牢（ろう）へ送りかえされて幾月ものあいだ起りそうにもない次の犠牲を待つことになったのであろうか？
This I at once saw could not be.	そんなことがあるはずはないと私はすぐ悟った。
Victims had been in immediate demand.	犠牲者はすぐに必要なのだ。
Moreover my dungeon, as well as all the condemned cells at Toledo, had stone floors, and light was not altogether excluded.	そのうえ、私の前の牢は、トレード（３）にあるすべての監房と同じように、石の床であって、光線がぜんぜんさえぎられてはいなかった。
A fearful idea now suddenly drove the blood in torrents upon my heart,	恐ろしい考えがこのとき急に念頭に浮び、血は奔流のように心臓へ集まった。
and for a brief period I once more relapsed into insensibility.	そして少しのあいだ、私はもう一度無感覚の状態にあともどりした。
Upon recovering, I at once started to my feet, trembling convulsively in every fibre.	我に返るとすぐ、全身の繊維が痙攣（けいれん）的に震えながらも、すっと立ち上がった。
I thrust my arms wildly above and around me in all directions.	頭の上や身のまわりやあらゆる方向に両腕を乱暴に突き出してみた。
I felt nothing;	なんにも触れなかった。
yet dreaded to move a step, lest I should be impeded by the walls of a TOMB.	それでも墓穴の壁に突き当りはしないかと思って、一歩でも動くことを恐れた。
Perspiration burst from every pore, and stood in cold big beads upon my forehead.	汗が体じゅうの毛孔から流れ出て、額には冷たい大きな玉がたまった。
The agony of suspense grew at length intolerable,	この不安な苦痛にとうとう堪えられなくなった。
and I cautiously moved forward, with my arms extended , and my eyes straining from their sockets, in the hope of catching some faint ray of light.	そこで両手をひろげ、かすかな光線でもとらえようと思って眼を眼窩（がんか）から突き出すようにしながら、注意深く前へ動いた。
I proceeded for many paces, but still all was blackness and vacancy.	私は何歩も進んだ、しかしやはりすべてが暗黒と空虚とであった。
I breathed more freely.	私はいままでよりも自由に呼吸をした。
It seemed evident that mine was not, at least, the most hideous of fates.	私の運命が少なくともいちばん恐ろしいものではないことはまず明らかであるように思われた。
And now, as I still continued to step cautiously onward, there came thronging upon my recollection a thousand vague rumours of the horrors of Toledo.	そしてなおも注意深く前へ歩きつづけているあいだに、今度はトレードの恐怖についてのいろいろの漠然とした噂（うわさ）が、私の記憶に群がりながら浮んできた。
Of the dungeons there had been strange things narrated	牢については前から奇妙なことが言い伝えられていた。
-- fables I had always deemed them	――つくり話だと私はいつも思っていたが
-- but yet strange, and too ghastly to repeat, save in a whisper.	――しかしいかにも奇妙な、声をひそめてでなければくりかえして話すことができないくらいにもの凄（すご）い話であった。
Was I left to perish of starvation in this subterranean world of darkness;	私はこの地下の暗黒の世界で餓死させられるのであろうか？
or what fate perhaps even more fearful awaited me?	さもなければ、たぶん、それよりもっと恐ろしいものではあろうが、どんな運命が私を待っているのであろうか？
That the result would be death, and a death of more than customary bitterness, I knew too well the character of my judges to doubt.	その結果が死であり、それも普通の苦しさ以上の死であろうということは、あの裁判官らの性質をよく知っている私には疑う余地もなかった。
The mode and the hour were all that occupied or distracted me.	ただその方法と時間とが、私を考えさせ、あるいは悩ましたすべてであった。
My outstretched hands at length encountered some solid obstruction.	ひろげていた手はとうとうなにか固い障害物につき当った。
It was a wall, seemingly of stone masonry -- very smooth, slimy, and cold.	それは壁であったが、石造らしく――ひどくなめらかで、ぬらぬらしていて、冷たかった。
I followed it up;	私はそれについて行った。
stepping with all the careful distrust with which certain antique narratives had inspired me.	ある昔の物語が教えてくれた注意深い警戒の念をもって、一歩一歩進んだ。
This process, however, afforded me no means of ascertaining the dimensions of my dungeon;	しかし、この方法は牢の広さを確かめる手段とはならなかった。
as I might make its circuit, and return to the point whence I set out, without being aware of the fact, so perfectly uniform seemed the wall.	というのは、一まわりしてもとの出発点に戻っていても、そのことがわからないからであって、それほどその壁は完全に一様なものらしかった。
I therefore sought the knife which had been in my pocket when led into the inquisitorial chamber,	そこで私は、宗教裁判所の部屋のなかへ連れて行かれたときにポケットのなかにあったナイフを探した。
but it was gone;	がそれはなかった。
my clothes had been exchanged for a wrapper of coarse serge.	私の衣服は粗末なセルの着物にかわっていたのだ。
I had thought of forcing the blade in some minute crevice of the masonry, so as to identify my point of departure.	出発点を認められるようにそのナイフの刀身をどこか石の小さい隙間にさしこんでおこうと思ったのであったが。
The difficulty, nevertheless, was but trivial, although, in the disorder of my fancy, it seemed at first insuperable.	しかしこの困難は、心が乱れていたので初めはどうにもできないもののように思われたが、実はちょっとしたものにすぎなかった。
I tore a part of the hem from the robe, and placed the fragment at full length, and at right angles to the wall.	私は着物のへりを一部分ひき裂いてその布片（きれ）をずっと伸ばして、壁と直角に置いた。
In groping my way around the prison, I could not fail to encounter this rag upon completing the circuit.	牢獄のまわりを手さぐりして回っているうちに、完全に一周すればこの布片に出会うことはまちがいない。
So, at least, I thought,	少なくともそう私は考えた。
but I had not counted upon the extent of the dungeon, or upon my own weakness.	だが、この牢の広さや、または自分の衰弱を、勘定に入れていなかった。
The ground was moist and slippery.	地面はじめじめしてすべった。
I staggered onward for some time, when I stumbled and fell.	私はしばらくのあいだ前へよろめきながら進んでいたが、そのうちにつまずいて倒れた。
My excessive fatigue induced me to remain prostrate,	ひどい疲労のために倒れたまま起き上がれなかった。
and sleep soon overtook me as I lay.	そして横になるとすぐ眠りが私をおそった。
Upon awaking, and stretching forth an arm, I found beside me a loaf and a pitcher with water.	目が覚めて、片腕を伸ばすと、かたわらには一塊のパンと水の入った水差しとが置いてあった。
I was too much exhausted to reflect upon this circumstance , but ate and drank with avidity.	ひどく疲れきっていたので、私はこの事がらを十分考えてみることもなく、がつがつと貪（むさぼ）るように食ったり飲んだりした。
Shortly afterwards I resumed my tour around the prison, and with much toil came at last upon the fragment of the serge.	それから間もなく牢獄のなかをまた回りはじめ、かなり骨を折ってやっとあのセルの布片のところへやってきた。
Up to the period when I fell I had counted fifty-two paces, and upon resuming my walk I had counted forty-eight more, when I arrived at the rag.	つまずいて倒れるときまでに五十二歩を数え、また歩きはじめてからさらに四十八歩を数えて――そのときに布片のところへ着いたのであった。
There were in all, then, a hundred paces;	してみると全体で百歩あることになる。
and, admitting two paces to the yard, I presumed the dungeon to be fifty yards in circuit.	そして二歩を一ヤードとして私はこの牢獄の周囲を五十ヤードと推定した。
I had met, however, with many angles in the wall, and thus I could form no guess at the shape of the vault, for vault I could not help supposing it to be.	しかし壁のところで多くの角に出会ったので、この窖（あなぐら）――窖であろうということは想像しないわけにはゆかなかった――の形状を推測することはできなかった。
I had little object -- certainly no hope -- in these researches,	このような調査には私はほとんど目的を――たしかに希望などは少しも――持っていなかった。
but a vague curiosity prompted me to continue them.	けれども漠然とした好奇心が私を駆ってその調査をつづけさせた。
Quitting the wall, I resolved to cross the area of the enclosure.	私は壁のところを離れて、この構内の地域を横断してみようと決心した。
At first I proceeded with extreme caution,	初めは非常に用心しながら進んだ。
for the floor although seemingly of solid material was treacherous with slime.	床は固い物質でできているらしかったが、ねばねばしていて油断がならなかったからだ。
At length, however, I took courage and did not hesitate to step firmly -- endeavouring to cross in as direct a line as possible.	しかしとうとう勇気を出して、ためらわずにしっかりと足を踏み出した、――できるだけ一直線によぎろうと努めながら。
I had advanced some ten or twelve paces in this manner, when the remnant of the torn hem of my robe became entangled between my legs.	こんなふうにして十歩か十二歩ばかり進んだときに、さっきひき裂いた着物のへりの残片が両足のあいだに絡まった。
I stepped on it, and fell violently on my face.	私はそれを踏みつけて、ばったりと俯向（うつむ）けに倒れてしまった。
In the confusion attending my fall, I did not immediately apprehend a somewhat startling circumstance , which yet, in a few seconds afterward, and while I still lay prostrate, arrested my attention.	倒れた当座は狼狽（ろうばい）していたので、一つのちょっと驚くべき事がらにすぐ気づくわけにはゆかなかったが、何秒かたつと、まだ倒れているあいだに、それが私の注意をひいた。
It was this:	それはこういうことであった。
my chin rested upon the floor of the prison, but my lips, and the upper portion of my head, although seemingly at a less elevation than the chin, touched nothing.	私の頤（おとがい）は牢獄の床の上についていたが、唇や頭の上部が、顎よりも低くなっているらしいのに、なににも触れていないのである。
At the same time, my forehead seemed bathed in a clammy vapour, and the peculiar smell of decayed fungus arose to my nostrils.	同時に額がしっとりとした湿気にひたっているように思われ、腐った菌類の独得の臭いが鼻をついてきた。
I put forward my arm,	私は片手を突き出した。
and shuddered to find that I had fallen at the very brink of a circular pit,	すると自分が円い落穴（おとしあな）のちょうど縁のところに倒れていることに気がついたので、ぞっと身ぶるいした。
whose extent of course I had no means of ascertaining at the moment.	その落穴の大きさはもちろん、そのときには確かめる方法もなかったが。
Groping about the masonry just below the margin, I succeeded in dislodging a small fragment, and let it fall into the abyss.	私はその縁のすぐ下の石細工のあたりを手さぐりして、うまく小さな石のかけらを取り出し、それをその深淵のなかへ落してみた。
For many seconds I hearkened to its reverberations as it dashed against the sides of the chasm in its descent;	何秒ものあいだ、石が落ちてゆくとき落穴の壁につき当る反響に、私はじっと耳を傾けていた。
at length there was a sullen plunge into water, succeeded by loud echoes.	とうとう陰鬱に水のなかへ落ちて、高い反響がそのあとにつづいた。
At the same moment there came a sound resembling the quick opening, and as rapid closing of a door overhead, while a faint gleam of light flashed suddenly through the gloom, and as suddenly faded away.	それと同時に、頭上で戸をぱっとあけ、また同じようにすばやくしめるような音がして、一すじの弱い光線がとつぜん暗闇のなかにひらめいたかと思うと、またたちまちにして消えてしまった。
I saw clearly the doom which had been prepared for me,	私は自分のために用意されてあった運命をはっきりと知った。
and congratulated myself upon the timely accident by which I had escaped.	そしてちょうど折よく偶然に起った出来事によって助かったことを喜んだ。
Another step before my fall, and the world had seen me no more	倒れる前にもう一歩進む、すると私はふたたびこの世に出ることができなかったのだ。
and the death just avoided was of that very character which I had regarded as fabulous and frivolous in the tales respecting the Inquisition.	そしていままぬかれた死こそは、宗教裁判所に関する話のなかで荒唐無稽な愚にもつかぬものと私のそれまで思いこんでいた種類のものであったのだ。
To the victims of its tyranny, there was the choice of death with its direst physical agonies, or death with its most hideous moral horrors.	宗教裁判の暴虐の犠牲者には、もっとも恐るべき肉体的の苦痛を伴う死か、またはもっともいまわしい精神的の恐怖を伴う死か、どちらかを選ぶのである。
I had been reserved for the latter.	私はその後者を受けることになっていたのだ。
By long suffering my nerves had been unstrung, until I trembled at the sound of my own voice, and had become in every respect a fitting subject for the species of torture which awaited me.	長いあいだの苦痛のために、私の神経は自分の声にさえ身ぶるいするほど衰弱し、どんな点からでも、自分を待ち受けているこの種の迫害にはたいへん適当な材料となっていたのであった。
Shaking in every limb, I groped my way back to the wall	手足をぶるぶる震わせながら、私は壁の方へ手さぐりで戻った、
-- resolving there to perish rather than risk the terrors of the wells, of which my imagination now pictured many in various positions about the dungeon.	――私の想像力がいまこの牢獄のいろいろな位置にたくさん描き出した落穴の恐怖をおかすよりも、むしろその壁のところで死のうと心を決めながら。
In other conditions of mind I might have had courage to end my misery at once by a plunge into one of these abysses;	もっとも他の心持ちでいたときなら、私はこれらの深淵の一つへ跳びこんで一思いに自分の惨めな運命の結末をつけてしまう勇気があったろう。
but now I was the veriest of cowards.	だがそのとき私はもっとも完全な臆病者であった。
Neither could I forget what I had read of these pits -- that the SUDDEN extinction of life formed no part of their most horrible plan.	私はまたこれらの落穴について前に読んだこと――とっさに生命を絶つということは彼らの恐ろしい計画のなかには少しもないということ――も忘れることができなかった。
Agitation of spirit kept me awake for many long hours;	精神の興奮は幾時間も私を眠らせなかった。
but at length I again slumbered.	がとうとう私はふたたび眠りに落ちた。
Upon arousing, I found by my side, as before, a loaf and a pitcher of water.	目を覚ますと、前と同じように一塊のパンと水の入った水差しとが置いてあった。
A burning thirst consumed me, and I emptied the vessel at a draught.	焼くような渇きを覚えたので、私はその水差しの水を一飲みに飲みほした。
It must have been drugged,	それには薬がまぜてあったにちがいない、
for scarcely had I drunk before I became irresistibly drowsy.	――飲むか飲まないうちにたまらなく睡くなったから。
A deep sleep fell upon me	深い眠りが私におそいかかってきた、
-- a sleep like that of death.	――死の眠りのような深い眠りが。
How long it lasted of course I know not;	どれだけ長くそれがつづいたか、もちろん私にはわからない。
but when once again I unclosed my eyes the objects around me were visible.	しかしまた眼を開いたときには、今度は身のまわりのものが見えるようになっていた。
By a wild sulphurous lustre, the origin of which I could not at first determine, I was enabled to see the extent and aspect of the prison.	どこにその光源があるのか初めはわかりかねた異様な硫黄色の微光によって、この牢獄の広さや様子を見ることができたのだ。
In its size I had been greatly mistaken.	牢獄の大きさについて私はひどく思い違いをしていた。
The whole circuit of its walls did not exceed twenty-five yards.	壁の全周囲は二十五ヤードを超えていなかった。
For some minutes this fact occasioned me a world of vain trouble;	この事実は数分のあいだ、私に役にも立たない非常な苦労をさせた。
vain indeed	まったく役にも立たない、
-- for what could be of less importance, under the terrible circumstances which environed me than the mere dimensions of my dungeon?	――なぜなら、私の取りまかれているこの恐ろしい事情のもとにあって、牢獄の面積などということよりも下らないことがあろうか？
But my soul took a wild interest in trifles,	だが、私の心はつまらないことに異常な興味を持っていた。
and I busied myself in endeavours to account for the error I had committed in my measurement.	そして、測量をするときに自分が犯した誤ちの理由を明らかにしようとする努力に没頭した。
The truth at length flashed upon me.	とうとう真相が頭に閃（ひらめ）いた。
In my first attempt at exploration I had counted fifty-two paces up to the period when I fell;	最初に探索しようと試みたときには、倒れるまでに五十二歩を数えていた。
I must then have been within a pace or two of the fragment of serge;	そのときはセルの布片へもう一歩か二歩というところへまで来ていたにちがいない。
in fact I had nearly performed the circuit of the vault.	実際、私はほとんど窖を一周していたのだ。
I then slept,	それから眠った、
and upon awaking, I must have returned upon my steps,	――そして眼が覚めると、前に歩いたところを逆に戻ったにちがいない、
thus supposing the circuit nearly double what it actually was.	――こうして周囲を実際のほとんど二倍に想像したのだ。
My confusion of mind prevented me from observing that I began my tour with the wall to the left, and ended it with the wall to the right.	心が混乱していたので、私は壁を左にして歩きだし、戻ったときには壁を右にしていたことに気づかなかったのだ。
I had been deceived too in respect to the shape of the enclosure.	私はまた、この構内の形についてもだまされていた。
In feeling my way I had found many angles, and thus deduced an idea of great irregularity,	手さぐりながら歩いたときに角がたくさんあったので、ずいぶん不規則な形だという考えを持っていたのであった。
so potent is the effect of total darkness upon one arousing from lethargy or sleep!	昏睡（こんすい）や睡眠からさめた者に与えるまったくの暗闇の効果というものはこんなに強いものなのだ！
The angles were simply those of a few slight depressions or niches at odd intervals.	角というのはただ、不規則な間隔をおいたいくつかの凹み、あるいは壁龕（へきがん）にすぎなかった。
The general shape of the prison was square.	牢獄の全体の形は四角であった。
What I had taken for masonry seemed now to be iron, or some other metal in huge plates, whose sutures or joints occasioned the depression.	私が前に石細工だと考えたものは、今度は鉄かあるいはなにか他の金属の大きな板らしく思われ、その継目（つぎめ）が凹みになっているのであった。
The entire surface of this metallic enclosure was rudely daubed in all the hideous and repulsive devices to which the charnel superstition of the monks has given rise.	この金属板を張った構内の壁の全面には、修道僧の気味の悪い迷信が生みだした恐ろしく厭（いと）わしい意匠の画が、不器用に描きなぐってあった。
The figures of fiends in aspects of menace, with skeleton forms and other more really fearful images, overspread and disfigured the walls.	骸骨（がいこつ）の形をして脅すような容貌をした悪鬼の姿や、そのほか実に恐ろしい画像などが、一面にひろがって壁をよごしていた。
I observed that the outlines of these monstrosities were sufficiently distinct, but that the colours seemed faded and blurred, as if from the effects of a damp atmosphere.	私は、これらの怪物の輪郭は十分はっきりしているが、その色彩が湿った空気のためであろうか、褪（あ）せてぼんやりしているらしいことを認めた。
I now noticed the floor, too,	それから今度は床にも注意してみた
which was of stone.	――が、それは石造だった。
In the centre yawned the circular pit from whose jaws I had escaped ;	その真ん中に、さっきその虎口をのがれたあの円い落穴が口を開いていた。
but it was the only one in the dungeon.	がそれはこの牢獄のなかにただ一つしかなかった。
All this I saw indistinctly and by much effort,	こういうことをすべて私はぼんやりと、しかも非常な努力をして、見たのだ。
for my personal condition had been greatly changed during slumber.	――というわけは、体の状態が眠っているあいだにひどく変っていたからである。
I now lay upon my back, and at full length, on a species of low framework of wood.	今度は仰向けになって体をながながと伸ばし、低い木製の枠組（わくぐみ）のようなものの上に臥（ね）ていた。
To this I was securely bound by a long strap resembling a surcingle.	その枠に馬の上腹帯に似た長い革紐でしっかりと縛りつけられているのだ。
It passed in many convolutions about my limbs and body, leaving at liberty only my head, and my left arm to such extent that I could by dint of much exertion supply myself with food from an earthen dish which lay by my side on the floor.	革紐は手足や胴体にぐるぐると巻きつけてあって、頭と左腕とだけが自由になっていたが、その左腕も非常な骨折りをしてやっと、かたわらの床の上に置いてある土器の皿から食物を取ることができるだけの程度にすぎなかった。
I saw to my horror that the pitcher had been removed .	恐ろしいことには、水差しがなくなっていた。
I say to my horror, for I was consumed with intolerable thirst.	恐ろしいことには――というのは、堪えがたいほどの渇きのために体が焼きつくされるようであったからだ。
This thirst it appeared to be the design of my persecutors to stimulate,	この渇きを刺激するのが私の迫害者どもの計画であったらしい、
for the food in the dish was meat pungently seasoned.	――なぜなら皿のなかの食物はひりひりするように辛く味をつけた肉であったから。
Looking upward, I surveyed the ceiling of my prison.	眼を上の方へ向けて、私はこの牢獄の天井を調べた。
It was some thirty or forty feet overhead, and constructed much as the side walls.	高さは約三、四十フィートであって、側面の壁と非常によく似た造りであった。
In one of its panels a very singular figure riveted my whole attention .	その天井の鏡板の一枚にあるたいへん奇妙な画像が、私の注意をすっかり釘（くぎ）づけにするように強くひきつけた。
It was the painted figure of Time as he is commonly represented, save that in lieu of a scythe he held what at a casual glance I supposed to be the pictured image of a huge pendulum, such as we see on antique clocks.	それは普通によく描かれているような時（タイム）の画像（４）であって、ただ違うのは大鎌のかわりに、ちょっと見たところでは、古風な掛時計についているような巨大な振子（ふりこ）を描いたのであろうと想像されるものを、持っていることであった。
There was something, however, in the appearance of this machine which caused me to regard it more attentively.	しかしこの機械の様子には、なにかしら私にもっと注意深く眺めさせるものがあった。
While I gazed directly upward at it (for its position was immediately over my own), I fancied that I saw it in motion.	まっすぐに上を向いてそれを眺めると（というのはそれの位置はちょうど私の真上にあったから）、なんだかそれが動いているような気がした。
In an instant afterward the fancy was confirmed.	間もなくその考えは事実だということがわかった。
Its sweep was brief, and of course slow.	その振動は短く、もちろんゆっくりしていた。
I watched it for some minutes, somewhat in fear but more in wonder.	私はいくらか恐怖を感じながらも、それよりももっと驚異の念をもって、数分間それを見まもっていた。
Wearied at length with observing its dull movement, I turned my eyes upon the other objects in the cell.	とうとうそののろい運動を見つめるのに疲れてしまって、監房のなかのほかの物に眼をうつした。
A slight noise attracted my notice, and looking to the floor, I saw several enormous rats traversing it.	かすかな物音が私の注意をひいたので、床の方に眼をやると、大きな鼠が何匹かそこを走っているのが見えた。
They had issued from the well which lay just within view to my right.	彼らはちょうど私の右の方に見えるところにある例の井戸から出てきたのだ。
Even then while I gazed, they came up in troops hurriedly, with ravenous eyes, allured by the scent of the meat.	私が眺めているときでさえ、彼らは、肉片の匂いに誘われて、がつがつした眼つきをして、あわただしそうに群れをなしてやってきた。
From this it required much effort and attention to scare them away.	彼らを脅して肉片によせつけないようにするには、たいへんな努力と注意が必要だった。
It might have been half-an-hour, perhaps even an hour (for I could take but imperfect note of time) before I again cast my eyes upward.	ふたたび視線を上の方へ向けたときまでには、半時間か、それともあるいは一時間も（というのは完全に時間を注意することはできなかったから）たっていたかもしれない。
What I then saw confounded and amazed me.	そのとき見たことで、私はすっかり狼狽（ろうばい）し、驚かされた。
The sweep of the pendulum had increased in extent by nearly a yard.	振子の振動は一ヤード近くもその振幅を増しているのだ。
As a natural consequence, its velocity was also much greater.	当然の結果として、その速度もまた大きくなっていた。
But what mainly disturbed me was the idea that it had perceptibly DESCENDED.	しかし、私がもっとも不安だったのは、それが眼に見えて下降してくるという考えであった。
I now observed, with what horror it is needless to say, that its nether extremity was formed of a crescent of glittering steel, about a foot in length from horn to horn; the horns upward, and the under edge evidently as keen as that of a razor.	それから私は、その振子の下端がきらきら光る鋼鉄の三日月形になっていて、先端から先端までは長さが一フィートほどあり、その先端は上の方を向き、下刃は明らかに剃刀（かみそり）の刃のように鋭いということを見てとった。
Like a razor also it seemed massy and heavy, tapering from the edge into a solid and broad structure above.	それは剃刀のようにがっしりしていて重いらしく、刃の方からだんだんに細くなって、上は固くて幅の広い部分になっている。
It was appended to a weighty rod of brass, and the whole HISSED as it swung through the air.	そして真鍮（しんちゅう）の重い柄につけてあって、空気を切って揺れるときに全体がしゅっしゅっと音をたてた。
I could no longer doubt the doom prepared for me by monkish ingenuity in torture.	私はもう、拷問の巧みな僧侶によって自分のために用意された運命を疑うことができなかった。
My cognisance of the pit had become known to the inquisitorial agents	私があの落穴に気がついたということは、とっくに宗教裁判所の役人どもには知れていた。
-- THE PIT, whose horrors had been destined for so bold a recusant as myself,	――あの落穴――その恐怖こそ私のような大胆不敵な国教忌避者のために用意してあったのだ。
THE PIT, typical of hell, and regarded by rumour as the Ultima Thule of all their punishments.	あの落穴――それこそ地獄の典型であり、噂によれば彼らのあらゆる刑罰のなかの極点と考えられているものだ。
The plunge into this pit I had avoided by the merest of accidents,	この落穴に落ちこむことを、私はまったく偶然の出来事によってのがれたのであった。
and I knew that surprise or entrapment into torment formed an important portion of all the grotesquerie of these dungeon deaths.	そして私は驚愕（きょうがく）、つまり拷問の罠（わな）に落ちこんで苦しむことが、この牢獄のいろいろな奇怪な死刑の重要な部分となっていることを知った。
Having failed to fall, it was no part of the demon plan to hurl me into the abyss,	深淵へ落ちなかったからには、私をその深淵のなかへ投げ込むということは、かの悪魔の計画にはなかった。
and thus (there being no alternative) a different and a milder destruction awaited me.	そこで（ほかにとるべき方法もないので）それより別の、もっとお手やわらかな破滅が私を待つことになったのだ。
Milder!	お手やわらかな！
I half smiled in my agony as I thought of such application of such a term.	こんな言葉をこんな場合に使うことを思いつくと、私は苦悶（くもん）のなかでもちょっと微笑したのだった。
What boots it to tell of the long, long hours of horror more than mortal, during which I counted the rushing oscillations of the steel!	鋼鉄の刃のもの凄い振動を数えているあいだの、死よりも恐ろしい長い長い幾時間のことを、話したところでなんになろう！
Inch by inch  -- line by line -- with a descent only appreciable at intervals that seemed ages -- down and still down it came!	一インチずつ――一ライン（５）ずつ――長い年月と思われる間（ま）をおいて、やっとわかるような降り方で――下へ、もっと下へと、降りてくる！
Days passed -- it might have been that many days passed -- ere it swept so closely over me as to fan me with its acrid breath.	それがひりひりするような息で私を煽（あお）りつけるくらい身近に迫ってくるまでには、幾日か過ぎた、
The odour of the sharp steel forced itself into my nostrils.	鋭い鋼鉄の臭いが私の鼻孔をおそった。
I prayed	私は祈った、
-- I wearied heaven with my prayer for its more speedy descent.	――それがもっと速く降りてくるようにと、天がうるさがるほど祈った。
I grew frantically mad, and struggled to force myself upward against the sweep of the fearful scimitar.	気が狂ったようになり、揺れているその偃月刀（えんげつとう）の方へ向って自分の体を上げようともがいた。
And then I fell suddenly calm and lay smiling at the glittering death as a child at some rare bauble.	それからまた急に静かになって、子供がなにか珍しい玩具を見たときのように、そのきらきら輝く死の振子を見て微笑しながら横たわっていた。
There was another interval of utter insensibility;	もう一度、まったく無感覚のときがあった。
it was brief,	それは短いあいだであった。
for upon again lapsing into life there had been no perceptible descent in the pendulum.	なぜなら、ふたたび我に返ったときに振子は眼につくほど下っていなかったから。
But it might have been long	しかしあるいは長いあいだであったかもしれない、
-- for I knew there were demons who took note of my swoon, and who could have arrested the vibration at pleasure.	――というのは、私の気絶するのに気をつけていて、振子の振動を思うままに止めることもできる悪魔どものいることを、私は知っていたから。
Upon my recovery, too, I felt very -- oh! inexpressibly -- sick and weak,	正気づくとまた、私はひどく――おお！　なんとも言いようもないほど――気分が悪く衰弱していることを感じた、
as if through long inanition.	ちょうど長いあいだの飢え疲れのように。
Even amid the agonies of that period the human nature craved food.	その苦痛のあいだにさえ、人間の本能は食物を求めるのであった。
With painful effort I outstretched my left arm as far as my bonds permitted, and took possession of the small remnant which had been spared me by the rats.	私は苦しい努力をして左腕を紐の許すかぎり伸ばし、鼠が食い残しておいてくれた食物のわずかな残りを手に入れた。
As I put a portion of it within my lips there rushed to my mind a half-formed thought of joy -- of hope.	その一片を口のなかへ入れたとき、私の心には半ば形になった歓喜の――希望の――念が湧（わ）きあがった。
Yet what business had I with hope?	しかしこの私が希望などになんの用があろう？
It was, as I say, a half-formed thought	それはいま言ったとおり、なかば形になった考えであった。
-- man has many such, which are never completed.	――人はよくそんな考えを持つが、それは決して完成されるものではない。
I felt that it was of joy -- of hope;	私はそれが歓喜の――希望の――念であることを感じた。
but I felt also that it had perished in its formation.	しかしまたそれが形になりかけて消えてしまったことを感じた。
In vain I struggled to perfect -- to regain it.	それを仕上げようと――取りもどそうと努めたが無駄だった。
Long suffering had nearly annihilated all my ordinary powers of mind.	長いあいだの苦しみは、私のあらゆる普通の心の能力をほとんど絶滅させてしまっていた。
I was an imbecile	私は低能者になっていた、
-- an idiot.	――白痴になっていた。
The vibration of the pendulum was at right angles to my length.	振子の振動は私の身の丈（たけ）と直角になっていた。
I saw that the crescent was designed to cross the region of the heart.	私は偃月刀が自分の心臓の部分をよぎるように工夫してあることを知った。
It would fray the serge of my robe;	それは外衣のセルを擦り切るだろう、
it would return and repeat its operations	――それから返り、そしてまたその動作をくりかえすだろう、
-- again -- and again.	――二回――三回と。
Notwithstanding its terrifically wide sweep (some thirty feet or more) and the hissing vigour of its descent, sufficient to sunder these very walls of iron, still the fraying of my robe would be all that, for several minutes, it would accomplish;	振幅がもの凄く広くなり（約三十フィートか、またはそれ以上）、しゅっしゅっと音をたてて降りてくる勢いが鉄の壁さえ切り裂くくらいであっても、数分間というものはそれのすることはやはり私の外衣を擦り切ることだけであろう。
and at this thought I paused.	ここまで考えてくると私の考えはとまった。
I dared not go farther than this reflection.	この考えより先へは行けなかった。
I dwelt upon it with a pertinacity of attention	私はしつこくこの考えに注意を集めた、
-- as if, in so dwelling, I could arrest HERE the descent of the steel.	――ちょうどそうすれば鋼鉄の刃の下降をそこでとめることができるかのように。
I forced myself to ponder upon the sound of the crescent as it should pass across the garment -- upon the peculiar thrilling sensation which the friction of cloth produces on the nerves.	私は偃月刀が衣服を切って通るときの音を――布地が摩擦されることが神経にさわる奇妙なぞっとするような感覚を、わざと考えてみた。
I pondered upon all this frivolity until my teeth were on edge.	こうしたくだらないことをいろいろと歯の根が浮くくらいになるまで考えてみた。
Down -- steadily down it crept.	下へ――じりじり下へ、振子は這（は）い降りてくる。
I took a frenzied pleasure in contrasting its downward with its lateral velocity.	私はその振子の横に揺れる速度と、下へ降りてくる速度とを照らしあわせて、狂気じみた快感を感じた。
To the right -- to the left -- far and wide -- with the shriek of a damned spirit!	右へ――左へ――遠く広く――悪鬼の叫びをあげて！
to my heart with the stealthy pace of the tiger!	私の心臓めがけて、虎のような忍び足で下へ！
I alternately laughed and howled, as the one or the other idea grew predominant.	この二つの考えのどっちかが力強くなるにしたがって、私はかわるがわるに笑ったり叫んだりした。
Down -- certainly, relentlessly down! It vibrated within three inches of my bosom!	下へ――まちがいなく、無情に下へ、それは私の胸から三インチ以内のところを振動しているのだ！
I struggled violently -- furiously -- to free my left arm.	私は左腕を自由にしようとしてはげしく――猛（たけ）りくるって――もがいた。
This was free only from the elbow to the hand.	その左の腕はただ肘（ひじ）から手首までだけが自由になっていた。
I could reach the latter, from the platter beside me to my mouth with great effort, but no farther.	手は非常な苦心をしてやっとかたわらの皿から口のところへ動かせるだけで、それ以上は動かせなかった。
Could I have broken the fastenings above the elbow, I would have seized and attempted to arrest the pendulum.	もし肘から上の紐を切ることができたら、私は振子をつかまえて止めようとでもしたことであろう。
I might as well have attempted to arrest an avalanche!	それは雪崩（なだれ）を止めようとするのと同じようなことだ！
Down -- still unceasingly -- still inevitably down!	下へ――なおも休みなく――なおも避けがたく下へ！
I gasped and struggled at each vibration.	それが振動するたびに私はあえぎ、もがいた。
I shrunk convulsively at its very sweep.	一揺れごとに痙攣的に身をちぢめた。
My eyes followed its outward or upward whirls with the eagerness of the most unmeaning despair;	眼はまったく意味のない絶望からくる熱心さで、振子が外の方へ、上の方へと跳びあがるあとを追った。
they closed themselves spasmodically at the descent, although death would have been a relief,	そしてそれが落ちてくるときには発作的に閉じた、死は救いであったろうが。
O, how unspeakable!	おお、なんという言うに言われぬ救いであろう！
Still I quivered in every nerve to think how slight a sinking of the machinery would precipitate that keen glistening axe upon my bosom.	あの機械がほんの少しばかり下っただけであの鋭いきらきら光る斧（おの）を私の胸に突きこむのだ、ということを考えると、体じゅうの神経がみなうち震えた。
It was hope that prompted the nerve to quiver -- the frame to shrink.	この神経をうち震えさせ――体をちぢませるものは希望であった。
It was HOPE -- the hope that triumphs on the rack -- that whispers to the death-condemned even in the dungeons of the Inquisition.	宗教裁判所の牢獄のなかであってさえ死刑囚の耳にささやくものは希望――拷問台の上にあってさえ喜びいさむ希望――であった。
I saw that some ten or twelve vibrations would bring the steel in actual contact with my robe,	もう十回か十二回振動すれば鋼鉄の刃が私の外衣にほんとうに触れるということがわかった。
and with this observation there suddenly came over my spirit all the keen, collected calmness of despair.	――そしてそれがわかると、ふいに、私の心には鋭い落ちついた絶望の静けさがやってきた。
For the first time during many hours, or perhaps days, I THOUGHT.	この幾時間ものあいだ――あるいはおそらく幾日ものあいだ――いま初めて私は考えた。
It now occurred to me that the bandage or surcingle which enveloped me was UNIQUE.	すると、自分を巻いている革紐つまり上腹帯は一本だけだということが思いついた。
I was tied by no separate cord.	私は何本もの紐で縛られているのではなかった。
The first stroke of the razor-like crescent athwart any portion of the band would so detach it that it might be unwound from my person by means of my left hand.	剃刀のような偃月刀の最初の一撃が紐のどの部分をよぎっても、その紐が切りはなされて、左手を使って体から解きはなすことができるにちがいない。
But how fearful, in that case, the proximity of the steel!	だが、その場合には鋼鉄の刃のすぐ近くにあることがどんなに恐ろしいことだろう！
The result of the slightest struggle, how deadly!	ほんのちょっとでももがいたらどんなに危ないことになるだろう！
Was it likely, moreover, that the minions of the torturer had not foreseen and provided for this possibility!	そのうえに拷問吏の手下どもが、こんなことがありそうだと察して、それに備えておくということもありそうなことではなかろうか？
Was it probable that the bandage crossed my bosom in the track of the pendulum?	紐が私の胸の振子の通るところに巻いてあるということがありそうだろうか？
Dreading to find my faint, and, as it seemed, my last hope frustrated, I so far elevated my head as to obtain a distinct view of my breast.	このかすかな、そして最後と思われる希望が破られるのを恐れながらも、私は胸のところをはっきり見られるくらいにまで頭を上げてみた。
The surcingle enveloped my limbs and body close in all directions save	革紐は手足も胴も縦横にぐるぐると堅く巻いてあった、
SAVE IN THE PATH OF THE DESTROYING CRESCENT.	――ただ人をうち殺すその偃月刀の通り路だけはのけて。
Scarcely had I dropped my head back into its original position when there flashed upon my mind what I cannot better describe than as the unformed half of that idea of deliverance to which I have previously alluded, and of which a moiety only floated indeterminately through my brain when I raised food to my burning lips.	頭をもとの位置に下ろすとすぐ、前にちょっと言ったところの、そしてその半分が、燃えるような唇に食物を持って行ったときにぼんやり浮んだところの、あの救いという考えのまだ形をなさない半分、というより以上にうまく言いあらわせないものが、私の心にひらめいた。
The whole thought was now present	全体の考えがいまあらわれてきたのだ。
-- feeble, scarcely sane, scarcely definite, but still entire.	――弱い、あまり正気でもない、あまりはっきりしないものであったが、――それでもとにかく全体であった。
I proceeded at once, with the nervous energy of despair, to attempt its execution.	私はすぐに自暴自棄の勇気で、その考えの実行にとりかかった。
For many hours the immediate vicinity of the low framework upon which I lay had been literally swarming with rats.	もう幾時間も、私の臥ている低い枠組のすぐ近くには、鼠が文字どおり群がっていた。
They were wild, bold, ravenous,	彼らは荒々しく、大胆で、がつがつして飢えていた。
their red eyes glaring upon me as if they waited but for motionlessness on my part to make me their prey.	――彼らの赤い眼は、ただ私が動かなくなりさえしたら私を餌食にしようと待ちかまえているように、私の方を向いてぎらぎらと光っていた。
"To what food,"	「この井戸のなかであいつらはいったいどんな食物を食いつけてきたのだろう？」
I thought,	と私は考えた。
They had devoured, in spite of all my efforts to prevent them, all but a small remnant of the contents of the dish.	彼らは、私がいろいろ骨を折って追い払おうとしたのに、もう皿のなかの食物をちょっぴり残しただけで、すっかり食いつくしてしまっていた。
I had fallen into an habitual see-saw or wave of the hand about the platter;	私はただ手を皿のあたりに習慣的に上げ下げして振っていたのだが、
and at length the unconscious uniformity of the movement deprived it of effect.	とうとうその無意識に一様な運動は効き目がなくなってしまった。
In their voracity the vermin frequently fastened their sharp fangs in my fingers.	貪欲（どんよく）にも鼠どもはちょいちょい鋭い牙（きば）を私の指につきたてた。
With the particles of the oily and spicy viand which now remained, I thoroughly rubbed the bandage wherever I could reach it;	私は残っている脂っこいよい香のする肉片を、手のとどくかぎり革紐にすっかりなすりつけて、
then, raising my hand from the floor, I lay breathlessly still.	それから手を床からひっこめて、息を殺してじっと臥ていた。
At first the ravenous animals were startled and terrified at the change-- at the cessation of movement .	初めはその飢えきった動物どもも、この変化に――運動の中止されたのに――驚きおそれた。
They shrank alarmedly back;	彼らはびっくりして尻込みした。
many sought the well.	井戸の方へ逃げたやつも多かった。
But this was only for a moment.	しかしこれはほんのしばらくのことにすぎなかった。
I had not counted in vain upon their voracity.	彼らの貪欲をあてにしたのは無駄ではなかった。
Observing that I remained without motion, one or two of the boldest leaped upon the frame-work and smelt at the surcingle.	私が身動きもしなくなったのを見てとると、いちばん大胆なやつが一、二匹、枠の上に跳びあがって、革紐を嗅（か）いだ。
This seemed the signal for a general rush.	これがまるで総突撃の合図のようであった。
Forth from the well they hurried in fresh troops.	彼らは井戸から出てきて、新たに群れをなして駆け集まってきた。
They clung to the wood, they overran it, and leaped in hundreds upon my person.	枠の木にかじりつき――それを乗りこえ、そして幾百となく私の体の上に跳びあがった。
The measured movement of the pendulum disturbed them not at all.	振子の規則正しい運動などはちっとも彼らの邪魔にはならなかった。
Avoiding its strokes, they busied themselves with the annointed bandage.	彼らは振子に撃たれるのを避けながら、油を塗った革紐に忙しく群がった。
They pressed,	彼らは押しよせ
they swarmed upon me in ever accumulating heaps.	――群がって私の上に絶えず積みかさなった。
They writhed upon my throat;	咽喉の上でのたうちまわった。
their cold lips sought my own;	その冷たい唇が私の唇を探した。
I was half stifled by their thronging pressure;	彼らの群がってくる圧迫のために私はなかば窒息しかかった。
disgust, for which the world has no name, swelled my bosom, and chilled with heavy clamminess my heart.	なんとも言いようのない不快な感じが胸に湧きあがり、じっとりとした冷たさで心臓をぞっとさせた。
Yet one minute and I felt that the struggle would be over.	それでも一分もたつと、私はこの争闘もやがて終ってしまうだろうと感じた。
Plainly I perceived the loosening of the bandage.	私は革紐の緩むのをはっきりと悟った。
I knew that in more than one place it must be already severed.	すでに一カ所以上も切れているにちがいないことがわかった。
With a more than human resolution I lay STILL.	超人間的の決心をもって、私はじっと横たわっていた。
Nor had I erred in my calculations,	私の予想はまちがっていなかった、
nor had I endured in vain.	――忍耐も無益ではなかった。
I at length felt that I was FREE.	やっと私は自由になったのを感じた。
The surcingle hung in ribands from my body.	革紐は幾すじかになって体からぶら下がった。
But the stroke of the pendulum already pressed upon my bosom.	しかし振子の刃はもう胸のところに迫った。
It had divided the serge of the robe.	それは外衣のセルを裂いていた。
It had cut through the linen beneath.	その下のリンネルも切っていた。
Twice again it swung,	またも二回揺れた。
and a sharp sense of pain shot through every nerve.	すると鋭い苦痛の感覚があらゆる神経に伝わった。
But the moment of escape had arrived.	しかし逃げ出る瞬間がきているのだ。
At a wave of my hand my deliverers hurried tumultously away.	手を一振りすると、私の救助者どもはあわてふためいてどっと逃げさった。
With a steady movement, cautious, sidelong, shrinking, and slow, I slid from the embrace of the bandage and beyond the reach of the scimitar.	じりじりと身を動かし――気をつけて、横ざまにすくみながら、ゆっくりと――革紐からすりぬけて、偃月刀のとどかないところへ身をすべらした。
For the moment, at least I WAS FREE.	少なくとも当分は、私は自由になったのだ。
Free!	自由！
and in the grasp of the Inquisition!	――宗教裁判所の手につかまれながら！
I had scarcely stepped from my wooden bed of horror upon the stone floor of the prison, when the motion of the hellish machine ceased and I beheld it drawn up by some invisible force through the ceiling.	恐怖の木の寝台から牢獄の石の床に足を踏み出すとすぐ、あの地獄のような恐ろしい機械の運動がぴったりと止り、なにか眼に見えない力でするすると天井の上に引き上げられるのを私は見た。
This was a lesson which I took desperately to heart.	これは非常に強く身にしみた教訓であった。
My every motion was undoubtedly watched.	私の一挙一動がみな看視されていることは疑いがない。
Free!	自由！
I had but escaped death in one form of agony to be delivered unto worse than death in some other.	――私はただ苦悶の一つの形式による死をのがれて、なにか他の形式の、死よりもいっそう悪いものの手に渡されることになったにすぎないのだ。
With that thought I rolled my eyes nervously around on the barriers of iron that hemmed me in.	そう考えながら、私をとり囲んでいる鉄の壁をびくびくして見まわした。
Something unusual -- some change which at first I could not appreciate distinctly -- it was obvious had taken place in the apartment.	なにか異常なことが――初めははっきりと見分けることのできなかったある変化が――この部屋のなかに起ったことは明らかであった。
For many minutes of a dreamy and trembling abstraction I busied myself in vain, unconnected conjecture.	何分間も夢み心地にわななきながら茫然（ぼうぜん）として、私はただいたずらにとりとめのない臆測にふけっていた。
During this period I became aware, for the first time, of the origin of the sulphurous light which illumined the cell.	そのあいだに、この監房を照らしている硫黄色の光の源を初めて知るようになった。
It proceeded from a fissure about half-an-inch in width	それは幅半インチほどの隙間からくるのだ。
extending entirely around the prison at the base of the walls	その隙間というのは壁の下の方で牢獄をぐるりと一まわりしている。
which thus appeared, and were completely separated from the floor.	だから壁は床から完全に離れているように見えたし、またほんとうに離れていたのである。
I endeavoured, but of course in vain, to look through the aperture.	その隙間からのぞこうと骨を折ったが、もちろん無駄であった。
As I arose from the attempt, the mystery of the alteration in the chamber broke at once upon my understanding.	この試みをやめて立ち上がると、この部屋の変化の神秘が急に理解されるようになってきた。
I have observed that although the outlines of the figures upon the walls were sufficiently distinct, yet the colours seemed blurred and indefinite .	私は前に、壁上に描かれている画の輪郭は十分はっきりしてはいるが、その色彩がぼんやりしていて明瞭ではないようだということを述べた。
These colours had now assumed, and were momentarily assuming, a startling and most intense brilliancy, that give to the spectral and fiendish portraitures an aspect that might have thrilled even firmer nerves than my own.	ところがその色彩がいまや驚くほどの強烈な光輝を帯びて、しかも刻一刻とその光輝を増し、その幽霊のような悪鬼のような画像を、私の神経より強い神経をさえ戦慄させるほどの姿にしたのだ。
Demon eyes, of a wild and ghastly vivacity, glared upon me in a thousand directions where none had been visible before, and gleamed with the lurid lustre of a fire that I could not force my imagination to regard as unreal.	狂暴なもの凄い生き生きした悪魔の眼は、らんらんとして前にはなにも見えなかったあらゆる方向から私をにらみつけ、気味のわるい火の輝きでひらめくので無理にも想像力でそれを幻だと考えてしまうわけにはゆかなかった。
UNREAL!	幻どころか！
-- Even while I breathed there came to my nostrils the breath of the vapour of heated iron!	――呼吸をするときでさえ、灼熱（しゃくねつ）した鉄の熱気が鼻をついてくるのだ！
A suffocating odour pervaded the prison!	息のつまるような臭いが牢獄に満ちた！
A deeper glow settled each moment in the eyes that glared at my agonies!	私の苦悶をにらんでいる眼は一刻ごとにらんらんとした光を強くした！
A richer tint of crimson diffused itself over the pictured horrors of blood.	血の恐怖の画の上には真紅のもっと濃い色がひろがった！
I panted '	私はあえいだ！
I gasped for breath!	息をしようとしてあえいだ！
There could be no doubt of the design of my tormentors	私の迫害者どもの計画についてはなんの疑いもない、
-- oh most unrelenting!	――おお、人間のなかでもいちばん無慈悲な！
oh, most demoniac of men!	おお、いちばん悪魔のような者ども！
I shrank from the glowing metal to the centre of the cell.	私はその真っ赤に熱した鉄板から監房の真ん中の方へあとじさりした。
Amid the thought of the fiery destruction that impended, the idea of the coolness of the well came over my soul like balm.	眼の前にさし迫った火刑の死を考えると、あの井戸の冷たさという観念が、苦痛をやわらげる香油のように心に浮んできた。
I rushed to its deadly brink.	私はその恐ろしい井戸のふちへ走りよった。
I threw my straining vision below.	眼を見はって下の方を見た。
The glare from the enkindled roof illumined its inmost recesses.	燃えたった屋根のぎらぎらする光が井戸の奥そこまで照らしていた。
Yet, for a wild moment, did my spirit refuse to comprehend the meaning of what I saw.	それでもしばらくは、私の心は錯乱していて自分の見たものの意味を理解しようとはしなかった。
At length it forced -- it wrestled its way into my soul	やっとそれが私の心に入ってきた、
-- it burned itself in upon my shuddering reason.	――無理に押し入った、戦（おのの）き震える理性に焼きつけた。
O for a voice to speak!	おお、ものを言う声が出たらいいのだが！
-- oh, horror!	――ああ、恐ろしい！
-- oh, any horror but this!	――ああ、このほかの恐ろしさならなんでもよい！
With a shriek I rushed from the margin and buried my face in my hands	鋭い叫び声をあげて私はそのふちから駆けもどり、両手に顔をうずめた、
-- weeping bitterly.	――はげしく泣きながら。
The heat rapidly increased, and once again I looked up, shuddering as if with a fit of the ague.	熱は急速に増した、私は瘧（おこり）の発作のようにぶるぶる震えながら、もう一度眼をあげた。
There had been a second change in the cell	監房のなかには二度目の変化が起っていた、
-- and now the change was obviously in the FORM.	――そして今度の変化は明らかに形に関するものであった。
As before , it was in vain that I at first endeavoured to appreciate or understand what was taking place.	前と同様に、初めのうちは起りつつあることを感知し理解しようと努めたが、無駄だった。
But not long was I left in doubt.	だが、疑念のなかにとり残されているのも長くはなかった。
The inquisitorial vengeance had been hurried by my two-fold escape,	二回も私がのがれたので、宗教裁判所は復讐（ふくしゅう）を急いでいた。
and there was to be no more dallying with the King of Terrors.	そして懼怖（おそれ）の王（６）とこのうえふざけているわけにはゆかなくなったのだ。
The room had been square.	部屋は前には四角形であった。
I saw that two of its iron angles were now acute -- two consequently, obtuse.	私はいまその鉄の四隅のなかの二つが鋭角をなしているのを――したがって当然ほかの二つは鈍角をなしているのを認めた。
The fearful difference quickly increased with a low rumbling or moaning sound.	この恐ろしい角度の違いは、低くごろごろいうような、または呻（うめ）くような音とともに急速に増した。
In an instant the apartment had shifted its form into that of a lozenge.	またたくまに部屋はその形をかえて菱形となった。
But the alteration stopped not here	しかしこの変化はそれでやみはしなかった、
-- I neither hoped nor desired it to stop.	――私はそれがやむのを望みもしなければ願いもしなかった。
I could have clasped the red walls to my bosom as a garment of eternal peace.	その灼熱した壁を私は、永遠の平和の衣服として胸にぴったり着けることができるのだ。
"Death,"	私は言った、
I said	「死――この落穴の死でさえなければどんな死でもいい！」
Fool!	ばかな！
might I not have known that INTO THE PIT it was the object of the burning iron to urge me?	この落穴のなかへ私を駆りたてるのが、この燃える鉄板の目的であることを知らなかったのか？
Could I resist its glow?	その灼熱に耐えることができるか？
or if even that, could I withstand its pressure ?	あるいはもしそれに耐えることができるとしても、その圧力に逆らうことができるか？
And now, flatter and flatter grew the lozenge, with a rapidity that left me no time for contempla- tion.	そしていまや菱形は、なにも考えるひまを与えないくらいの速さでますます平たくなってきた。
Its centre, and of course, its greatest width, came just over the yawning gulf.	その中心、つまりその幅の広いところは、大きく口を開いているあの深淵の真上であった。
I shrank back	私はたじろいだ、
-- but the closing walls pressed me resistlessly onward .	――が迫ってくる壁は抵抗できないように私を前へ押しすすめた。
At length for my seared and writhing body there was no longer an inch of foothold on the firm floor of the prison.	とうとう焼けこげて悶（もだ）えくるしむ私の体には、もう牢獄の堅い床の上に一インチの足場もなくなった。
I struggled no more, but the agony of my soul found vent in one loud, long, and final scream of despair.	私はもうもがかなかった、が私の苦悶は、一声の高い、長い、最後の、絶望の絶叫となってほとばしった。
I felt that I tottered upon the brink	私は自分が落穴のふちへよろめきよったのを感じた、
-- I averted my eyes --	――私は眼を逸（そ）らした――
There was a discordant hum of human voices!	がやがやいう人声が聞えた！
There was a loud blast as of many trumpets!	多くの喇叭（らっぱ）の音のような高らかな響きが聞えた！
There was a harsh grating as of a thousand thunders!	百雷のような荒々しい軋（きし）り音が聞えた！
The fiery walls rushed back!	炎の壁は急にとびのいた！
An outstretched arm caught my own as I fell fainting into the abyss.	私が失神してその深淵のなかへ落ちこもうとした瞬間に、一つの腕がのびて私の腕をつかんだ。
It was that of General Lasalle.	それはラサール将軍（７）の腕であった。
The French army had entered Toledo.	フランス軍がトレードに入ったのだ。
The Inquisition was in the hands of its enemies.	宗教裁判所はその敵の手に落ちた。
（７）　Antonie Charles Louis Colinet	（１）　十二世紀ごろから始まりその後数世紀にわたって、ローマ教会の教権擁護のために、異端その他宗教に関する罪悪を摘発撲滅するために行われた、歴史上有名な裁判。――フランス、イタリア、ドイツ、スペイン、ポルトガル、その他ヨーロッパの諸国においてさかんに行われて、異教徒の迫害に利用され、ことにスペインにおける宗教裁判はその糺問（きゅうもん）が峻烈（しゅんれつ）で処刑が残酷なので有名であった。第十八世紀にいたってようやくやみ、スペインでは最も遅く、一八三四年まで行われた。
