High above the city, on a tall column, stood the statue of the Happy Prince.	町の上に高く柱がそびえ、その上に幸福の王子の像が立っていました。
He was gilded all over with thin leaves of fine gold, for eyes he had two bright sapphires, and a large red ruby glowed on his sword-hilt.	王子の像は全体を薄い純金で覆われ、 目は二つの輝くサファイアで、 王子の剣のつかには大きな赤いルビーが光っていました。
He was very much admired indeed.	王子は皆の自慢でした。
"He is as beautiful as a weathercock,"	「風見鶏と同じくらいに美しい」
remarked one of the Town Councillors who wished to gain a reputation for having artistic tastes;	と、 芸術的なセンスがあるという評判を得たがっている一人の市会議員が言いました。
"only not quite so useful,"	「もっとも風見鶏ほど便利じゃないがね」
he added,	と付け加えて言いました。
fearing lest people should think him unpractical,	これは夢想家だと思われないように、と心配したからです。
which he really was not.	実際には彼は夢想家なんかじゃなかったのですが。
"Why can't you be like the Happy Prince?"	「どうしてあの幸福の王子みたいにちゃんとできないの」
asked a sensible mother of her little boy who was crying for the moon.	月が欲しいと泣いている幼い男の子に、賢明なお母さんが聞きました。
"The Happy Prince never dreams of crying for anything."	「幸福の王子は決して何かを欲しがって泣いたりしないのよ」
"I am glad there is some one in the world who is quite happy,"	「この世界の中にも、本当に幸福な人がいる、というのはうれしいことだ」
muttered a disappointed man as he gazed at the wonderful statue.	失望した男が、この素晴らしい像を見つめてつぶやきました。
"He looks just like an angel,"	「天使のようだね」
said the Charity Children as they came out of the cathedral in their bright scarlet cloaks and their clean white pinafores.	と、 明るい赤のマントときれいな白い袖なしドレスを来た養育院の子供たちが聖堂から出てきて言いました。
"How do you know?"	「どうしてそのようなことがわかるのかね」
said the Mathematical Master,	と数学教師がいいました。
"you have never seen one."	「天使など見たことがないのに」
"Ah! but we have, in our dreams,"	「ああ、でも見たことはありますよ。夢の中で」
answered the children;	と子供たちは答えました。
and the Mathematical Master frowned and looked very severe,	すると数学教師は眉をひそめてとても厳しい顔つきをしました。
for he did not approve of children dreaming.	というのは彼は子供たちが夢を見ることはよろしくないと考えていたからです。
One night there flew over the city a little Swallow.	ある晩、その町に小さなツバメが飛んできました。
His friends had gone away to Egypt six weeks before, but he had stayed behind,	友達らはすでに六週間前にエジプトに出発していましたが、 そのツバメは残っていました。
for he was in love with the most beautiful Reed.	彼は最高にきれいな葦に恋をしていたからです。
He had met her early in the spring as he was flying down the river after a big yellow moth,	ツバメが彼女に出会ったのは春のはじめ、 大きくて黄色い蛾を追って川の下流へ向かって飛んでいたときでした。
and had been so attracted by her slender waist that he had stopped to talk to her.	葦のすらっとした腰があまりにも魅力的だったので、 ツバメは立ち止まって彼女に話しかけたのです。
"Shall I love you?"	「君を好きになってもいいかい」
said the Swallow,	とツバメは言いました。
who liked to come to the point at once,	ツバメは単刀直入に話すのが好きでした。
and the Reed made him a low bow.	葦は深くうなずきました。
So he flew round and round her, touching the water with his wings, and making silver ripples.	そこでツバメは、翼で水に触れながら彼女の周りをぐるぐると回り、 銀色のさざなみを立てました。
This was his courtship, and it lasted all through the summer.	これはツバメからのラブコールで、それは夏中続きました。
"It is a ridiculous attachment,"	「彼女はおかしな恋人だね」
twittered the other Swallows;	と他のツバメたちがぺちゃぺちゃ言いました。
"she has no money, and far too many relations";	「財産はないくせに、親戚は多すぎるときてる」
and indeed the river was quite full of Reeds.	実際、その川は葦でいっぱいだったのです。
Then, when the autumn came they all flew away.	やがて、秋が来るとそのツバメたちもみんな飛んでいってしまいました。
After they had gone he felt lonely, and began to tire of his lady- love.	みんなが行ってしまうと、ツバメはさびしくなり、自分の恋人にも飽き始めました。
"She has no conversation,"	「彼女は何も話してくれないしな」
he said,	ツバメは言いました。
"and I am afraid that she is a coquette,	「それに浮気っぽいんじゃないかと思うんだ。
for she is always flirting with the wind."	だって彼女はいつも風といちゃついてるんだから」
And certainly,whenever the wind blew, the Reed made the most graceful curtseys.	確かに、風が吹くといつも、葦は最高に優美なおじぎをするのでした。
"I admit that she is domestic,"	「彼女は家庭的なのは認めるけれど」
he continued,	とツバメは続けました。
"but I love travelling, and my wife, consequently, should love travelling also."	「でも、僕は旅をするのが好きなんだから、僕の妻たるものも、 旅をするのが好きでなくっちゃ」
"Will you come away with me?" he said finally to her;	とうとうツバメは「僕と一緒に行ってくれないか」と彼女に言いました。
but the Reed shook her head,	でも葦は首を横に振りました。
she was so attached to her home.	彼女は自分の家にとても愛着があったのです。
"You have been trifling with me,"	「君は僕のことをもてあそんでいたんだな」
he cried.	とツバメは叫びました。
"I am off to the Pyramids.Good-bye!"	「僕はピラミッドに出発するよ。じゃあね」
and he flew away.	ツバメは飛び去りました。
All day long he flew, and at night-time he arrived at the city.	一日中ツバメは飛び、夜になって町に着きました。
"Where shall I put up?"	「どこに泊まったらいいかな」
he said;	とツバメは言いました。
"I hope the town has made preparations."	「泊まれるようなところがあればいいんだけれど」
Then he saw the statue on the tall column.	それからツバメは高い柱の上の像を見ました。
"I will put up there,"	「あそこに泊まることにしよう」
he cried;	と声をあげました。
"it is a fine position, with plenty of fresh air."	「あれはいい場所だ、新鮮な空気もたくさん吸えるし」
So he alighted just between the feet of the Happy Prince.	そしてツバメは幸福の王子の両足のちょうど間に止まりました。
"I have a golden bedroom,"	「黄金のベッドルームだ」
he said softly to himself as he looked round, and he prepared to go to sleep;	ツバメはあたりを見まわしながらそっと一人で言い、 眠ろうとしました。
but just as he was putting his head under his wing a large drop of water fell on him.	ところが、頭を翼の中に入れようとしたとたん、 大きな水の粒がツバメの上に落ちてきました。
"What a curious thing!"	「何て不思議なんだ！」
he cried;	とツバメは大きな声をあげました。
"there is not a single cloud in the sky, the stars are quite clear and bright, and yet it is raining.	「空には雲一つなく、星はとてもくっきりと輝いているというのに、雨が降っているなんて。
The climate in the north of Europe is really dreadful.	北ヨーロッパの天候はまったくひどいもんだね。
The Reed used to like the rain, but that was merely her selfishness."	あの葦は雨が好きだったが、それは単なる自己中心だったし」
Then another drop fell.	すると、もう一滴落ちてきました。
"What is the use of a statue if it cannot keep the rain off?"	「雨よけにならないんだったら、像なんて何の役にも立たないな」
he said;	とツバメは言いました。
"I must look for a good chimney-pot,"	「もっといい煙突を探さなくちゃ」
and he determined to fly away.	ツバメは飛び立とうと決心しました。
But before he had opened his wings, a third drop fell, and he looked up,	でも、翼を広げるよりも前に、 三番目の水滴が落ちてきて、ツバメは上を見上げました。
and saw - Ah! what did he see?	すると――何が見えたでしょうか。
The eyes of the Happy Prince were filled with tears,	幸福の王子の両眼は涙でいっぱいになっていました。
and tears were running down his golden cheeks.	そしてその涙は王子の黄金の頬を流れていたのです。
His face was so beautiful in the moonlight that the little Swallow was filled with pity.	王子の顔は月光の中でとても美しく、 小さなツバメはかわいそうな気持ちでいっぱいになりました。
"Who are you?"	「あなたはどなたですか」
he said.	ツバメは尋ねました。
"I am the Happy Prince."	「私は幸福の王子だ」
"Why are you weeping then?"	「それなら、どうして泣いているんですか」
asked the Swallow;	とツバメは尋ねました。
"you have quite drenched me."	「もう僕はぐしょぬれですよ」
"When I was alive and had a human heart,"	「まだ私が生きていて、人間の心を持っていたときのことだった」
answered the statue,	と像は答えました。
"I did not know what tears were,	「私は涙というものがどんなものかを知らなかった。
for I lived in the Palace of Sans- Souci, where sorrow is not allowed to enter.	というのは私はサンスーシの宮殿に住んでいて、 そこには悲しみが入り込むことはなかったからだ。
In the daytime I played with my companions in the garden, and in the evening I led the dance in the Great Hall.	昼間は友人たちと庭園で遊び、夜になると大広間で先頭切ってダンスを踊ったのだ。
Round the garden ran a very lofty wall, but I never cared to ask what lay beyond it,	庭園の周りにはとても高い塀がめぐらされていて、 私は一度もその向こうに何があるのかを気にかけたことがなかった。
everything about me was so beautiful.	周りには、非常に美しいものしかなかった。
My courtiers called me the Happy Prince,	廷臣たちは私を幸福の王子と呼んだ。
and happy indeed I was, if pleasure be happiness.	実際、幸福だったのだ、もしも快楽が幸福だというならば。
So I lived, and so I died.	私は幸福に生き、幸福に死んだ。
And now that I am dead they have set me up here so high that I can see all the ugliness and all the misery of my city,	死んでから、人々は私をこの高い場所に置いた。ここからは町のすべての醜悪なこと、すべての悲惨なことが見える。
and though my heart is made of lead yet I cannot chose but weep."	私の心臓は鉛でできているけれど、泣かずにはいられないのだ」
"What! is he not solid gold?"	「何だって！　この王子は中まで金でできているんじゃないのか」
said the Swallow to himself.	とツバメは心の中で思いました。
He was too polite to make any personal remarks out loud.	けれどツバメは礼儀正しかったので、個人的な意見は声に出しませんでした。
"Far away,"	「ずっと向こうの」
continued the statue in a low musical voice,	と、王子の像は低く調子のよい声で続けました。
"far away in a little street there is a poor house.	「ずっと向こうの小さな通りに貧しい家がある。
One of the windows is open, and through it I can see a woman seated at a table.	窓が一つ開いていて、テーブルについたご婦人が見える。
Her face is thin and worn,	顔はやせこけ、疲れている。
and she has coarse, red hands, all pricked by the needle,	彼女の手は荒れ、縫い針で傷ついて赤くなっている。
for she is a seamstress.	彼女はお針子をしているのだ。
She is embroidering passion- flowers on a satin gown for the loveliest of the Queen's maids-of- honour to wear at the next Court-ball.	その婦人はトケイソウ〔訳注：(passion-flower)この花の副花冠はキリストのいばらの冠に似ているという〕の花をサテンのガウンに刺繍しようとしている。そのガウンは女王様の一番可愛い侍女のためのもので、 次の舞踏会に着ることになっているのだ。
In a bed in the corner of the room her little boy is lying ill.	その部屋の隅のベッドでは、幼い息子が病のために横になっている。
He has a fever, and is asking for oranges.	熱があって、オレンジが食べたいと言っている。
His mother has nothing to give him but river water, so he is crying.	母親が与えられるものは川の水だけなので、その子は泣いている。
Swallow, Swallow, little Swallow,	ツバメさん、ツバメさん、小さなツバメさん。
will you not bring her the ruby out of my sword-hilt?	私の剣のつかからルビーを取り出して、あの婦人にあげてくれないか。
My feet are fastened to this pedestal and I cannot move."	両足がこの台座に固定されているから、私は行けないのだ」
"I am waited for in Egypt,"	「私はエジプトに行きたいんです」
said the Swallow.	とツバメは言いました。
"My friends are flying up and down the Nile, and talking to the large lotus- flowers.	「友人たちはナイル川に沿って飛びまわったり、大きな蓮の花に話しかけたりしています。
Soon they will go to sleep in the tomb of the great King.	まもなく、みんなは偉大な王の墓の中で眠ります。
The King is there himself in his painted coffin.	王もまた、そこの彩られた棺の中にいます。
He is wrapped in yellow linen, and embalmed with spices.	王は黄色の亜麻布で包まれ、香料を使ってミイラになっています。
Round his neck is a chain of pale green jade, and his hands are like withered leaves."	首には青緑色の翡翠の首飾りがかけられ、王の両手はまるでしおれた葉のようなんですよ」
"Swallow, Swallow, little Swallow,"	「ツバメさん、ツバメさん、小さなツバメさん」
said the Prince,	と王子は言いました。
"will you not stay with me for one night, and be my messenger?	「もう一晩泊まって、私のお使いをしてくれないか。
The boy is so thirsty, and the mother so sad."	あの子はとても喉が乾いていて、お母さんはとても悲しんでいるのだよ」
"I don't think I like boys,"	「私は男の子が好きじゃないんです」
answered the Swallow.	とツバメは答えました。
"Last summer, when I was staying on the river, there were two rude boys,	「去年の夏、川のほとりにいたとき、二人の乱暴な男の子がおりました。
the miller's sons, who were always throwing stones at me.	粉引きの息子たちで、二人はいつも僕に石を投げつけました。
They never hit me, of course;	もちろん一回も当たりませんでしたよ。
we swallows fly far too well for that, and besides, I come of a family famous for its agility;	僕たちツバメはそういうときにはとてもうまく飛びますし、その上、僕は機敏さで有名な家系の出ですから。
but still, it was a mark of disrespect."	でも、石を投げてくるっていうのは失礼な証拠ですよね」
But the Happy Prince looked so sad that the little Swallow was sorry.	でも、幸福の王子がとても悲しそうな顔をしましたので、小さなツバメもすまない気持ちになりました。
"It is very cold here,"	「ここはとても寒いですね」
he said;	とツバメは言いました。
"but I will stay with you for one night, and be your messenger."	「でも、あなたのところに一晩泊まって、あなたのお使いをいたしましょう」
"Thank you, little Swallow,"	「ありがとう、小さなツバメさん」
said the Prince.	と王子は言いました。
So the Swallow picked out the great ruby from the Prince's sword, and flew away with it in his beak over the roofs of the town.	そこでツバメは王子の剣から大きなルビーを取り出すと、 くちばしにくわえ、町の屋根を飛び越えて出かけました。
He passed by the cathedral tower, where the white marble angels were sculptured.	ツバメは、白い大理石の天使が彫刻されている聖堂の塔を通りすぎました。
He passed by the palace and heard the sound of dancing.	宮殿を通りすぎるとき、ダンスを踊っている音が聞こえました。
A beautiful girl came out on the balcony with her lover.	美しい女の子が恋人と一緒にバルコニーに出てきました。
"How wonderful the stars are,"	「何て素晴らしい星だろう」
he said to her,	彼は女の子に言いました。
"and how wonderful is the power of love!"	「そして愛の力は何と素晴らしいことだろう」
"I hope my dress will be ready in time for the State-ball,"	「私のドレスが舞踏会に間に合うといいわ」
she answered;	と女の子が答えました。
"I have ordered passion-flowers to be embroidered on it;	「ドレスにトケイソウの花が刺繍されるように注文したのよ。
but the seamstresses are so lazy."	でもお針子っていうのはとっても怠け者だから」
He passed over the river, and saw the lanterns hanging to the masts of the ships.	ツバメは川を越え、船のマストにかかっているランタンを見ました。
He passed over the Ghetto, and saw the old Jews bargaining with each other, and weighing out money in copper scales.	ツバメは貧民街を越え、老いたユダヤ人たちが商売をして、銅の天秤でお金を量り分けるのを見ました。
At last he came to the poor house and looked in.	やっと、あの貧しい家にたどり着くと、ツバメは中をのぞき込みました。
The boy was tossing feverishly on his bed, and the mother had fallen asleep, she was so tired.	男の子はベッドの上で熱のために寝返りをうち、お母さんは疲れ切って眠り込んでおりました。
In he hopped, and laid the great ruby on the table beside the woman's thimble.	ツバメは中に入って、テーブルの上にあるお母さんの指ぬきの脇に大きなルビーを置きました。
Then he flew gently round the bed, fanning the boy's forehead with his wings.	それからツバメはそっとベッドのまわりを飛び、 翼で男の子の額をあおぎました。
"How cool I feel,"	「とても涼しい」
said the boy,	と男の子は言いました。
"I must be getting better";	「僕はきっと元気になる」
and he sank into a delicious slumber.	そして心地よい眠りに入っていきました。
Then the Swallow flew back to the Happy Prince, and told him what he had done.	それからツバメは幸福の王子のところに飛んで戻り、やったことを王子に伝えました。
"It is curious,"	「妙なことに」
he remarked,	とツバメは言いました。
"but I feel quite warm now, although it is so cold."	「こんなに寒いのに、僕は今とても温かい気持ちがするんです」
"That is because you have done a good action,"	「それは、いいことをしたからだよ」
said the Prince.	と王子は言いました。
And the little Swallow began to think, and then he fell asleep.	そこで小さなツバメは考え始めましたが、やがて眠ってしまいました。
Thinking always made him sleepy.	考えごとをするとツバメはいつも眠くなるのです。
When day broke he flew down to the river and had a bath.	朝になると、ツバメは川のところまで飛んでいき、水浴びをしました。
"What a remarkable phenomenon,"	「何と驚くべき現象だ」
said the Professor of Ornithology as he was passing over the bridge.	と鳥類学の教授が橋を渡りながら言いました。
"A swallow in winter!"	「冬にツバメを見るなんて」
And he wrote a long letter about it to the local newspaper.	それから教授は、このことについて長い投書を地方新聞にあてて書きました。
Everyone quote it,	みんながその投書を話題にしました。
it was full of so many words that they could not understand.	でも、その投書は人々が理解できない単語でいっぱいでした。
"To-night I go to Egypt,"	「今夜、エジプトに行きます」
said the Swallow, and he was in high spirits at the prospect.	とツバメは言いました。ツバメはその予定に上機嫌でした。
He visited all the public monuments, and sat a long time on top of the church steeple.	町中の名所をみな訪れてから、教会の尖塔のてっぺんに長い時間とまっていました。
Wherever he went the Sparrows chirruped, and said to each other, "What a distinguished stranger!" so he enjoyed himself very much.	ツバメが行くところはどこでもスズメがチュンチュン鳴いていて、「素敵な旅人ね」と口々に言っていましたので、 ツバメはとてもうれしくなりました。
When the moon rose he flew back to the Happy Prince.	月がのぼると、ツバメは幸福の王子のところに戻ってきました。
"Have you any commissions for Egypt?"	「エジプトに何かことづけはありますか」
he cried;	と声をあげました。
"I am just starting."	「もうすぐ出発しますから」
"Swallow, Swallow, little Swallow,"	「ツバメさん、ツバメさん、小さなツバメさん」
said the Prince,	と王子は言いました。
"will you not stay with me one night longer?"	「もう一晩泊まってくれませんか」
"I am waited for in Egypt,"	「私はエジプトに行きたいと思っています」
answered the Swallow.	とツバメは答えました。
"To-morrow my friends will fly up to the Second Cataract.	「明日僕の友達は川を上り、二番目の滝へ飛んでいくでしょう。
The river-horse couches there among the bulrushes,	そこではパピルスのしげみの間でカバが休んでいます。
and on a great granite throne sits the God Memnon.	そして巨大な御影石の玉座にはメムノン神が座っているんです。
All night long he watches the stars, and when the morning star shines he utters one cry of joy, and then he is silent.	メムノン神は、星を一晩中見つめ続け、 明けの明星が輝くと喜びの声を一声あげ、 そしてまた沈黙に戻ると言われています。
At noon the yellow lions come down to the water's edge to drink.	正午には黄色のライオンが水辺に水を飲みにやってきます。
They have eyes like green beryls, and their roar is louder than the roar of the cataract.	ライオンの目は緑柱石のようで、 その吠え声は滝のごうごうという音よりも大きいんですよ」
"Swallow, Swallow, little Swallow,"	「ツバメさん、ツバメさん、小さなツバメさん」
said the Prince,	と王子は言いました。
"far away across the city I see a young man in a garret.	「ずっと向こう、町の反対側にある屋根裏部屋に若者の姿が見える。
He is leaning over a desk covered with papers,	彼は紙であふれた机にもたれている。
and in a tumbler by his side there is a bunch of withered violets.	傍らにあるタンブラーには、枯れたスミレが一束刺してある。
His hair is brown and crisp, and his lips are red as a pomegranate, and he has large and dreamy eyes.	彼の髪は茶色で細かく縮れ、唇はザクロのように赤く、 大きくて夢見るような目をしている。
He is trying to finish a play for the Director of the Theatre,	彼は劇場の支配人のために芝居を完成させようとしている。
but he is too cold to write any more.	けれど、あまりにも寒いのでもう書くことができないのだ。
There is no fire in the grate, and hunger has made him faint."	暖炉の中には火の気はなく、空腹のために気を失わんばかりになっている」
"I will wait with you one night longer,"	「もう一晩、あなたのところに泊まりましょう」
said the Swallow, who really had a good heart.	よい心をほんとうに持っているツバメは言いました。
"Shall I take him another ruby?"	「もう一つルビーを持っていきましょうか」
"Alas! I have no ruby now,"	「ああ！　もうルビーはないのだよ」
said the Prince;	王子は言いました。
"my eyes are all that I have left.	「残っているのは私の両目だけだ。
They are made of rare sapphires,	私の両目は珍しいサファイアでできている。
which were brought out of India a thousand years ago.	これは一千年前にインドから運ばれてきたものだ。
Pluck out one of them and take it to him.	私の片目を抜き出して、彼のところまで持っていっておくれ。
He will sell it to the jeweller, and buy food and firewood, and finish his play."	彼はそれを宝石屋に売って、食べ物と薪を買って、芝居を完成させることができるだろう」
"Dear Prince,"	「王子様」
said the Swallow,	とツバメは言いました。
"I cannot do that";	「私にはできません」
and he began to weep.	そしてツバメは泣き始めました。
"Swallow, Swallow, little Swallow,"	「ツバメさん、ツバメさん、小さなツバメさん」
said the Prince,	と王子は言いました。
"do as I command you."	「私が命じたとおりにしておくれ」
So the Swallow plucked out the Prince's eye, and flew away to the student's garret.	そこでツバメは王子の目を取り出して、 屋根裏部屋へ飛んでいきました。
It was easy enough to get in, as there was a hole in the roof.	屋根に穴があいていたので、入るのは簡単でした。
Through this he darted, and came into the room.	ツバメは穴を通ってさっと飛び込み、部屋の中に入りました。
The young man had his head buried in his hands, so he did not hear the flutter of the bird's wings,	その若者は両手の中に顔をうずめるようにしておりましたので、 鳥の羽ばたきは聞こえませんでした。
and when he looked up he found the beautiful sapphire lying on the withered violets.	そして若者が顔を上げると、そこには美しいサファイアが枯れたスミレの上に乗っていたのです。
"I am beginning to be appreciated,"	「私も世の中に認められ始めたんだ」
he cried;	若者は大声を出しました。
"this is from some great admirer.	「これは誰か、熱烈なファンからのものだな。
Now I can finish my play,"	これで芝居が完成できるぞ」
and he looked quite happy.	若者はとても幸福そうでした。
The next day the Swallow flew down to the harbour.	次の日、ツバメは波止場へ行きました。
He sat on the mast of a large vessel and watched the sailors hauling big chests out of the hold with ropes.	大きな船のマストの上にとまり、 水夫たちが大きな箱を船倉からロープで引きずり出すのを見ました。
"Heave a-hoy!" they shouted as each chest came up.	箱が一つ出るたびに「よいこらせ！」と水夫たちは叫びました。
"I am going to Egypt"!	「僕はエジプトに行くんだよ！」
cried the Swallow, but nobody minded,	とツバメも大声を出しましたが、誰も気にしませんでした。
and when the moon rose he flew back to the Happy Prince.	月が出るとツバメは幸福の王子のところに戻りました。
"I am come to bid you good-bye,"	「おいとまごいにやってきました」
he cried.	ツバメは声をあげました。
"Swallow, Swallow, little Swallow,"	「ツバメさん、ツバメさん、小さなツバメさん」
said the Prince,	と王子は言いました。
"will you not stay with me one night longer?"	「もう一晩泊まってくれませんか」
"It is winter,"	「もう冬です」
answered the Swallow,	ツバメは答えました。
"and the chill snow will soon be here.	「冷たい雪がまもなくここにも降るでしょう。
In Egypt the sun is warm on the green palm-trees, and the crocodiles lie in the mud and look lazily about them.	エジプトでは太陽の光が緑のシュロの木に温かく注ぎ、 ワニたちは泥の中に寝そべってのんびり過ごしています。
My companions are building a nest in the Temple of Baalbec, and the pink and white doves are watching them, and cooing to each other.	友人たちは、バールベック寺院の中に巣を作っており、 ピンクと白のハトがそれを見て、クークーと鳴き交わしています。
Dear Prince,	王子様。
I must leave you,	僕は行かなくちゃなりません。
but I will never forget you,	あなたのことは決して忘れません。
and next spring I will bring you back two beautiful jewels in place of those you have given away.	来年の春、僕はあなたがあげてしまった宝石二つの代わりに、 美しい宝石を二つ持って帰ってきます。
The ruby shall be redder than a red rose, and the sapphire shall be as blue as the great sea."	ルビーは赤いバラよりも赤く、 サファイアは大海のように青いものになるでしょう」
"In the square below,"	「下のほうに広場がある」
said the Happy Prince,	と幸福の王子は言いました。
"there stands a little match-girl.	「そこに小さなマッチ売りの少女がいる。
She has let her matches fall in the gutter, and they are all spoiled.	マッチを溝に落としてしまい、全部駄目になってしまった。
Her father will beat her if she does not bring home some money,	お金を持って帰れなかったら、お父さんが女の子をぶつだろう。
and she is crying.	だから女の子は泣いている。
She has no shoes or stockings, and her little head is bare.	あの子は靴も靴下もはいていないし、何も頭にかぶっていない。
Pluck out my other eye, and give it to her,	私の残っている目を取り出して、あの子にやってほしい。
and her father will not beat her."	そうすればお父さんからぶたれないだろう」
"I will stay with you one night longer,"	「もう一晩、あなたのところに泊まりましょう」
said the Swallow,	ツバメは言いました。
"but I cannot pluck out your eye.	「でも、あなたの目を取り出すなんてできません。
You would be quite blind then."	そんなことをしたら、あなたは何も見えなくなってしまいます」
"Swallow, Swallow, little Swallow,"	「ツバメさん、ツバメさん、小さなツバメさん」
said the Prince,	と王子は言いました。
"do as I command you."	「私が命じたとおりにしておくれ」
So he plucked out the Prince's other eye, and darted down with it.	そこでツバメは王子のもう片方の目を取り出して、下へ飛んでいきました。
He swooped past the match-girl, and slipped the jewel into the palm of her hand.	ツバメはマッチ売りの少女のところまでさっと降りて、 宝石を手の中に滑り込ませまし
"What a lovely bit of glass,"	「とってもきれいなガラス玉！」
cried the little girl;	その少女は言いました。
and she ran home, laughing.	そして笑いながら走って家に帰りました。
Then the Swallow came back to the Prince.	それからツバメは王子のところに戻りました。
"You are blind now,"	「あなたはもう何も見えなくなりました」
he said,	とツバメは言いました。
"so I will stay with you always."	「だから、ずっとあなたと一緒にいることにします」
"No, little Swallow,"	「いや、小さなツバメさん」
said the poor Prince,	とかわいそうな王子は言いました。
"you must go away to Egypt."	「あなたはエジプトに行かなくちゃいけない」
"I will stay with you always,"	「僕はずっとあなたと一緒にいます」
said the Swallow,	ツバメは言いました。
and he slept at the Prince's feet.	そして王子の足元で眠りました。
All the next day he sat on the Prince's shoulder, and told him stories of what he had seen in strange lands.	次の日一日、ツバメは王子の肩に止まり、珍しい土地で見てきたたくさんの話をしました。
He told him of the red ibises, who stand in long rows on the banks of the Nile, and catch gold-fish in their beaks;	ナイル川の岸沿いに長い列をなして立っていて、 くちばしで黄金の魚を捕まえる赤いトキの話。
of the Sphinx, who is as old as the world itself, and lives in the desert, and knows everything;	世界と同じくらい古くからあり、 砂漠の中に住んでいて、何でも知っているスフィンクスの話。
of the merchants, who walk slowly by the side of their camels, and carry amber beads in their hands;	琥珀のロザリオを手にして、ラクダの傍らをゆっくり歩く貿易商人の話。
of the King of the Mountains of the Moon, who is as black as ebony, and worships a large crystal;	黒檀のように黒い肌をしており、大きな水晶を崇拝している月の山の王の話。
of the great green snake that sleeps in a palm-tree, and has twenty priests to feed it with honey-cakes;	シュロの木で眠る緑の大蛇がいて、二十人の僧侶が蜂蜜のお菓子を食べさせている話。
and of the pygmies who sail over a big lake on large flat leaves, and are always at war with the butterflies.	広く平らな葉に乗って大きな湖を渡り、蝶といつも戦争しているピグミーの話。
"Dear little Swallow,"	「可愛い小さなツバメさん」
said the Prince,	王子は言いました。
"you tell me of marvellous things,	「あなたは驚くべきことを聞かせてくれた。
but more marvellous than anything is the suffering of men and of women.	しかし、苦しみを受けている人々の話ほど驚くべきことはない。
There is no Mystery so great as Misery.	度しがたい悲しみ以上に解きがたい謎はないのだ。
Fly over my city, little Swallow,	小さなツバメさん、町へ行っておくれ。
and tell me what you see there."	そしてあなたの見たものを私に教えておくれ」
So the Swallow flew over the great city, and saw the rich making merry in their beautiful houses, while the beggars were sitting at the gates.	ツバメはその大きな町の上を飛びまわり、 金持ちが美しい家で幸せに暮らす一方で、 乞食がその家の門の前に座っているのを見ました。
He flew into dark lanes, and saw the white faces of starving children looking out listlessly at the black streets.	暗い路地に入っていき、ものうげに黒い道を眺めている空腹な子供たちの青白い顔を見ました。
Under the archway of a bridge two little boys were lying in one another's arms to try and keep themselves warm.	橋の通りの下で小さな少年が二人、互いに抱き合って横になり、暖め合っていました。
"How hungry we are!"	「お腹がすいたよう」
they said.	と二人は口にしていましたが
"You must not lie here,"	「ここでは横になっていてはいかん」
shouted the Watchman, and they wandered out into the rain.	と夜警が叫び、二人は雨の中へとさまよい出ました。
Then he flew back and told the Prince what he had seen.	それからツバメは王子のところへ戻って、 見てきたことを話しました。
"I am covered with fine gold,"	「私の体は純金で覆われている」
said the Prince,	と王子は言いました。
"you must take it off, leaf by leaf, and give it to my poor;	「それを一枚一枚はがして、貧しい人にあげなさい。
the living always think that gold can make them happy."	生きている人は、金があれば幸福になれるといつも考えているのだ」
Leaf after leaf of the fine gold the Swallow picked off, till the Happy Prince looked quite dull and grey.	ツバメは純金を一枚一枚はがしていき、とうとう幸福の王子は完全に輝きを失い、灰色になってしまいました。
Leaf after leaf of the fine gold he brought to the poor, and the children's faces grew rosier, and they laughed and played games in the street.	ツバメが純金を一枚一枚貧しい人に送ると、子供たちの顔は赤みを取り戻し、笑い声をあげ、通りで遊ぶのでした。
"We have bread now!"	「パンが食べられるんだ！」
they cried.	と大声で言いました。
Then the snow came,	やがて、雪が降ってきました。
and after the snow came the frost.	その後に霜が降りました。
The streets looked as if they were made of silver, they were so bright and glistening;	通りは銀でできたようになり、 たいそう光り輝いておりました。
long icicles like crystal daggers hung down from the eaves of the houses, everybody went about in furs, and the little boys wore scarlet caps and skated on the ice.	水晶のような長いつららが家ののきから下がり、みんな毛皮を着て出歩くようになり、 子供たちは真紅の帽子をかぶり、氷の上でスケートをしました。
The poor little Swallow grew colder and colder,	かわいそうな小さなツバメにはどんどん寒くなってきました。
but he would not leave the Prince,	でも、ツバメは王子の元を離れようとはしませんでした。
he loved him too well.	心から王子のことを愛していたからです。
He picked up crumbs outside the baker's door when the baker was not looking and tried to keep himself warm by flapping his wings.	パン屋が見ていないとき、ツバメはパン屋のドアの外でパン屑を拾い集め、翼をぱたぱたさせて自分を暖めようとしました。
But at last he knew that he was going to die.	でも、とうとう自分は死ぬのだとわかりました。
He had just strength to fly up to the Prince's shoulder once more.	ツバメには、王子の肩までもう一度飛びあがるだけの力しか残っていませんでした。
"Good-bye, dear Prince!"	「さようなら、愛する王子様」
he murmured,	ツバメはささやくように言いました。
"will you let me kiss your hand?"	「あなたの手にキスをしてもいいですか」
"I am glad that you are going to Egypt at last, little Swallow,"	「あなたがとうとうエジプトに行くのは、私もうれしいよ、小さなツバメさん」
said the Prince,	と王子は言いました。
"you have stayed too long here; but you must kiss me on the lips, for I love you."	「あなたはここに長居しすぎた。 でも、キスはくちびるにしておくれ。 私もあなたを愛しているんだ」
"It is not to Egypt that I am going,"	「私はエジプトに行くのではありません」
said the Swallow.	とツバメは言いました。
"I am going to the House of Death.	「死の家に行くんです。
Death is the brother of Sleep, is he not?"	『死』というのは『眠り』の兄弟、ですよね」
And he kissed the Happy Prince on the lips, and fell down dead at his feet.	そしてツバメは幸福の王子のくちびるにキスをして、死んで彼の足元に落ちていきました。
At that moment a curious crack sounded inside the statue, as if something had broken.	その瞬間、像の中で何かが砕けたような奇妙な音がしました。
The fact is that the leaden heart had snapped right in two.	それは、鉛の心臓がちょうど二つに割れた音なのでした。
It certainly was a dreadfully hard frost.	ひどく寒い日でしたから。
Early the next morning the Mayor was walking in the square below in company with the Town Councillors.	次の日の朝早く、市長が市会議員たちと一緒に、像の下の広場を歩いておりました。
As they passed the column he looked up at the tatue:	柱を通りすぎるときに市長が像を見上げました。
"Dear me! how shabby the Happy Prince looks!"	「おやおや、この幸福の王子は何てみすぼらしいんだ」
he said.	と市長は言いました。
"How shabby indeed!"	「何てみすぼらしいんだ」
cried the Town Councillors,	市会議員たちは叫びました。
who always agreed with the Mayor;	彼らはいつも市長に賛成するのです。
and they went up to look at it.	皆は像を見ようと近寄っていきました。
"The ruby has fallen out of his sword, his eyes are gone, and he is golden no longer,"	「ルビーは剣から抜け落ちてるし、目は無くなってるし、もう金の像じゃなくなっているし」
said the Mayor in fact,	と市長は言いました
"he is litttle beter than a beggar!"	「これでは乞食とたいして変わらんじゃないか」
"Little better than a beggar,"	「乞食とたいして変わらんじゃないか」
said the Town Councillors.	と市会議員たちが言いました。
"And here is actually a dead bird at his feet!"	「それに、死んだ鳥なんかが足元にいる」
continued the Mayor.	市長は続けました。
"We must really issue a proclamation that birds are not to be allowed to die here."	「われわれは実際、鳥類はここで死ぬことあたわずという布告を出さねばならんな」
And the Town Clerk made a note of the suggestion.	そこで書記がその提案を書きとめました。
So they pulled down the statue of the Happy Prince.	そこで彼らは幸福の王子の像を下ろしました。
"As he is no longer beautiful he is no longer useful,"	「もう美しくないから、役にも立たないわけだ」
said the Art Professor at the University.	大学の芸術の教授が言いました。
Then they melted the statue in a furnace, and the Mayor held a meeting of the Corporation to decide what was to be done with the metal.	溶鉱炉で像を溶かすときに、その金属を使ってどうするかを決めるため、市長は市議会を開きました。
"We must have another statue, of course,"	「もちろん他の像を立てなくてはならない」
he said,	と市長は言いました。
"and it shall be a statue of myself."	「そしてその像は私の像でなくてはなるまい」
"Of myself,"	「いや、私の像です」
said each of the Town Councillors, and they quarrelled.	と市会議員たちがそれぞれ言い、口論になりました。
When I last heard of them they were quarrelling still.	私が彼らのうわさを最後に聞いたときも、まだ口論していました。
"What a strange thing!"	「おかしいなあ」
said the overseer of the workmen at the foundry.	鋳造所の労働者の監督が言いました。
"This broken lead heart will not melt in the furnace. We must throw it away."	「この壊れた鉛の心臓は溶鉱炉では溶けないぞ。 捨てなくちゃならんな」
So they threw it on a dust-heap	心臓は、ごみために捨てられました。
where the dead Swallow was also lying.	そこには死んだツバメも横たわっていたのです。
"Bring me the two most precious things in the city," said God to one of His Angels; 	神さまが天使たちの一人に「町の中で最も貴いものを二つ持ってきなさい」とおっしゃいました。
and the Angel brought Him the leaden heart and the dead bird.	その天使は、神さまのところに鉛の心臓と死んだ鳥を持ってきました。
"You have rightly chosen," said God,	神さまは「よく選んできた」とおっしゃいました。
"for in my garden of Paradise this little bird shall sing for evermore, and in my city of gold the Happy Prince shall praise me."	「天国の庭園でこの小さな鳥は永遠に歌い、黄金の都でこの幸福の王子は私を賛美するだろう」
