LYKKENS KALOSKER	幸福のうわおいぐつ
Hans Christian Andersen	ハンス・クリスティアン・アンデルセン
I. A Beginning	一　お話のはじまり
In one of the houses not far from the new market a party was invited--a very large party,	コペンハーゲンで、そこの東通の、王立新市場からとおくない一軒の家は、たいそうおおぜいのお客でにぎわっていました。
in order, as is often the case, to get a return invitation from the others.	人と人とのおつきあいでは、ときおりこちらからお客をしておけば、そのうち、こちらもお客によばれるといったものでしてね。
One half of the company was already seated at the card-table,	お客の半分はとうにカルタ卓（づくえ）にむかっていました。
the other half awaited the result of the stereotype preliminary observation of the lady of the house:	あとの半分は、主人役の奥さんから、今しがた出た、
"Now let us see what we can do to amuse ourselves."	「さあ、こんどはなにがはじまりしましょうね。」
They had got just so far, and the conversation began to crystallise,	もうずいぶんお客さま同士の話がはずむだけはずんでいました。
Amongst other things they spoke of the middle ages:	そういう話のなかには、中世紀時代の話もでました。
some praised that period as far more interesting, far more poetical than our own too sober present;	あるひとりは、あの時代は今の時代にくらべては、くらべものにならないほどよかったと主張しました。
indeed Councillor Knap defended this opinion so warmly, that the hostess declared immediately on his side,	じっさい司法参事官（しほうさんじかん）のクナップ氏などは、この主張（しゅうちょう）にとても熱心で、さっそく主人役の奥さんを身方につけてしまったほどでした。
and both exerted themselves with unwearied eloquence.	そうしてこのふたりは＊エールステッドが年報誌上にかいた古近代論の、現代びいきな説にたいして、やかましい攻撃をはじめかけたくらいです。
The Councillor boldly declared the time of King Hans to be the noblest and the most happy period.*	司法参事官の説にしたがえば、デンマルクの＊＊ハンス王時代といえば、人間はじまって以来、いちばんりっぱな、幸福な時代であったというのでした。
* A.D. 1482-1513	＊デンマルクの名高い物理学者（一七七七―一八五一）。
While the conversation turned on this subject, and was only for a moment interrupted by the arrival of a journal	さて会話は、こんなことで、賛否（さんぴ）こもごも花が咲いて、あいだに配達の夕刊がとどいたので、ちょっと話がとぎれたぐらいのことでした。
that contained nothing worth reading,	でも、新聞にはべつだんおもしろいこともありませんでしたから、話はそれなりまたつづきました。
we will just step out into the antechamber,	で、わたしたちはちょっと表の控間へはいってみましょう。
where cloaks, mackintoshes, sticks, umbrellas, and shoes, were deposited.	そこにはがいとうと、つえと、かさと、くつの上にはうわおいぐつが一足（いっそく）置いてありました。
Here sat two female figures,	みるとふたりの婦人が卓（つくえ）のまえにすわっていました。
a young and an old one.	ひとりはまだ若い婦人ですが、ひとりは年をとっていました。
One might have thought at first they were servants come to accompany their mistresses home;	ちょっとみると、お客のなかのお年よりのお嬢さん、または未亡人（びぼうじん）の奥さんのお迎えに来て、待っている女中かとおもうでしょう。
but on looking nearer, one soon saw they could scarcely be mere servants;	でもよくみると、ふたりとも、ただの女中などでないということはわかりました。
their forms were too noble for that, their skin too fine, the cut of their dress too striking.	それにはふたりともきゃしゃすぎる手をしていましたし、ようすでも、ものごしでも、りっぱすぎていましたが、着物のしたて方にしても、ずいぶんかわっていました。
Two fairies were they;	ほんとうは、このふたりは妖女（ようじょ）だったのです。
the younger, it is true, was not Dame Fortune herself, but one of the waiting-maids of her handmaidens who carry about the lesser good things that she distributes;	若いほうは幸福の女神でこそありませんが、そのおそばづかえのそのまた召使のひとりで、ちょいとしたちいさな幸福のおくりものをはこぶ役をつとめているのです。
the other looked extremely gloomy	年をとったほうは、だいぶむずかしい顔をしていました。
--it was Care.	これは心配の妖女でした。
She always attends to her own serious business herself,	このほうはいつもごじしん堂堂（どうどう）と、どこへでも乗り込んでいってしごとをします。
as then she is sure of having it done properly.	すると、やはりそれがいちばんうまくいくことを知ってました。
They were telling each other, with a confidential interchange of ideas, where they had been during the day.	ふたりはおたがいに、きょうどこでなにをして来たか話し合っていました。
The messenger of Fortune had only executed a few unimportant commissions,	幸福の女神のおそばづかえのそのまた召使は、ほんのふたつ三つごくつまらないことをして来ました。
such as saving a new bonnet from a shower of rain, etc.;	たとえば買い立ての帽子が夕立にあうところを助けてやったり、ある正直な男に無名の篤志家（とくしか）からほどこし物をもらってやったり、まあそんなことでした。
but what she had yet to perform was something quite unusual.	しかし、そのあとで、もうひとつ、話しのこしていたことは、いくらかかわったことであったのです。
"I must tell you,"	「まあついでだからいいますがね。」
said she,	と、幸福のおそばづかえのそのまた召使は話しました。
"that to-day is my birthday;	「きょうはわたしの誕生日（たんじょうび）なのですよ。
and in honor of it, a pair of walking-shoes or galoshes has been entrusted to me,	それでそのお祝いに、ご主人からうわおいぐつを一足（いっそく）あずけられました。
which I am to carry to mankind.	そしてそれを人間のなかま［＃「なかま」は底本では「なまか」］にやってくれというのです。
These shoes possess the property of instantly transporting him who has them on to the place or the period in which he most wishes to be; every wish, as regards time or place, or state of being, will be immediately fulfilled,	そのうわおいぐつにはひとつの徳（とく）があって、それをはいたものはたちまち、だれでもじぶんがいちばん住んでみたいとおもう時代なり場所なりへ、はこんで行ってもらえて、その時代なり場所なりについて、のぞんでいたことがさっそくにかなうのです。
and so at last man will be happy, here below."	そういうわけで、人間もどうやら、この世の中ながら幸福になれるのでしょう。」
"Do you seriously believe it?"	こういうと心配の妖女（ようじょ）が、
replied Care,	「いや、お待ちなさいよ。
"No; he will be very unhappy, and will assuredly bless the moment when he feels that he has freed himself from the fatal shoes."	そのうわおいぐつをはいた人は、きっとずいぶんふしあわせになるでしょうよ。
"Stupid nonsense!"	「まあそこまではおもわなくても。」
said the other angrily.	と、もうひとりがふふくらしくいいました。
"I will put them here by the door.	「さあ、それでは幸福のうわおいぐつを、ここの戸口におきますよ。
Some one will make a mistake for certain and take the wrong ones--he will be a happy man."	だれかがまちがってひっかけていって、いやでも、すぐと幸福な人間になるでしょう。」
Such was their conversation.	どうです。
II. What Happened to the Councillor	二　参事官はどうしたか
It was late;	もうだいぶ夜がふけていました。
Councillor Knap, deeply occupied with the times of King Hans, intended to go home,	司法参事（しほうさんじ）官クナップ氏は、ハンス王時代のことに心をとられながら、うちへかえろうとしました。
and malicious Fate managed matters so that his feet, instead of finding their way to his own galoshes, slipped into those of Fortune.	ところで運命の神さまは、この人がじぶんのとまちがえて、幸福のうわおいぐつをはくように取りはからってしまいました。
Thus caparisoned the good man walked out of the well-lighted rooms into East Street.	そこで参事官がなんの気なしにそれをはいたまま東通へ出ますと、
By the magic power of the shoes he was carried back to the times of King Hans;	もうすぐと、うわおいぐつの効能があらわれて、クナップ氏はたちまち三百五十年前のハンス王時代にまでひきもどされてしまいました。
on which account his foot very naturally sank in the mud and puddles of the street,	さっそくに参事官は往来のぬかるみのなかへ、両足つっこんでしまいました。
there having been in those days no pavement in Copenhagen.	なぜならその時代はもちろん昔のことで、石をしいた歩道なんて、ひとつだってあるはずがないのです。
"Well!	「やれやれ、
This is too bad!	これはえらいぞ、
How dirty it is here!"	いやはや、なんというきたない町だ。」
sighed the Councillor.	と参事官がいいました。
"As to a pavement, I can find no traces of one,	「どうして歩道をみんな、なくしてしまったのだろう。
and all the lamps, it seems, have gone to sleep."	街灯（がいとう）をみんな消してしまったのだろう。」
The moon was not yet very high; it was besides rather foggy, so that in the darkness all objects seemed mingled in chaotic confusion.	月はまだそう高くはのぼっていませんでしたし、おまけに空気はかなり重たくて、なんということなしに、そこらの物がくらやみのなかへとろけ出しているようにおもわれました。
At the next corner hung a votive lamp before a Madonna, but the light it gave was little better than none at all;	次の横町の角（かど）には、うすぐらい灯明がひとつ、聖母のお像のまえにさがっていましたが、そのあかりはまるでないのも同様でした。
indeed, he did not observe it before he was exactly under it, and his eyes fell upon the bright colors of the pictures which represented the well-known group of the Virgin and the infant Jesus.	すぐその下にたって、仰いでみてやっと、聖母と神子（しんじ）の彩色した像が分かるくらいでした。
"That is probably a wax-work show,"	「これはきっと美術品を売る家なのだな。
thought he;	日がくれたのに看板をひっこめるを忘れているのだ。」
"and the people delay taking down their sign in hopes of a late visitor or two."	と、参事官はおもいました。
A few persons in the costume of the time of King Hans passed quickly by him.	むかしの服装をした人がふたり、すぐそばを通っていきました。
"How strange they look!	「おや、なんというふうをしているのだ。
The good folks come probably from a masquerade!"	仮装舞踏会（かそうぶとうかい）からかえって来た人たちかな。」
Suddenly was heard the sound of drums and fifes; the bright blaze of a fire shot up from time to time, and its ruddy gleams seemed to contend with the bluish light of the torches.	ふとだしぬけに、太皷と笛の音（ね）がきこえて、たいまつがあかあかかがやき出しました。
The Councillor stood still, and watched a most strange procession pass by.	参事官はびっくりしてたちどまりますと、そのとき奇妙な行列が鼻のさきを通っていきました。
First came a dozen drummers, who understood pretty well how to handle their instruments;	まっさきには皷手の一隊が、いかにもおもしろそうに太皷を打ちながら進んで来ました。
then came halberdiers, and some armed with cross-bows.	そのあとには、長い弓と石弓をかついだ随兵（ずいひょう）がつづきました。
The principal person in the procession was a priest.	この行列のなかでいちばんえらそうな人は坊さんの殿様でした。
Astonished at what he saw, the Councillor asked what was the meaning of all this mummery, and who that man was.	びっくりした参事官は、いったいこれはいつごろの風をしているので、このすいきょうらしい仮装行列をやってあるく人はたれなのだろう、といって、行列のなかの人にたずねました。
"That's the Bishop of Zealand,"	「シェランの大僧正（そうじょう）さまです。」
was the answer.	と、たれかがこたえました。
"Good Heavens! What has taken possession of the Bishop?"	「大僧正のおもいつきだと、とんでもないことだ。」
sighed the Councillor, shaking his head.	と、参事官はため息をついてあたまを振りました。
It certainly could not be the Bishop;	そんな大僧正なんてあるものか。
Reflecting on the matter, and without looking right or left, the Councillor went through East Street and across the Habro-Platz.	ひとりで不服をとなえながら、右も左もみかえらずに、参事官はずんずん東通をとおりぬけて、高橋広場（たかばしひろば）にでました。
The bridge leading to Palace Square was not to be found;	ところが宮城広場へ出る大きな橋がみつかりません。
scarcely trusting his senses, the nocturnal wanderer discovered a shallow piece of water,	やっとあさい小川をみつけてその岸に出ました。
and here fell in with two men who very comfortably were rocking to and fro in a boat.	そのうち小舟にのってやって来るふたりの船頭らしい若者にであいました。
"Does your honor want to cross the ferry to the Holme?"	「島（ホルメン）へ渡りなさるのかな。」
asked they.	と、船頭はいいました。
"Across to the Holme!"	「島（ホルメン）へ渡るかって。」
said the Councillor,	と、参事官はおうむ返しにこたえました。
who knew nothing of the age in which he at that moment was.	なにしろ、この人はまた、じぶんが今、いつの時代に居るのか、はっきり知らなかったのです。
"No, I am going to Christianshafen, to Little Market Street."	「わたしは、クリスティアンス　ハウンから小市場通へいくのだよ。」
Both men stared at him in astonishment.	こういうと、こんどはむこうがおどろいて顔をみました。
"Only just tell me where the bridge is,"	「ぜんたい橋はどこになっているのだ。」
said he.	と参事官はいいました。
"It is really unpardonable that there are no lamps here;	「第一ここにあかりをつけておかないなんてけしからんじゃないか。
and it is as dirty as if one had to wade through a morass."	それにこのへんはまるで沼の中をあるくようなひどいぬかるみだな。」
The longer he spoke with the boatmen, the more unintelligible did their language become to him.	こんなふうに話しても、話せば話すほど船頭にはよけいわからなくなりました。
"I don't understand your Bornholmish dialect,"	「どうもおまえたちの＊ボルンホルムことばは、さっぱりわからんぞ。」
said he at last, angrily,	と、参事官はかんしゃくをおこしてどなりつけました。
and turning his back upon them.	そして背中をむけてどんどんあるきだしました。
He was unable to find the bridge:	しかしいくらあるいても、参事は橋をみつけることはできませんでした。
there was norailway either.	らんかんらしいものはまるでありませんでした。
"It is really disgraceful what a state this place is in,"	「どうもこのへんは実にひどい所だ。」
muttered he to himself.	と、参事官はいいました。
Never had his age, with which, however, he was always grumbling, seemed so miserable as on this evening.	じぶんのいる時代を、この晩ほどなさけなくおもったことはありませんでした。
"I'll take a hackney-coach!"	「まあこのぶんでは、辻馬車をやとうのがいちばんよさそうだ。」
thought he.	と、参事官はおもいました。
But where were the hackney-coaches?	そういったところで、さて、どこにその辻馬車があるでしょうか。
Not one was to be seen.	それは一台だってみあたりそうにはありませんでした。
"I must go back to the New Market;	「これではやはり、王立新市場までもどるほうがいいだろう。
there, it is to be hoped, I shall find some coaches;	あそこならたくさん馬車も来ているだろう。
for if I don't, I shall never get safe to Christianshafen."	そうでもしないと、とてもクリスティアンス　ハウンまでかえることなどできそうもない。」
So off he went in the direction of East Street,	そこで、またもどって、東通のほうへあるきだしました。
and had nearly got to the end of it when the moon shone forth.	そしてほとんどそこを通りぬけようとしたときに、たかだかと月がのぼりました。
"God bless me!	「おや、
What wooden scaffolding is that which they have set up there?"	なんとおもって足場みたいなものをここに建てたのだ。」
cried he involuntarily, as he looked at East Gate,	東門をみつけて、参事官はこうさけびました。
which, in those days, was at the end of East Street.	そのころ東通のはずれに、門があったのです。
He found, however, a little side-door open, and through this he went, and stepped into our New Market of the present time.	とにかく、出口をさがして、そこをとおりぬけると、今の王立新市場のある通へでました。
It was a huge desolate plain;	けれどそれはただのだだっ広い草原でした。
Some wretched hovels for the Dutch sailors, resembling great boxes, and after which the place was named, lay about in confused disorder on the opposite bank.	二三軒みすぼらしいオランダ船の船員のとまる下宿の木小屋（きごや）が、そのむこう岸に建っていて、オランダッ原（ぱら）ともよばれていた所です。
"I either behold a fata morgana,	「おれはしんきろうをみているのか知らん。
or I am regularly tipsy,"	それとも酔っぱらっているのじゃないか知ら。」
whimpered out the Councillor.	と、参事は泣き声をだしました。
"But what's this?"	「とにかくありゃあなんだ。」
He turned round anew, firmly convinced that he was seriously ill.	もうどうしても、病気にかかっているにちがいない、そうおもい込んで、また引っかえしました。
He gazed at the street formerly so well known to him, and now so strange in appearance, and looked at the houses more attentively: most of them were of wood, slightly put together; and many had a thatched roof.	往来をとぼとぼあるきあるき、なおよくそこらの家のようすをみると、たいていの家は木組の小屋で、なかにはわら屋根の家もありました。
"No--I am far from well,"	「いや、どうもへんな気分でしょうがない。」
sighed he;	と、参事官はため息をつきました。
"and yet I drank only one glass of punch; but I cannot suppose it--it was, too, really very wrong to give us punch and hot salmon for supper.	「しかしおれは、ほんの一杯ポンスを飲んだだけだが、それがうまくおさまらないとみえる。
I have half a mind to go back again, and say what I suffer.	もういちどもどっていって、主人の代理公使夫人に小言（こごと）をいって来ようかしらん。
But no, that would be too silly;	いや、それもばからしいようだ。
and Heaven only knows if they are up still."	それにまだ起きているかどうかわからない。」
He looked for the house, but it had vanished.	そういいながら、その家の方角をさがしましたが、どうしてもみつかりませんでした。
"It is really dreadful,"	「どうもひどいことだ。
"I cannot recognise East Street again;	東通がまるでわからなくなった。
there is not a single decent shop from one end to the other!	一軒の店もみえはしない。
Nothing but wretched huts can I see anywhere;	みすぼらしいたおれかけの小屋がみえるだけだ。
just as if I were at Ringstead.	これではまるでリョースキレか、リンステッドへでもいったようだ。
Oh!	ああ、
I am ill!	おれは病気だぞ。
I can scarcely bear myself any longer.	遠慮をしているところでない。
Where the deuce can the house be?	だが、いったい代理公使の家はどこなんだろう。
yet there is not the slightest idea of resemblance, to such a degree has everything changed this night!	どうしてももうもととはちがっている。
At all events here are some people up and stirring.	しかもなかには人がまだ起きている。
Oh! oh! I am certainly very ill."	――どうしてもおれは病気だ。」
He now hit upon a half-open door,	そのとき参事官は、一軒戸のあいている家の前へ出ました。
through a chink of which a faint light shone.	すきまからあかりが往来へさしていました。
It was a sort of hostelry of those times; a kind of public-house.	これはそのころの安宿で、半分居酒屋のようなものでした。
The room had some resemblance to the clay-floored halls in Holstein;	ところで、そのなかはホルシュタイン風の百姓家の台所といったていさいでした。
a pretty numerous company, consisting of seamen, Copenhagen burghers, and a few scholars, sat here in deep converse over their pewter cans, and gave little heed to the person who entered.	なかにはおおぜいの人間が、船乗や、コペンハーゲンの町人や二三人の本読（ほんよみ）もまじって、みんなビールのジョッキをひかえて、むちゅうになってしゃべっていて、はいって来た客にはいっこう気がつかないようでした。
"By your leave!"	参事官はお客をむかえにたったおかみさんにいいました。
said the Councillor to the Hostess, who came bustling towards him.	「お気のどくですが、わたしは非常にぐあいがわるいのです。
would you have the goodness to send for a hackney-coach to take me to Christianshafen?"	クリスティアンスハウンまで、辻馬車をやとってはもらえませんか。」
The woman examined him with eyes of astonishment, and shook her head;	おかみさんは、参事官の顔をうさんらしくみて首をふりました。
she then addressed him in German.	それからドイツ語で話しかけました。
The Councillor thought she did not understand Danish, and therefore repeated his wish in German.	参事官はそれで、おかみさんがデンマルク語を知らないことがわかったので、こんどはドイツ語で同じ註文をくり返しました。
This, in connection with his costume, strengthened the good woman in the belief that he was a foreigner.	その言葉と服装から、おかみさんは、この客をてっきり外国人だとおもい込みました。
That he was ill, she comprehended directly; so she brought him a pitcher of water,	で、気分のわるそうなようすをみると、さっそく水をジョッキに一杯ついでもって来ました。
which tasted certainly pretty strong of the sea,	水はなんだかしょっぱいへんな味がしました。
although it had been fetched from the well.	そのくせ外の噴井戸（ふきいど）から汲んで来たのです。
The Councillor supported his head on his hand, drew a long breath, and thought over all the wondrous things he saw around him.	参事官は両手であたまをおさえて、ふかいためいきをつきながら、いまし方つづいておこった奇妙なことを、あれこれとおもいめぐらしていました。
"Is this the Daily News of this evening?"	「それはきょうの＊『ダーエン』ですか。」
he asked mechanically, as he saw the Hostess push aside a large sheet of paper.	と、参事官は、おかみさんがもっていきかけた大きな紙をみて、ほんのおせじにききました。
The meaning of this councillorship query remained, of course, a riddle to her, yet she handed him the paper without replying.	お上さんは、なにを客がいうのだかわかりませんでしたから、だまってその紙を渡しました。
It was a coarse wood-cut, representing a splendid meteor "as seen in the town of Cologne," which was to be read below in bright letters.	それはむかし、キョルンの町にあらわれたふしぎな空中現象（げんしょう）をかいた一枚の木版刷（もくはんずり）でした。
"That is very old!"	「こりゃなかなか古い。」
said the Councillor, whom this piece of antiquity began to make considerably more cheerful.	と参事官は、あんがいな掘り出しもので、おおきに愉快になりました。
"Pray how did you come into possession of this rare print?	「おまえさん、このめずらしい刷物（すりなの）をどうして手に入れたのだね。
It is extremely interesting,	こりゃなかなかおもしろいものだよ。
although the whole is a mere fable.	もっとも話はまるっきりおとぎばなしだがね。
Such meteorous appearances are to be explained in this way--that they are the reflections of the Aurora Borealis,	今日では、これに類した空中現象は、北極光をみあやまったものだということになつている。
and it is highly probable they are caused principally by electricity."	おそらく電気の作用でおこるものらしい。」
Those persons who were sitting nearest him and heard his speech, stared at him in wonderment;	すると参事官のすぐそばにすわって、この話をきいた人たちが、びっくりしてその顔をながめました。
and one of them rose, took off his hat respectfully, and said with a serious countenance,	そして、そのうちのひとりは、たち上がって、うやうやしく帽子をぬいで、ひどくしかつめらしく
"You are no doubt a very learned man, Monsieur."	「先生、どうも、あなたはたいそうな学者でおいでになりますな。」
"Oh no,"	「いやはや、どういたしまして。」
answered the Councillor,	と、参事官は答えました。
"I can only join in conversation on this topic and on that, as indeed one must do according to the demands of the world at present."	「ついだれでも知っているはずのことをふたことみこと、お話しただけですよ。」
"Modestia is a fine virtue,"	「けんそんは美徳で。」
continued the gentleman;	とその男はラテン語まじりにいいました。
"however, as to your speech, I must say mihi secus videtur:	「［＃「「」は底本では欠落］もっともお説にたいして、わたくしは異説をさしはさむものであります。
yet I am willing to suspend my judicium."	しかしながら、わたくしの批判はしばらく保留いたしましよう。」
"May I ask with whom I have the pleasure of speaking?"	「失礼ながら、あなたはどなたですか。」
asked the Councillor.	と、参事官がたずねました。
"I am a Bachelor in Theologia,"	「わたくしは聖書得業士でして。」
answered the gentleman with a stiff reverence.	と、その男が答えました。
This reply fully satisfied the Councillor;	その答で参事官は十分でした。
the title suited the dress.	その人の称号と服装はそれによくつりあっていました。
"He is certainly,"	多分、これは村の老先生というやつにちがいない。
thought he,	よくユラン（ユットランド）地方でみかけるかわりものだと参事官はおもいました。
"This is no locus docendi, it is true,"	「ここはいかにも学者清談の郷ではありませんな。」
began the clerical gentleman;	と、その男はつづけていいだしました。
"yet I beg you earnestly to let us profit by your learning.	「しかしどうかまげてお話しください。
Your reading in the ancients is, sine dubio, of vast extent?"	あなたはむろん、古書はふかくご渉猟（しょうりょう）でしょうな。」
"Oh yes, I've read something, to be sure,"	「はい、はい、それはな。」
replied the Councillor.	と、参事官は受けて、
"I like reading all useful works; but I do not on that account despise the modern ones;	「わたしも有益な古書を読むことは大好きですが、とうせつの本もずいぶん読みます。
'tis only the unfortunate 'Tales of Every-day Life' that I cannot bear--we have enough and more than enough such in reality."	ただ困るのは『その日、その日の話』というやつで、わざわざ本でよまないでも、毎日のことで飽き飽きしますよ。」
"'Tales of Every-day Life?'"	「［＃「「」は底本では「『」］『その日、その日の話』といいますと。」
said our Bachelor inquiringly.	と、得業士はふしんそうにききました。
"I mean those new fangled novels, twisting and writhing themselves in the dust of commonplace, which also expect to find a reading public."	「いや、わたしのいうのは、このごろはやる新作の小説のことですよ。」
"Oh,"	「ははあ。」
exclaimed the clerical gentleman smiling,	と、得業士はにっこりしながら、
"there is much wit in them; besides they are read at court.	「あれもなかなか気のきいたものでして、宮中ではずいぶん読まれていますよ。
The King likes the history of Sir Iffven and Sir Gaudian particularly, which treats of King Arthur, and his Knights of the Round Table;	＊王様はとりわけ、アーサー王と円卓（えんたく）の騎士の話を書いた、イフヴェンとゴーディアンの物語を好いていられます。
he has more than once joked about it with his high vassals."	それでご家来の人達とあの話をして興（きょう）がっていられます。」
"I have not read that novel,"	「それはまだ読んでいません。」
said the Councillor;	と、参事官はいいました。
"it must be quite a new one, that Heiberg has published lately."	「ハイベルが出した新刊の本にちがいありませんね。」
"No,"	「いや、ハイベルではありません。
answered the theologian of the time of King Hans:	ゴットフレト　フォン　ゲーメンが出したのです。」
"that book is not written by a Heiberg, but was imprinted by Godfrey von Gehmen."	と、学士は答えました。
"Oh, is that the author's name?"	「へへえ、その人は作者ですか。」
said the Councillor.	と、参事官がたずねました。
"It is a very old name,	「ゴットフレト　フォン　ゲーメンといえば、すいぶん古い名まえですね。
and, as well as I recollect, he was the first printer that appeared in  Denmark."	あれはなんでも、ハンス王時代、デンマルクで印刷業をはじめた人ではありませんか。」
"Yes,	「そうですとも。
he is our first printer,"	この国でははじめての印刷屋さんですよ。」
replied the clerical gentleman hastily.	と、学士が答えました。
So far all went on well.	ここまではどうにかうまくいきました。
Some one of the worthy burghers now spoke of the dreadful pestilence that had raged in the country a few years back,	こんどは町人のひとりが、三年まえ流行した伝染病の話をしだしました。
meaning that of 1484.	ただそれは一四八四年の話でした。
The Councillor imagined it was the cholera that was meant, which people made so much fuss about;	参事官はそれを一八三〇年代はやったコレラの話をしているのだとおもいました。
and the discourse passed off satisfactorily enough.	そこで会話は、どうにかつじつまがあいました。
The war of the buccaneers of 1490 was so recent that it could not fail being alluded to;	一四九〇年の海賊戦争もつい近頃のことでしたから、これも話題にのぼらずにいませんでした。
the English pirates had, they said, most shamefully taken their ships while in the roadstead;	で、イギリスの海賊船が、やはり同じ波止場か船をりゃくだつしていった、とその男は話しました。
and the Councillor, before whose eyes the Herostratic* event of 1801 still floated vividly, agreed entirely with the others in abusing the rascally English.	ところで、＊一八〇一年の事件をよく知っている参事官は、進んでその話に調子をあわせて、イギリス人に攻撃をしかけました。
With other topics he was not so fortunate;	これだけはまずよかったが、そのあとの話はそううまくばつがあいませんでした。
every moment brought about some new confusion,	ひとつひとつに話がくいちがいました。
for the worthy Bachelor was really too ignorant,	学士先生は気のどくなほどなにも知りませんでした。
and the simplest observations of the Councillor sounded to him too daring and phantastical.	参事官のごくかるく口にしたことまでが、いかにもでたらめな、気ちがいじみた話にきこえました。
They looked at one another from the crown of the head to the soles of the feet;	そうなると、ふたりはだまって顔ばかりみあわせました。
and when matters grew to too high a pitch, then the Bachelor talked Latin, in the hope of being better understood--but it was of no use after all.	いよいよいけないとなると、学士はいくらか相手にわからせることができるかとおもって、ラテン語で話しましたけれど、いっこう役には立ちませんでした。
"What's the matter?"	「あなた、ご気分はどうですね。」
asked the Hostess, plucking the Councillor by the sleeve;	と、おかみさんはいって、参事官のそでをひっぱりました。
and now his recollection returned,	ここではじめて、参事官はわれにかえりました。
for in the course of the conversation he had entirely forgotten all that had preceded it.	話でむちゅうになっているあいだは、これまでのことをいっさい忘れていたのです。
"Merciful God, where am I!"	「やあ、たいへん、わたしはどこにいるのだ。」
exclaimed he in agony; and while he so thought, all his ideas and feelings of overpowering dizziness,	と、参事官はいって、それをおもいだしたとたん、くらくらとなったようでした。
"Let us drink claret	「さあ、クラレットをやろうよ。
fand mead, and Bremen beer,"	蜜酒に、ブレーメン・ビールだ。」
shouted one of the guests--	と、客のひとりがさけびました。
"and you shall drink with us!"	「どうです、いっしょにやりたまえ。」
Two maidens approached.	ふたりの給仕のむすめがはいって来ました。
One wore a cap of two staring colors, denoting the class of persons to whicddh she belonged.	そのひとりは＊［＃「＊」は底本では欠落］ふた色の染分け帽子をかぶって来ました。
They poured out the liquor, and made the most friendly gesticulations;	ふたりはお酒をついでまわって、おじぎをしました。
while a cold perspiration trickled down the back of the poor Councillor.	参事官はからだじゅうぞっとさむけがするようにおもいました。
"What's to be the end of this!	「やあ、こりゃなんだ。
What's to become of me!"	こりゃなんだ。」
groaned he;	と、参事官はさけびました。
but he was forced, in spite of his opposition, to drink with the rest.	けれども、いやでもいっしょに飲まなければなりませんでした。
They took hold of the worthy man;	客どもはごくたくみにこの紳士（しんし）をあつかいました。
who, hearing on every side that he was intoxicated,	たれか、
did not in the least doubt the truth of this certainly not very polite assertion;	そのことばをうそだとおこるどころではありません。
but on the contrary, implored the ladies and gentlemen present to procure him a hackney-coach:	どうぞ、ドロシュケ（辻馬車）を一台たのむといったのが精いっぱいでした。
they, however, imagined he was talking Russian .	ところがみんなはそれをロシア語でも話しているのかとおもいました。
Never before, he thought, had he been in such a coarse and ignorant company;	参事官は、これまでこんな下等な乱暴ななかまにはいったことはありませんでした。
one might almost fancy the people had turned heathens again.	「これではまるで、デンマルクの国が、異教国の昔にかえったようだ。
"It is the most dreadful moment of my life:	こんなおそろしい目にあったことははじめてだぞ。」
But suddenly it occurred to him that he might stoop down under the table, and then creep unobserved out of the door.	しかしそのときふとおもいついて、参事官はテーブルの下にもぐりこんで、そこから戸口の所まではい出そうとしました。
He did so; but just as he was going, the others remarked what he was about;	そのとおりうまくやって、ちょうど出口までいったところを、ほかの者にみつけられました。
they laid hold of him by the legs;	みんなは参事官の足をとって引きもどしました。
and now, happily for him, off fell his fatal shoes	そのとき大仕合わせなことには、うわおおいぐつがすっぽりぬけました。
--and with them the charm was at an end.	――それでいっさいの魔法が消えてなくなりました。
The Councillor saw quite distinctly before him a lantern burning, and behind this a large handsome house.	そのとき参事官ははっきりと、すぐ目のまえに、街灯がひとつ、かんかんともっていて、そのうしろに大きな建物の立っているのをみつけました。
All seemed to him in proper order as usual;	そこらじゅうみまわしても、おなじみのあるものばかりでした。
it was East Street, splendid and elegant as we now see it.	それは、今の世の中で毎日みているとおりの東通でした。
He lay with his feet towards a doorway,	参事官は玄関の戸に足をむけて腹ンばいになっていたのです。
and exactly opposite sat the watchman asleep.	すぐむこうには町の夜番が、すわって寝込んでいました。
"Gracious Heaven!"	「やあたいへん、おれは往来で寝て、夢をみていたのか。」
said he.	と、参事官はさけびました。
Yes;'tis East Street!	「なるほど、これは東通だわい。
How splendid and light it is!	どうもなにかが、かんかんあかるくって、にぎやかだな。
But really it is terrible what an effect that one glass of punch must have had on me!"	それにしてもいっぱいのポンスのききめはじつにおそろしい。」
Two minutes later, he was sitting in a hackney-coach and driving to Frederickshafen.	それから二分ののち参事官は、ゆうゆうと辻馬車のなかにすわって、クリスティアンス　ハウンのじぶんの家のほうへはこばれて［＃「はこばれて」は底本では「はこぱれて」］いきました。
He thought of the distress and agony he had endured, and praised from the very bottom of his heart the happy reality--our own time--which, with all its deficiencies, is yet much better than that in which, so much against his inclination, he had lately been.	参事官はいましがたさんざんおそろしい目や心配な目にあったことをおもいだすと、今の世の中には、それはいろいろわるいことはあっても、ついさっきもっていかれた昔の時代よりはずっとましだということをさとりました。
III. The Watchman's Adventure	三　夜番のぼうけん
"Why, there is a pair of galoshes, as sure as I'm alive!"	「おやおや、あすこにうわおいぐつが一足ころがっている。」
said the watchman,	と夜番はいいました。
"They belong no doubt to the lieutenant who lives over the way.	「きっとむこうの二階にいる中尉さんの物にちがいない。
They lie close to the door."	すぐ門口にころがっているから。」
The worthy man was inclined to ring and deliver them at the house,	正直な夜番は、ベルをならして、うわおいぐつを持主にわたそうとおもいました。
for there was still a light in the window;	二階にはまだあかりがついていました。
but he did not like disturbing the other people in their beds, and so very considerately he left the matter alone.	けれど、うちのなかのほかの人たちまでおどろかすのも気のどくだとおもったので、そのままにしておきました。
"Such a pair of shoes must be very warm and comfortable,"	「だが、こういうものをはいたら、ずいぶん温かいだろうな。」
said he;	と、夜番はひとりごとをいいました。
"the leather is so soft and supple."	「なんて上等なやわらかい革がつかってあるのだろう。」
They fitted his feet as though they had been made for him.	うわおいぐつはぴったり夜番の足にあいました。
"'Tis a curious world we live in,"	「どうも、世の中はおかしなものだ。
"There is the lieutenant, now, who might go quietly to bed if he chose, where no doubt he could stretch himself at his ease; but does he do it?	いまごろ中尉さんは、あの温かい寝床のなかで横になっていればいられるはすなのだ。
No;	ところが、そうでない。
he saunters up and down his room,	へやのなかをいったり来たり、あるいている。
That's a happy fellow!	ありゃしあわせなお人さな。
He has neither an infirm mother, nor a whole troop of everlastingly hungry children to torment him.	おかみさんもこどももなくて、
Every evening he goes to a party, where his nice supper costs him nothing:	毎晩、夜会にでかけていく。
would to Heaven I could but change with him! How happy should I be!"	おれがあの人だったらずいぶんしあわせな人間だろうな。」
While expressing his wish, the charm of the shoes, which he had put on, began to work;	夜番がこういって、こころのねがいを口にだしますと、はいていたうわおいぐつはみるみる効能をあらわして、
the watchman entered into the being and nature of the lieutenant.	夜番のたましいはするすると中尉のからだとこころのなかへ運んで持っていかれました。
He stood in the handsomely furnished apartment, and held between his fingers a small sheet of rose-colored paper,	そこで夜番は、二階のへやにはいって、ちいさなばら色の紙を指のまたにはさんで持ちました。
on which some verses were written--written indeed by the officer himself;	それには詩が、中尉君自作の詩が書いてありました。
for who has not, at least once in his life, had a lyrical moment?	それはどんな人だって、一生にいちどは心のなかを歌にうたいたい気持になるおりがあるもので、
And if one then marks down one's thoughts, poetry is produced.	そういうとき、おもったとおりを紙に書けば［＃「書けば」は底本では「書けは」］、詩になります。
But here was written:	そこで紙にはこう書いてありました。
OH, WERE I RICH!	「ああ、金持でありたいな。」
"Oh, were I rich!	「ああ、金持でありたいな。」
Such was my wish, yea such	おれはたびたびそうおもった。
When hardly three feet high, I longed for much.	やっと二尺のがきのとき、おれはいろんな望をおこした。
Oh, were I rich! an officer were I,	ああ、金持でありたいな――そうして士官になろうとした、
With sword, and uniform, and plume so high.	サーベルさげて、軍服すがたに、負革（おいかわ）かけて。
And the time came, and officer was I!	時節がくると、おれも士官になりすました。
But yet I grew not rich.	さてはや、いっこう金（かね）はできない。
Alas, poor me!	なさけないやつ。
Have pity, Thou, who all man's wants dost see.	全能の神さま、お助けください。
"I sat one evening sunk in dreams of bliss,	ある晩、元気で浮かれていると、
A maid of seven years old gave me a kiss,	ちいさい女の子がキスしてくれた、
I at that time was rich in poesy	おとぎ歌なら、持ちあわせは山ほど、
And tales of old, though poor as poor could be;	そのくせ金にはいつでも貧乏――
But all she asked for was this poesy.	こどもは歌さえあればかまわぬ。
Then was I rich, but not in gold, poor me!	歌なら、山ほど、金には、いつもなさけないやつ。
As Thou dost know, who all men's hearts canst see.	全能の神さま、ごらんのとおり。
"Oh, were I rich!	「ああ、金持でありたいな。」
Oft asked I for this boon.	おいのりがこうきこえだす。
The child grew up to womanhood full soon.	こどもはみるみるむすめになった、
She is so pretty, clever, and so kind	りこうで、きれいで、心もやさしいむすめになった。
Oh, did she know what's hidden in my mind--	ああ、分らせたい、おれの心のうちにある――
A tale of old. Would she to me were kind!	それこそ大したおとぎ話を――むすめがやさしい心をみせりゃ。
But I'm condemned to silence! oh, poor me!	だが金はなし、口には出せぬ。なさけないやつ。
As Thou dost know, who all men's hearts canst see.	全能の神さま、おこころしだいに。
"Oh, were I rich in calm and peace of mind,	ああ、せめてかわりに、休息と慰安（なぐさめ）、それでもほしい。
My grief you then would not here written find!	そうすりゃなにも心の悩み、紙にかくにもあたらない。
O thou, to whom I do my heart devote,	おれの心をささげたおまえだ、わかってもくれよ。
Oh read this page of glad days now remote,	若いおもい出つづった歌だ、読んでもくれよ。
A dark, dark tale, which I tonight devote!	だめだ、やっぱりこのままくらい夜（よる）にささげてしまうがましか。
Dark is the future now. Alas, poor me!	未来はやみだ、いやはやなさけないやつめ。
Have pity Thou, who all men's pains dost see."	全能の神さま、おめぐみください。
Such verses as these people write when they are in love!	そうです、人は恋をしているときこんな詩をつくります。
But no man in his senses ever thinks of printing them.	でも用心ぶかい人は、そんなものを印刷したりしないものです。
Lieutenant, love, and lack of money--that is a symbolic triangle,	中尉と恋と貧乏、これが三角の形です。
or much the same as the half of the shattered die of Fortune.	それとも幸福のさいころのこわれた半かけとでもいいましようか。
This the lieutenant felt most poignantly,	それを中尉はつくづくおもっていました。
and this was the reason he leant his head against the window, and sighed so deeply.	そこで、窓わくにあたまをおしつけて、ふかいため息ばかりついていました。
"The poor watchman out there in the street is far happier than I.	「あすこの往来にねている貧しい夜番のほうが、おれよりはずっと幸福だ。
He knows not what I term privation.	あの男にはおれのおもっているような不足というものがない。
He has a home, a wife, and children, who weep with him over his sorrows, who rejoice with him when he is glad.	家もあり、かみさんもあり、こどももあって、あの男のかなしいことには泣いてくれ、うれしいことには喜んでくれる。
Oh, far happier were I, could I exchange with him my being--with his desires and with his hopes perform the weary pilgrimage of life!	ああ、おれはいっそあの男と代ることができたら、今よりずっと幸福になれるのだがな。
Oh, he is a hundred times happier than I!"	あの男はおれよりずっと幸福なのだからな。」
In the same moment the watchman was again watchman.	中尉がこうひとりごとをいうと、そのしゅんかん、夜番はまたもとの夜番になりました。
It was the shoes that caused the metamorphosis by means of which, unknown to himself, he took upon him the thoughts and feelings of the officer; but, as we have just seen, he felt himself in his new situation much less contented, and now preferred the very thing which but some minutes before he had rejected.	なぜなら幸福のうわおいぐつのおかげで、夜番のたましいは中尉のからだを借りたのですけれど、その中尉は、夜番よりもいっそう不平家で、おれはもとの夜番になりたいとのぞんだのでした。
So then the watchman was again watchman.	そこで、そのおのぞみどおり、夜番はまた夜番になってしまったのです。
"That was an unpleasant dream,"	「いやな夢だった。」
said he;	と、夜番はいいました。
"but 'twas droll enough altogether.	「が、ずいぶんばかばかしかった。
I fancied that I was the lieutenant over there: and yet the thing was not very much to my taste after all.	おれはむこう二階の中尉さんになったようにおもったが、まるで愉快でもなんでもなかった。
I missed my good old mother and the dear little ones; who almost tear me to pieces for sheer love."	息のつまるほどほおずりしようとまちかまえていてくれる、かみさんやこどものいることを忘れてなるものか。」
He seated himself once more and nodded:	夜番はまたすわって、こくりこくりやっていました。
the dream continued to haunt him,	夢がまだはっきりはなれずにいました。
for he still had the shoes on his feet.	うわおいぐつはまだ足にはまっていました。
A falling star shone in the dark firmament.	そのとき流れ星がひとつ、空をすべって落ちました。
"There falls another star,"	「ほう、星がとんだ。」
said he:	と、夜番はいいました。
"but what does it matter; there are always enough left.	「だが、いくらとんでも、あとにはたくさん星がのこっている。
I should not much mind examining the little glimmering things somewhat nearer,	どうかして、もう少し星のそばによってみたいものだ。
especially the moon;	とりわけ月の正体をみてみたいものだ。
for that would not slip so easily through a man's fingers.	あれだけはどんなことがあっても、ただの星とちがって、手の下からすべって消えていくということはないからな。
When we die--so at least says the student, for whom my wife does the washing--we shall fly about as light as a feather from one such a star to the other.	うちのかみさんがせんたく物をしてやっている学生の話では、おれたちは死ぬと、星から星へとぶのだそうだ。
That's, of course, not true: but 'twould be pretty enough if it were so.	それはうそだが、しかしずいぶんおもしろい話だとおもう。
If I could but once take a leap up there, my body might stay here on the steps for what I care."	どうかしておれも星の世界までちょいととんでいくくふうはないかしら、すると、からだぐらいはこの段段のうえにのこしていってもいい。」
Behold--there are certain things in the world to which one ought never to give utterance except with the greatest caution;	ところで、この世の中には、おたがい口にだしていうことをつつしまなければならないことがずいぶんあるものです。
but doubly careful must one be when we have the Shoes of Fortune on our feet.	取りわけ足に幸福のうわおいぐつなんかはいているときは、たれだって、よけい注意がかんじんです。
Now just listen to what happened to the watchman.	まあそのとき、夜番の身の上に、どんなことがおこったとおもいますか。
As to ourselves, we all know the speed produced by the employment of steam;	たれしも知っている限りでは、蒸気の物をはこぶ力の早いことはわかっています。
we have experienced it either on railroads, or in boats when crossing the sea;	それは鉄道でもためしてみたことだし、海の上を汽船でとおってみてもわかります。
but such a flight is like the travelling of a sloth in comparison with the velocity with which light moves.	ところが蒸気の速力などは、光がはこぶ早さにくらべれば、なまけものがのそのそ歩いているか、かたつむりがむずむずはっているようなものです。
It flies nineteen million times faster than the best race-horse;	それは第一流の競走者の千九百万倍もはやく走ります。
and yet electricity is quicker still.	電気となるともっと早いのです。
Death is an electric shock which our heart receives; the freed soul soars upwards on the wings of electricity.	死ぬというのは電気で心臓を撃たれることなので、その電気のつばさにのって、からだをはなれた魂はとんで行きます。
The sun's light wants eight minutes and some seconds to perform a journey of more than twenty million of our Danish* miles; (* A Danish mile is nearly 4 3/4 English.)	太陽の光は、二千万マイル以上の旅を、八分と二、三秒ですませてしまいます。
borne by electricity, the soul wants even some minutes less to accomplish the same flight.	ところで電気の早飛脚（はやびきゃく）によれば、たましいは、太陽と同じ道のりを、もっと少い時間でとんでいってしまいます。
To it the space between the heavenly bodies is not greater than the distance between the homes of our friends in town is for us, even if they live a short way from each other;	天体と天体とのあいだを往きかいするのは、同じ町のなかで知っている同士が、いやもっと近く、ついお隣同士が往きかいするのと大してちがったことではありません。
such an electric shock in the heart, however, costs us the use of the body here below;	でも、この下界では心臓を電気にうたれると、からだがはたらかなくなる危険があります。
unless, like the watchman of East Street, we happen to have on the Shoes of Fortune.	ただこの夜番のように、幸福のうわおいぐつをはいているときだけは、べつでした。
In a few seconds the watchman had done the fifty-two thousand of our miles up to the moon,	なん秒かで、夜番は五万二千マイルの道をいって、月の世界までとびました。
which, as everyone knows, was formed out of matter much lighter than our earth;	それは、地の上の世界とはちがった、ずっと軽い材料でできていました。
and is, so we should say, as soft as newly-fallen snow.	そしていわば降りだしたばかりの雪のようにふわふわしています。
He found himself on one of the many circumjacent mountain-ridges with which we are acquainted by means of Dr. Madler's "Map of the Moon."	夜番は例の＊メードレル博士の月世界大地図で、あなた方もおなじみの、かずしれず環（わ）なりに取りまわした山のひとつにくだりました。
Within, down it sunk perpendicularly into a caldron, about a Danish mile in depth;	山が輪になってめぐっている内がわに、切っ立てになったはち形のくぼみが、なんマイルもふかく掘れていました。
while below lay a town, whose appearance we can, in some measure, realize to ourselves by beating the white of an egg in a glass of water.	その堀の底に町があって、そのようすはちょっというと、卵の白味を、水を入れたコップに落したというおもむきですが、いかにも、さわってみると、まるで卵の白味のように、ぶよぶよやわらかで、
The matter of which it was built was just as soft, and formed similar towers, and domes, and pillars, transparent and rocking in the thin air;	人間の世界と同じような塔や、円（まる）屋根のお堂や、帆のかたちした露台（ろだい）が、薄い空気のなかに、すきとおって浮いていました。
while above his head our earth was rolling like a large fiery ball.	さて人間の住む地球は、大きな赤黒い火の玉のように、あたまの上の空にぶら下がっていました。
He perceived immediately a quantity of beings	たくさんの生きものにであいました［＃「ました」は底本では「ましだ」］。
who were certainly what we call "men"; yet they looked different to us.	それはたぶん月の世界の「人間」なのでしょうが、そのようすはわたしたちとはすっかりちがっていました。
A far more correct imagination than that of the pseudo-Herschel* had created them; and if they had been placed in rank and file, and copied by some skilful painter's hand, one would, without doubt, have exclaimed involuntarily, "What a beautiful arabesque!"	（＊＊偽（にせ）ヘルシェルが、作り出したものよりも、ずっとたしかな想像でこしらえられていて、一列にならばせて、画にかいたら、こりゃあうつくしいアラビヤ模様だというでしょう。）
They had a language too; but surely nobody can expect that the soul of the watchman should understand it.	この人たちもやはり言葉を話しましたが、夜番のたましいにそれがわかろうとは、たれだっておもわなかったでしょう。
Be that as it may, it did comprehend it; for in our souls there germinate far greater powers than we poor mortals, despite all our cleverness, have any notion of.	（ところがそれが、わかったのだからふしぎですが、人間のたましいには、おもいの外の働きがあるのです。
Does she not show us--she the queen in the land of enchantment--her astounding dramatic talent in all our dreams?	そのびっくりするような芝居めいた才能は、夢の中でもはたらくとおりでしょう。
There every acquaintance appears and speaks upon the stage, so entirely in character, and with the same tone of voice,	そこでは知合のたれかれがでて来て、いかにもその気性をあらわした、めいめい特有（とくゆう）の声で話します。
that none of us, when awake, were able to imitate it.	それは目がさめてのちまねようにもまねられないものです。
How well can she recall persons to our mind, of whom we have not thought for years;	どうしてたましいは、もうなん年もおもいだしもしずにいた人たちを、わたしたちの所へつれてくるのでしょう。
when suddenly they step forth "every inch a man," resembling the real personages, even to the finest features, and become the heroes or heroines of our world of dreams.	それは、わたしたちのたましいのなかへ、いきなりと、ごくこまかいくせまでももってあらわれてきます。
In reality, such remembrances are rather unpleasant:	まったく、わたしたちのたましいのもつ記憶はおそろしいようですね。
every sin, every evil thought, may, like a clock with alarm or chimes, be repeated at pleasure;	それはどんな罪でも、どんなわるいかんがえでも、そのままあらわしてみせます。
then the question is if we can trust ourselves to give an account of every unbecoming word in our heart and on our lips.	こうなると、わたしたちの心にうかんで、くちびるにのぼったかぎりの、どんなくだらない言葉でも、そののこらずの明細がきができそうなことです。）
The watchman's spirit understood the language of the inhabitants of the moon pretty well.	そこで夜番のたましいは、月の世界の人たちの言棄をずいぶんよくときました。
The Selenites* disputed variously about our earth, and expressed their doubts if it could be inhabited:	その人たちはこの地球の話をして、そこはいったい人間が住めるところかしらとうたぐっていました。
the air, they said, must certainly be too dense to allow any rational dweller in the moon the necessary free respiration.	なんでも地球は空気が重たすぎて、感じのこまかい月の人にはとても住めまいといいはりました。
They considered the moon alone to be inhabited:	その人たちは、月の世界だけに人間が住んでいるとおもっているのです。
they imagined it was the real heart of the universe or planetary system, on which the genuine Cosmopolites, or citizens of the world, dwelt. What strange things men--no, what strange things Selenites sometimes take into their heads!	なぜなら、古くからの世界人が住んでいる、ほんとうの世界といったら、月のほかにはないというのです。
About politics they had a good deal to say.	（この人たちはまた政治の話もしていました。）
but we will rather proceed, like good quiet citizens, to East Street, and observe what happened meanwhile to the body of the watchman.	それはそれとして、またもとの東通へくだっていって、そこに夜番のたましいがおき去りにして来たからだは、どうしたかみてみましょう。
He sat lifeless on the steps:	夜番は、階段の上で息がなくなってねていました。
the morning-star,* that is to say, the heavy wooden staff, headed with iron spikes, and which had nothing else in common with its sparkling brother in the sky, had glided from his hand; while his eyes were fixed with glassy stare on the moon,	明星（みょうじょう）をあたまにつけたやりは、手からころげ落ちて、その目はぼんやりと月の世界をながめていました。
looking for the good old fellow of a spirit which still haunted it.	夜番のからだは、そのほうへあこがれてでていった正直なたましいのゆくえをながめていたのです。
"What's the hour, watchman?"	「こら夜番、なん時か。」
asked a passer-by.	と、往来の男がたずねました。
But when the watchman gave no reply,	ところが返事のできない夜番でありました。
the merry roysterer, who was now returning home from a noisy drinking bout, took it into his head to try what a tweak of the nose would do, on which the supposed sleeper lost his balance, the body lay motionless, stretched out on the pavement: the man was dead.	そこでこの男は、ごく軽く夜番の鼻をつつきますと、夜番はからだの平均（へいきん）を失って、ながながと地びたにたおれて、死んでしまいました。
When the patrol came up, all his comrades, who comprehended nothing of the whole affair, were seized with a dreadful fright,	鼻をつついた男は、びっくりしたのしないのではありません。
for dead he was, and he remained so.	夜番が死んだまま生きかえらないのです。
The proper authorities were informed of the circumstance, people talked a good deal about it, and in the morning the body was carried to the hospital.	さっそく知らせる、相談がはじまる、明くる朝、死体は病院にはこばれました。
Now that would be a very pretty joke, if the spirit when it came back and looked for the body in East Street, were not to find one.	ところで、月の世界へあそびにでかけたたましいが、そこへひょっこり帰って来て、東通に残したからだを、ありったけの心あたりを探してみて、みつけなかったら、かなりおもしろいことになるでしょう。
No doubt it would, in its anxiety, run off to the police,	たぶんたましいはまず第一に警察へでかけるでしょう。
and then to the "Hue and Cry" office,	それから人事調査所へもいくでしょう。
to announce that "the finder will be handsomely rewarded,"	そしてなくなった品物のゆくえについて捜索（そうさく）がはじまるでしょう。
and at last away to the hospital;	それから、やっと、病院までたずねていくことになるかも知れませんが、でも安心してよろしい。
yet we may boldly assert that the soul is shrewdest when it shakes off every fetter, and every sort of leading-string	たましいはじぶんの身じんまくをするのは、この上なくきようです。
--the body only makes it stupid.	まのぬけているのはからだです。
The seemingly dead body of the watchman wandered, as we have said, to the hospital,	さて申し上げたとおり、夜番のからだは病院へはこばれました。
where it was brought into the general viewing-room:	そうして清潔室（せいけつしつ）に入れられました。
and the first thing that was done here was naturally to pull off the galoshes	死体をきよめるについて、もちろん第一にすることは、うわおいぐつをぬがせることでした。
--when the spirit, that was merely gone out on adventures, must have returned with the quickness of lightning to its earthly tenement.	そこで、いやでもたましいはかえってこないわけにはいきません。
It took its direction towards the body in a straight line;	で、さっそくたましいはからだへもどって来ました。
and a few seconds after, life began to show itself in the man.	すると、みるみる死骸に気息（いき）がでて来ました。
He asserted that the preceding night had been the worst that ever the malice of fate had allotted him;	夜番は、これこそ一生に一どの恐しい夜であったと白状しました。
he would not for two silver marks again go through what he had endured while moon-stricken;	もうグロシェン銀貨なん枚もらっても、二どとこんなおもいはしたくないといいました。
but now, however, it was over.	しかし今となれば、いっさい、すんだことでした。
The same day he was discharged from the hospital as perfectly cured;	その日、すぐと、夜番は、病院をでることをゆるされました。
but the Shoes meanwhile remained behind.	けれど、うわおいぐつは、それなり病院にのこっていました。
IV. A Moment of Head Importance--An Evening's "Dramatic Readings"--A Most Strange Journey	四　一大事　朗読会の番組　世にもめずらしい旅
Every inhabitant of Copenhagen knows, from personal inspection, how the entrance to Frederick's Hospital looks;	コペンハーゲンに生まれたものなら、たれでもその町のフレデリク病院の入口がどんなようすか知っているはずです。
but as it is possible that others, who are not Copenhagen people, may also read this little work, we will beforehand give a short description of it.	でもこの話を読む人のなかには、コペンハーゲン生まれでない人もあるでしょうから、まずそれについて、かんたんなお話をしておかなくてはなりますまい。
The extensive building is separated from the street by a pretty high railing, the thick iron bars of which are so far apart, that in all seriousness, it is said, some very thin fellow had of a night occasionally squeezed himself through to go	さて、その病院と往来とのあいだにはかなり高いさくがあって、ふとい鉄の棒が、まあ、ずいぶんやせこけた志願助手ででもあったらむりにもぬけられそうな、というくらいの間（ま）をおいて並んでいました。
and pay his little visits in the town.	それで、ここからぬけてちょっとしたそとの用事がたせるというわけでした。
The part of the body most difficult to manage on such occasions was, no doubt, the head;	ただからだのなかで、いちばんむずかしいのはあたまでした。
here, as is so often the case in the world, long-headed people get through best.	そこでよくあるとおり、ここでも小あたまがなによりのしあわせということになるのでした。
So much, then, for the introduction.	まずこのくらいで、前口上はたくさんでしょう。
One of the young men,	さて、若いひとりの志願助手がありました。
whose head, in a physical sense only, might be said to be of the thickest, had the watch that evening.	からだのことだけでいうと、大あたまの男でしたが、これが、ちょうどその晩、宿直（しゅくちょく）に当っていました。
The rain poured down in torrents;	雨もざんざん降っていました。
yet despite these two obstacles, the young man was obliged to go out,	しかし、このふたつのさわりにはかまわず、この人はぜひそとへでる用がありました。
if it were but for a quarter of an hour; and as to telling the door-keeper about it, that, he thought, was quite unnecessary, if, with a whole skin, he were able to slip through the railings.	それもほんの十五分ばかりのことだ、門番にたのんで門をあけてもらうまでもなかろう、ついさくをくぐってもでられそうだからとおもいました。
There, on the floor lay the galoshes, which the watchman had forgotten;	ふとみると夜番のおいていったうわおいぐつがそこにありました。
he never dreamed for a moment that they were those of Fortune;	これが幸福のうわおいぐつであろうとはしりませんでした。
and they promised to do him good service in the wet; so he put them on.	こういう雨降りの日には、くっきょうなものがあったとおもって、それをくつの上にはきました。
The question now was, if he could squeeze himself through the grating, for he had never tried before.	ところで、はたしてさくはくぐることができるものかどうか、今までは、ついそれをためしてみたことがないのです、
Well, there he stood.	そこでさくのまえにたちました、
"Would to Heaven I had got my head through!"	「どうかあたまがそとにでますように。」
said he, involuntarily;	と、助手はいいました。
and instantly through it slipped, easily and without pain, notwithstanding it was pretty large and thick.	するとたちまち、いったいずいぶんのさいづちあたまなのが、わけなくすっぽりでました。
But now the rest of the body was to be got through!	ところで、こんどはからだをださなければならないのに、そこでぐっとつまってしまいました。
"Ah!	「こりゃ
I am much too stout,"	肥りすぎているわい。
"I had thought the head was the most difficult part of the matter--oh! oh!	どうもあたまが一番始末がわるそうだとおもったのだが。
I really cannot squeeze myself through!"	でるのはだめか。」
He now wanted to pull his over-hasty head back again,	そこで、いそいであたまをひっこめようとしました。
but he could not.	けれども、うまくいきませんでした。
For his neck there was room enough, but for nothing more.	どうやら動くのは首だけで、しかしそれきりでした。
His first feeling was of anger;	はじめはぷりぷりしてみました。
his next that his temper fell to zero.	そのうちがっかりして、零下（れいか）何度のごきげんになってしまいました。
The Shoes of Fortune had placed him in the most dreadful situation;	幸福のうわおいぐつは、この人をこんななさけないめにあわせたのです。
and, unfortunately, it never occurred to him to wish himself free.	しかも、ふしあわせと、ああどうか自由になりたいとひとこということをおもいつかずにいました。
The pitch-black clouds poured down their contents in still heavier torrents;	雨はしぶきをたててながれました。
not a creature was to be seen in the streets.	往来には人ッ子ひとり通りません。
To reach up to the bell was what he did not like;	門のベルにはせいがとどきません。
How was he to twist himself through!	どうしてぬけだしましょう。
He saw clearly that it was his irrevocable destiny to remain a prisoner till dawn, or, perhaps, even late in the morning;	こうなると、まずあしたの朝まで、そこにそのままたっているということになりそうです。
then the smith must be fetched to file away the bars;	そこで、みんながみつけてかじ屋を呼びにやってくれて、鉄の格子（こうし）をやすりで切ってだすというところでしょう。
but all that would not be done so quickly as he could think about it.	だがそういうしごとは、ちょっくりはこぶものではありません。
The whole Charity School, just opposite, would be in motion; all the new booths, with their not very courtier-like swarm of seamen, would join them out of curiosity, and would greet him with a wild "hurrah!" while he was standing in his pillory: there would be a mob, a hissing, and rejoicing, and jeering, ten times worse than in the rows about the Jews some years ago	すぐまえの青建物の貧民学校から、総出でくる、すぐそばの海員地区からも、つながってくる、このお仕置台に首をはさまれている、さらし物の見物で、去年竜舌蘭（りゅうぜつらん）の大輪が咲いたときのさわぎとはまたちがった、大へんな人だかりになるでしょう。
--"Oh,	「うう、苦しい。
my blood is mounting to my brain;	血があたまに上るようだ。
'tis enough to drive one mad!	おれは気がちがう。
I shall go wild!	――そうだ、もう気がちがいかけている。
Oh! were I but loose; my dizziness would then cease; oh, were my head but loose!"	ああ、どうかして自由になりたい、それだけでもういいんだ。」
You see he ought to have said that sooner;	これはもう少し早くいえばよかったことでした。
for the moment he expressed the wish his head was free;	こうおもったとおり口にだしたとたん、あたまは自由になりました。
and cured of all his paroxysms of love, he hastened off to his room,	幸福のうわおいぐつのおそろしいきき目にびっくりして、助手はむちゅうでうちへかけ込みました。
But you must not think that the affair is over now;	しかし、これでいっさいすんだとおもってはいけません。
it grows much worse.	これからもっとたいへんなことになるのです。
The night passed, the next day also;	その晩はそれですぎて、次の日も無事に暮れました。
but nobody came to fetch the Shoes.	たれもうわおいぐつを取りにくるものはありませんでした。
In the evening "Dramatic Readings" were to be given at the little theatre in King Street.	その日の夕、カニケ街の小さな朗読会の催しがあるはずでした。
The house was filled to suffocation;	小屋はぎっしりつまっていました。
and among other pieces to be recited was a new poem	朗読会の番組のなかに、新作の詩がありました。
the contents of which were pretty nearly as follows:	それをわたしたちもききましょう。
"A certain person had an aunt, who boasted of particular skill in fortune-telling with cards, and who was constantly being stormed by persons that wanted to have a peep into futurity.	では、政治向。おまちなさいよ――新聞種（しんぶんだね）だ――
But she was full of mystery about her art, in which a certain pair of magic spectacles did her essential service.	のちほどゆっくり読んだらわかるさ。
Her nephew, a merry boy, who was his aunt's darling, begged so long for these spectacles, that, at last, she lent him the treasure, after having informed him, with many exhortations, that in order to execute the interesting trick, he need only repair to some place where a great many persons were assembled; and then, from a higher position, whence he could overlook the crowd, pass the company in review before him through his spectacles.	ここでしゃべると、業務の妨害、
Immediately 'the inner man' of each individual would be displayed before him, like a game of cards, in which he unerringly might read what the future of every person presented was to be.	晩のごはんのたのしみなくなる。
Well pleased the little magician hastened away to prove the powers of the spectacles in the theatre; no place seeming to him more fitted for such a trial.	そんならお芝居――初演の新作。おこのみ流行。
He begged permission of the worthy audience, and set his spectacles on his nose.	いけない、これは――支配人とけんかだ。
A motley phantasmagoria presents itself before him, which he describes in a few satirical touches, yet without expressing his opinion openly: he tells the people enough to set them all thinking and guessing; but in order to hurt nobody, he wraps his witty oracular judgments in a transparent veil, or rather in a lurid thundercloud, shooting forth bright sparks of wit, that they may fall in the powder-magazine of the expectant audience."	そこでじぶんの身の上のこと、
The humorous poem was admirably recited, and the speaker much applauded.	この詩の朗読はなかなかりっぱなできで、演者は面目をほどこしました。
Among the audience was the young man of the hospital, who seemed to have forgotten his adventure of the preceding night.	見物のなかには、れいの病院の志願助手が、ゆうべの大事件はけろりと忘れたような顔をしてまじっていました。
He had on the Shoes; for as yet no lawful owner had appeared to claim them;	たれも取りにくるものがないので、うわおいぐつは相変らずはいたままでした。
and besides it was so very dirty out-of-doors, they were just the thing for him, he thought.	それになにしろ往来は道がひどいのでこれはとんだちょうほうでした。
The beginning of the poem he praised with great generosity:	この詩を助手はおもしろいとおもいました。
Meanwhile he was haunted by the idea	なによりもそのおもいつきが心をひきました。
--he should like to possess such a pair of spectacles himself;	そういう目がねがあったらさぞいいだろう。
then, perhaps, by using them circumspectly, one would be able to look into people's hearts,	じょうずにつかうと、その目がねで、ひとの心のなかをみとおすことができるわけだ。
which, he thought, would be far more interesting than merely to see what was to happen next year;	これは来年のことを今みるよりも、もっとおもしろいことだとかんがえました。
for that we should all know in proper time, but the other never.	なぜなら、さきのことはさきになれば分かるが、ひとの心なんてめったに分かるものではないのです。
"I can now," said he to himself, "fancy the whole row of ladies and gentlemen sitting there in the front row; 	「そこで、おれはまずいちばんまえの紳士貴女諸君の列をながめることにする。
if one could but see into their hearts	――いきなり、あの人たちの胸のなかにとびこんだらどうだろう。
--yes, that would be a revelation--a sort of bazar.	まあ窓だな、店をひろげたようにいろいろな物がならんでいるだろう。
In that lady yonder, so strangely dressed, I should find for certain a large milliner's shop;	きっと、あすこの奥さんの所は大きな小間物屋にはいったようだろう。
in that one the shop is empty,	こちらのほうはきっと店がからっぽだろう。
but it wants cleaning plain enough.	だいぶそうじがとどかないな。
But there would also be some good stately shops among them.	だがたしかな品物をうる店だってありそうなものだ。
Alas!"	やれやれ。」
sighed he,	と、助手はため息をつきながら、またかんがえつづけました。
"I know one in which all is stately; but there sits already a spruce young shopman,	「なんでもたしかな品ばかり売るという店があるのだか、そこにはあいにくもう店番がいる。
which is the only thing that's amiss in the whole shop.	それがきずさ。
All would be splendidly decked out,	こちらの店もあちらの店も
and we should hear,	「だんな、どうぞおはいりください」
'Walk in, gentlemen, pray walk in; here you will find all you please to want.'	といいたそうだ。
Ah! I wish to Heaven I could walk in and take a trip right through the hearts of those present!"	そこでかわいらしい「かんがえ」の精のようなものになって、あの人たちの胸のなかをのぞきまわってみてやりたい。」
And behold! to the Shoes of Fortune this was the cue;	ほら、うわおいぐつにはもうこれだけで通じました。
the whole man shrunk together and a most uncommon journey through the hearts of the front row of spectators, now began.	たちまち助手はからだがちぢくれ上がって、一ばんまえがわの見物の心から心へ実にふしぎな旅行をはじめることになりました。
The first heart through which he came, was that of a middle-aged lady, but he instantly fancied himself in the room of the "Institution for the cure of the crooked and deformed,"	まっさきにはいっていったのは、ある奥さまの心で、整形外科（せいけいげか）の手術室にはいりこんだようにおもいました。
where casts of mis-shapen limbs are displayed in naked reality on the wall.	そのへやには、かたわな手足のギプス型が壁に立てかけてありました。
Yet there was this difference, in the institution the casts were taken at the entry of the patient; but here they were retained and guarded in the heart while the sound persons went away.	ただちがうのは整形病院では、ギプス型を患者（かんじゃ）がはいってくるたんびにとるのですが、この心のなかでは、人がでていったあとで型をとって、保存されることでした。
They were, namely, casts of female friends,	ここにあるのは女のお友だちの型で。
whose bodily or mental deformities were here most faithfully preserved.	そのからだと心の欠点がそのままここに保存されていました。
With the snake-like writhings of an idea he glided into another female heart;	すぐまた、ほかの女のなかにはいっていきました。
but this seemed to him like a large holy fane.* * temple	しかし、これは大きな神神（こうごう）しいお寺のようにおもわれました。
The white dove of innocence fluttered over the altar.	無垢（むく）の白はとが、高い聖壇の上をとんでいました。
How gladly would he have sunk upon his knees;	よっぽどひざをついて拝みたいとおもったくらいでした。
but he must away to the next heart;	しかし、すぐと次の心のなかにはいっていかなければなりませんでした。
yet he still heard the pealing tones of the organ,	でも、まだオルガンの音がきこえていました。
and he himself seemed to have become a newer and a better man;	そうしてじぶんがまえよりもいい、別の人間になったようにおもわれました。
he felt unworthy to tread the neighboring sanctuary	いばって次の聖堂にはいる資格が、できたように感じました。
which a poor garret, with a sick bed-rid mother, revealed.	それは貧しい屋根裏のへやのかたちであらわれて、なかには病人のおかあさんがねていました。
But God's warm sun streamed through the open window; lovely roses nodded from the wooden flower-boxes on the roof,	けれどあいた窓からは神さまのお日さまの光が温かくさしこみましたうつくしいばらの花が、屋根の上の小さな木箱のなかから、がてんがてんしていました。
and two sky-blue birds sang rejoicingly,	空色した二羽の小鳥が、こどもらしいよろこびのうたを歌っていました。
while the sick mother implored God's richest blessings on her pious daughter.	そのなかで、病人のおかあさんは、むすめのために、神さまのおめぐみを祈っていました。
He now crept on hands and feet through a butcher's shop;	それから、肉でいっぱいつまった肉屋の店を、四つんばいになってはいあるきました。
at least on every side, and above and below, there was nought but flesh.	ここは肉ばかりでした。
It was the heart of a most respectable rich man,	これはお金持のりっぱな紳士（しんし）の心でした。
whose name is certain to be found in the Directory.	おそらく、この人の名まえは紳士録にのっているでしょう。
He was now in the heart of the wife of this worthy gentleman.	こんどはその紳士の奥さまの心のなかにはいりました。
It was an old, dilapidated, mouldering dovecot.	その心は、古い荒れはてたはと小屋でした。
The husband's portrait was used as a weather-cock,	ごていしゅの像がほんの風見（かざみ）のにわとり代りにつかわれていました。
which was connected in some way or other with the doors, and so they opened and shut of their own accord, whenever the stern old husband turned round.	その風見は、小屋の戸にくっついていて、ごていしゅの風見がくるりくるりするとおりに、あいたりとじたりしました。
Hereupon he wandered into a boudoir formed entirely of mirrors, like the one in Castle Rosenburg;	それからつぎには、ローゼンボルのお城でみるような鏡の間（ま）にでました。
but here the glasses magnified to an astonishing degree.	でもこの鏡は、うそらしいほど大きくみせるようにできていました。
On the floor, in the middle of the room, sat, like a Dalai-Lama, the insignificant "Self" of the person, quite confounded at his own greatness.	床（ゆか）のまんなかには、達頼喇嘛（ダライラマ）のように、その持主のつまらない「わたし」が、じぶんでじぶんの家の大きいのにあきれながらすわっていました。
He then imagined he had got into a needle-case full of pointed needles of every size.	それからこんどは、針がいっぱいつんつんつッたっている、せまい針箱のなかにはこばれました。
"This is certainly the heart of an old maid," thought he.	これはきっと年をとっておよめにいけないむすめの心にちがいないとおもいました。
But he was mistaken.	けれど、じつはそうではありません。
It was the heart of a young military man;	たくさん勲章をぶら下げている若い士官の心でした。
a man, as people said, of talent and feeling.	しかし、世間ではこの人を才と情のかねそなわった人物だといっていました。
In the greatest perplexity, he now came out of the last heart in the row; he was unable to put his thoughts in order,	あわれな助手は、列のいちばんおしまいの人の心からぬけだしたとき、すっかりあたまがへんになっていて、まるでかんがえがまとまりませんでした。
and fancied that his too lively imagination had run away with him.	やたらとはげしいもうぞうが、じぶんといっしょにかけずりまわったのだとおもいました。
"Good Heavens!"	「やれやれ、おどろいた。」
sighed he.	と、助手はため息をつきました。
"I have surely a disposition to madness	「おれはどうも気ちがいになるうまれつきらしい。
--'tis dreadfully hot here;	それに、ここは、むやみと暑い。
my blood boils in my veins and my head is burning like a coal."	血があたまにのぼるわけさ。」
And he now remembered the important event of the evening before, how his head had got jammed in between the iron railings of the hospital.	そこで、ふとゆうべの、病院の鉄さくにあたまをはさまれた大事件をおもいだしました。
"That's what it is, no doubt,"	「きっとあのとき病気にかかったにちがいない。」
said he.	と、助手はおもいました。
"I must do something in time:	「すぐどうかしなければならない。
under such circumstances a Russian bath might do me good.	ロシア風呂（ぶろ）がきくかも知れない。
I only wish I were already on the upper bank."* *In these Russian (vapor) baths the person extends himself on a bank or form, and as he gets accustomed to the heat, moves to another higher up towards the ceiling, where, of course, the vapor is warmest. In this manner he ascends gradually to the highest.	ならば一等上のたなにねたいものだ。」
And so there he lay on the uppermost bank in the vapor-bath;	するともう、さっそくに蒸風呂（むしぶろ）のいちばん上のたなにねていました。
but with all his clothes on, in his boots and galoshes,	ところで、着物を着たなり、長ぐつも、うわおいぐつもそのままでねていました。
while the hot drops fell scalding from the ceiling on his face.	天井（てんじょう）からあついしずくが、ぽた、ぽた、顔に落ちて来ました。
"Holloa!"	「うわあ。」
cried he, leaping down.	と、とんきょう［＃「とんきょう」は底本では「とんきょと」］にさけんで、こんどは灌水浴（かんすいよく）をするつもりで下へおりました。
The bathing attendant, on his side, uttered a loud cry of astonishment when he beheld in the bath, a man completely dressed.	湯番は着物を着こんだ男がとびだしたのをみてびっくりして、大きなさけび声をたてました。
The other, however, retained sufficient presence of mind to whisper to him,	でも、そういうなか［＃「なか」は底本では「な声」］で、助手は、湯番の耳に、
"'Tis a bet, and I have won it!"	「なあにかけをしているのだよ。」
But the first thing he did as soon as he got home, was to have a large blister put on his chest	さて、へやにかえってさっそくにしたことは、首にひとつ、背中にひとつ、大きなスペイン発泡膏（はっぽうこう）をはることでした。
and back to draw out his madness.	これでからだのなかの気ちがいじみた毒気を吸いとろうというわけです。
The next morning he had a sore chest and a bleeding back;	明くる朝、助手は、赤ただれたせなかを［＃「せなかを」は底本では「せなをか」］していました。
and, excepting the fright, that was all that he had gained by the Shoes of Fortune.	これが幸福のうわおいぐつからさずけてもらった御利益（ごりやく）のいっさいでした。
V. Metamorphosis of the Copying-Clerk	五　書記の変化（へんげ）
The watchman, whom we have certainly not forgotten, thought meanwhile of the galoshes he had found and taken with him to the hospital;	さて、わたしたちがまだ忘れずにいたあの夜番は、そのうち、じぶんがみつけて、病院までもはいていったうわおいぐつのことをおもいだしました。
he now went to fetch them; and as neither the lieutenant, nor anybody else in the street, claimed them as his property, they were delivered over to the police-office.* *As on the continent, in all law and police practices nothing is verbal, but any circumstance, however trifling, is reduced to writing, the labor, as well as the number of papers that thus accumulate, is enormous. In a police-office, consequently, we find copying-clerks among many other scribes of various denominations, of which, it seems, our hero was one.	そこで、とってかえりましたが、むこう二階の中尉にも、町のたれかれにきいても、持主は、わかりませんでしたから、警察へとどけました。
"Why, I declare the Shoes look just like my own,"	「これはわたしのうわおいぐつにそっくりだ。」
said one of the clerks, eying the newly-found treasure, whose hidden powers, even he, sharp as he was, was not able to discover.	と、この拾得物（しゅうとくぶつ）をみた書記君のひとりがいって、じぶんのと並べてみました。
"One must have more than the eye of a shoemaker to know one pair from the other,"	「どうして、くつ屋でもこれをみわけるのはむずかしかろう。」
"Here, sir!"	「書記さん。」
said one of the men, who panting brought him a tremendous pile of papers.	と、そのとき小使が書類をもってはいって来ました。
The copying-clerk turned round and spoke awhile with the man about the reports and legal documents in question;	書記はふりむいてその男と話をしていました。
but when he had finished, and his eye fell again on the Shoes, he was unable to say whether those to the left or those to the right belonged to him.	話がすむと、またうわおいぐつのほうへむかいましたが、もうそのときは、右か左かじぶんのがわからなくなってしまいました。
"At all events it must be those which are wet,"	「しめっているほうがわたしのにちがいない。」
thought he;	と、書記君はおもいました。
but this time, in spite of his cleverness, he guessed quite wrong,	でも、これはかんがえちがいでした。
for it was just those of Fortune	なぜなら、そのほうが幸福のうわおいぐつだったのです。
And why, I should like to know, are the police never to be wrong?	だって警察のお役人だって、まちがわないとはかぎらないでしょう。
So he put them on quickly, stuck his papers in his pocket,	で、すましてそれをはいて、書類をかくしにつッこみました。
and took besides a few under his arm,	それからあとは小わきにかかえました。
intending to look them through at home to make the necessary notes.	これを内へかえって読んで、コピイ（副本）をつくらなければならないのです。
It was noon; and the weather, that had threatened rain, began to clear up,	ところで、その日は日曜の朝で、いいお天気でした。
"A little trip to Fredericksburg would do me no great harm," thought he; 	ひとつ、フレデリクスベルグへでもぶらぶらでてみるかな、とかんがえて、そちらに足をむけました。
Nobody could be more steady or quiet than this young man;	さて、この青年ぐらい、おとなしい、堅人（かたじん）はめったにありません。
we therefore wish him joy of the excursion with all our heart;	すこしばかりの散歩を、この人がするのは、さんせいですよ。
and it will certainly be beneficial for a person who leads so sedentary a life.	ながく腰をかけ通していたあとで、きっとからだにいいでしょう。
In the park he met a friend, one of our young poets,	公園の並木道（なみきみち）にはいると、書記はふとお友だちの、若い詩人にであいました。
who told him that the following day he should set out on his long-intended tour.	詩人は、あしたから旅にでかけるところだと話しました。
"So you are going away again!"	「じゃあ、もうでかけるのかい。」
said the clerk.	と、書記はうらやましそうにいいました。
"You are a very free and happy being;	「なんて幸福な自由な身の上だろう。
we others are chained by the leg and held fast to our desk."	われわれと来ては、足にくさりをつけられているのだからね。」
"Yes; but it is a chain, friend, which ensures you the blessed bread of existence,"	「だが、そのくさりはパンの木にゆいつけてあるのだろう。」
answered the poet.	と、詩人はいいました。
"You need feel no care for the coming morrow:	「そのかわりくらしの心配はいらないのだ。
when you are old, you receive a pension."	年をとれば、恩給がもらえるしな。」
"True,"	「やはりなんといっても、きみのほうがいいくらしをしているよ。」
said the clerk, shrugging his shoulders;	と、書記がいいました。
To sit at one's ease and poetise--that is a pleasure;	「うちにすわって詩を書いているというのは、楽しみにちがいない。
everybody has something agreeable to say to you,	それで世間からはもてはやされる。
and you are always your own master.	おれはおれだでやっていける。
No, friend, you should but try what it is to sit from one year's end to the other occupied with and judging the most trivial matters."	まあ、きみ、いちどためしにやってみたまえ。
The poet shook his head,	詩人はあたまをふりました。
the copying-clerk did the same.	書記も同様にあたまをふりました。
Each one kept to his own opinion, and so they separated.	てんでにじぶんじぶんの意見をいい張って、そのままふたりは別れました。
"It's a strange race, those poets!"	「どうも詩人というものはきみょうななかまだな。」
said the clerk,	と、書記はおもいました。
"I should like some day, just for a trial, to take such nature upon me,	「わたしもああいう人間の心持になってみたいものだ。
and be a poet myself;	じぶんで詩人になってみたいものだ。
I am very sure I should make no such miserable verses as the others.	わたしなら、むろん、あの連中のように泣言をならべはしないぞ
Today, methinks, is a most delicious day for a poet. Nature seems anew to celebrate her awakening into life.	……ああ、詩人にとってなんてすばらしい春だろう。
The air is so unusually clear, the clouds sail on so buoyantly,	あんなにも空気は澄み、雲はあくまでうつくしい。
and from the green herbage a fragrance is exhaled that fills me with delight.	わか葉の緑にかおりただよう。
For many a year have I not felt as at this moment."	そうだ、もうなん年にも、このしゅんかんのような気持をわたしは知らなかった。」
We see already, by the foregoing effusion, that he is become a poet;	これで、もうこの書記は、さっそく、詩人になっていたことがわかります。
to give further proof of it, however, would in most cases be insipid,	べつだん目につくほどのことはありません。
for it is a most foolish notion to fancy a poet different from other men.	いったい詩人とほかの人間とでは、うまれつきからまるでちがっているようにかんがえるのは、ばかげたことです。
Among the latter there may be far more poetical natures than many an acknowledged poet, when examined more closely, could boast of;	ただの人で詩人と名のっているたいていの人間よりも、もっと詩人らしい気質の人がいくらもあるのです。
the difference only is, that the poet possesses a better mental memory, on which account he is able to retain the feeling and the thought till they can be embodied by means of words; a faculty which the others do not possess.	ただまあ詩人となれば、おもったこと感じたことをよくおぼえていて、それをはっきりと、言葉に書きあらわすだけの天分がある、そこらがちがうところです。
But the transition from a commonplace nature to one that is richly endowed, demands always a more or less breakneck leap over a certain abyss which yawns threateningly below; and thus must the sudden change with the clerk strike the reader.	でも、世間なみの気質から詩人の天分にうつるというのは、やはり大きなかわり方にちがいないので、それをいま、この書記君がしているのです。
"The sweet air!"	「なんとすばらしい匂だ。」
continued he of the police-office, in his dreamy imaginings;	と、書記はいいました。
"how it reminds me of the violets in the garden of my aunt Magdalena!	「ローネおばさんのすみれの花をおもい出させる。
Yes, then I was a little wild boy,	そう、あれはわたしのこどものじぶんだった。
O heavens! 'tis a long time since I have thought on those times.	はてね、ながいあいだおもいだしもしずにいたのだがな。
The good old soul!	いいおばさんだったなあ。
She lived behind the Exchange.	おばさんは取引所のうしろに住んでいた。
She always had a few twigs or green shoots in water--let the winter rage without as it might.	いつも木の枝か青いわか枝をだいじそうに水にさして、どんな冬の寒いときでも、あたたかいへやのなかにおいた。
The violets exhaled their sweet breath, whilst I pressed against the windowpanes covered with fantastic frost-work the copper coin I had heated on the stove, and so made peep-holes.	ほっこりとすみれが花をひらいているわきで、わたしは凍った窓ガラスに火であつくした銅貨をおしつけて、すきみの穴をこしらえたものだ。
What splendid vistas were then opened to my view!	あれはおもしろい見物だった。
Yonder in the canal lay the ships frozen up,	そとの掘割には船が氷にとじられていた。
and deserted by their whole crews, with a screaming crow for the sole occupant.	乗組はみんなどこかへいっていて、からすが一羽のこってかあかあないていた。
But when the spring, with a gentle stirring motion, announced her arrival, a new and busy life arose;	やがて春風がそよそよ吹きそめると、なにかが生き生きして来た。
with songs and hurrahs the ice was sawn asunder,	にぎやかな歌とさけび声のなかに、氷がこわされる。
the ships were fresh tarred and rigged, that they might sail away to distant lands.	船にタールがぬられて、帆綱のしたくができると、やがて知らない国へこぎ出していってしまう。
But I have remained here	でも、わたしはいつまでもここにのこっている。
--must always remain here, sitting at my desk in the office, and patiently see other people fetch their passports to go abroad.	年がら年じゅう警察のいすに腰をかけて、ひとが外国行の旅券を受け取っていくのをながめている、これがわたしの持ってうまれた運なのだ。
Such is my fate! Alas!"	うん、うん、どうも。」
--sighed he,	こうおもって、書記はふかいため息をつきましたが。
and was again silent.	ふと、気がついて、
"Great Heaven!	「はて、おかしいぞ。
What is come to me!	わたしは、いったいどうしたというのだろう。
Never have I thought or felt like this before!	いつもこんなふうに、かんがえたり感じたりしたことはなかったのに。
It must be the summer air that affects me with feelings	きっと心のなかに春風が吹き込んだのかな。
almost as disquieting as they are refreshing."	なにかやるせないようで、そのくせいい気持だ。」
He felt in his pocket for the papers.	こうおもいながらなにげなくかくしのなかの紙に手をふれました。
"These police-reports will soon stem the torrent of my ideas, and effectually hinder any rebellious overflowing of the time-worn banks of official duties";	「いけない。
he said to himself consolingly, while his eye ran over the first page.	書記はそういいながらはじめの一枚にふと目をさらしますと、それはこう読まれました。
"DAME TIGBRITH, tragedy in five acts."	「『ジグブリット夫人、五幕新作悲劇』
"What is that?	おやおや、これはなんだ。
And yet it is undeniably my own handwriting.	しかもこれはわたしの手だぞ。
Have I written the tragedy?	わたしはいつこんな悲劇（ひげき）なんて書いたろう。
'INTRIGUE ON THE RAMPARTS; or THE DAY OF REPENTANCE: vaudeville with new songs to the most favorite airs.'	軽喜歌劇散歩道の陰謀　一名懺悔祈祷日。
The deuce!	はてね、
Where did I get all this rubbish?	どこでこんなものをもらったろう。
Some one must have slipped it slyly into my pocket for a joke.	たれかいたずらに、かくしに入れたかな。
There is too a letter to me; a crumpled letter and the seal broken."	おやおや、ここに手紙があるぞ。」
Yes; it was not a very polite epistle from the manager of a theatre, in which both pieces were flatly refused.	いかにもそれは劇場の支配人から来たものでした。
"Hem! hem!"	「ふん、ふん。」
said the clerk breathlessly, and quite exhausted he seated himself on a bank.	こう書記はつぶやきながら、腰掛に腰をおろしました。
His thoughts were so elastic, his heart so tender;	なにか心がおどって、生きかえったようで、気分がやさしくなりました。
and involuntarily he picked one of the nearest flowers.	ついすぐそばの花をひとつ手につみました。
It is a simple daisy, just bursting out of the bud.	それはつまらない、ちいさなひなぎくの花でした。
What the botanist tells us after a number of imperfect lectures, the flower proclaimed in a minute.	植物学者が、なんべんも、なんべんも、［＃「、」は底本では「。」］お講義を重ねて、やっと説明することを、この花はほんの一分間に話してくれました。
It related the mythus of its birth,	それはじぶんの生いたちの昔話もしました。
told of the power of the sun-light that spread out its delicate leaves, and forced them to impregnate the air with their incense	お日さまの光がやわらかな花びらをひらかせ、いい匂を立たせてくださる話もしました。
--and then he thought of the manifold struggles of life,	そのとき、書記は、「いのちのたたかい」ということを、ふとおもいました。
which in like manner awaken the budding flowers of feeling in our bosom.	これもやはりわたしたちの心を動かすものでした。
Light and air contend with chivalric emulation for the love of the fair flower	空気と光は花と仲よしでした。
that bestowed her chief favors on the latter; full of longing she turned towards the light,	それでも光がよけいすきなので、いつも光のほうへ、花は顔をむけました。
and as soon as it vanished, rolled her tender leaves together and slept in the embraces of the air.	ただ光が消えてしまったとき、花は花びらをまるめて、空気に抱かれながら眠りました。
"It is the light which adorns me,"	「わたしを飾ってくれるのは、光ですよ。」
said the flower.	と、花はいいました。
"But 'tis the air which enables thee to breathe,"	「でも、空気はおまえに息をさせてくれるだろう。」
said the poet's voice.	と、詩人の声がささやきました。
Close by stood a boy who dashed his stick into a wet ditch.	すると、すぐそばに、ひとりの男の子が、溝川（どぶかわ）の上を棒でたたいていました。
The drops of water splashed up to the green leafy roof,	にごった水のしずくが緑の枝の上にはねあがりました。
and the clerk thought of the million of ephemera which in a single drop were thrown up to a height,	すると、書記はそのしずくといっしょにたかく投げあげられたなん万という目にみえないちいさい生き物のことをおもいました。
that was as great doubtless for their size, as for us if we were to be hurled above the clouds.	それは、からだの大きさの割合からすると、ちょうどわたしたちが雲の上まで高く投げられたと同じようなものでしょうか。
While he thought of this and of the whole metamorphosis he had undergone, he smiled and said,	そんなことを書記はおもいながら、だんだんかわっていくじぶんをおかしく感じました。
"I sleep and dream;	「どうも眠って夢をみているのだな。
but it is wonderful	だが、ふしぎなことにはちがいない。
how one can dream so naturally, and know besides so exactly that it is but a dream.	そんなにまざまざ夢をみていて、しかも夢のなかで、それが夢だと知っているのだからな。
If only to-morrow on awaking, I could again call all to mind so vividly!	どうかして夢にみたことをのこらず、あくる日目がさめてもおぼえていられたらいいだろう。
I seem in unusually good spirits;	どうもいつもとちがって、気分がみょうにうかれている。
my perception of things is clear, I feel as light and cheerful as though I were in heaven;	なにをみてもはっきりわかるし、生き生きとものをかんじている。
but I know for a certainty, that if to-morrow a dim remembrance of it should swim before my mind, it will then seem nothing but stupid nonsense,	でも、あしたになっておもいだしたら、ずいぶんばかげているにちがいない。
as I have often experienced already	せんにもよくあったことだ。
All we hear or say in a dream that is fair and beautiful	夢のなかでいろいろと賢いことやりっぱなことをいったり、きいたりするものだ。
is like the gold of the subterranean spirits;	それは地の下の小人（こびと）の金（きん）のようなものだ。
it is rich and splendid when it is given us, but viewed by daylight we find only withered leaves.	それを受けとったときには、たくさんできれいな金にみえるが、あかるい所でみると、石ころか枯ッ葉になってしまう。
Alas!"	やれ、やれ。」
he sighed quite sorrowful, and gazed at the chirping birds that hopped contentedly from branch to branch,	書記は、さもつまらなそうにため息をついて、枝から枝へ、愉快そうにとびまわって、ちいちいさえずっている小鳥をながめました。
"they are much better off than I!	「小鳥はわたしよりずっとよくくらしている。
To fly must be a heavenly art;	とぶということは、なにしろたいしたわざだ。
and happy do I prize that creature in which it is innate.	つばさをそなえてうまれたものはしあわせだ。
Yes!	そうだな。
Could I exchange my nature with any other creature, I fain would be such a happy little lark!"	わたしがもしなにか人間でないものに変れるならかわいいひばりになりたいものだ。」
He had hardly uttered these hasty words when the skirts and sleeves of his coat folded themselves together into wings;	こういうが早いか、書記の服のせなかに、両そでがびったりくっついて、つばさになりました。
the clothes became feathers, and the galoshes claws.	着物は羽根になり、うわおいぐつはつめになりました。
He observed it perfectly, and laughed in his heart.	書記はじぶんのずんずん変っていくすがたをはっきりみながら、心のなかでわらいました。
"Now then, there is no doubt that I am dreaming;	「なるほど、これでいよいよ夢をみていることがわかる。
but I never before was aware of such mad freaks as these."	だが、わたしはまだこんなおもいきってばかげた夢をみたことはないぞ。」
And up he flew into the green roof and sang;	こういって、ひばりになった書記は、みどりの枝のなかをとびまわってうたいました。
but in the song there was no poetry,	もう、その歌に詩はありません。
for the spirit of the poet was gone.	詩人の気質はなくなってしまったのです。
The Shoes, as is the case with anybody who does what he has to do properly, could only attend to one thing at a time.	このうわおいぐつは、なんでもものごとをつきつめてするひとのように、［＃「、」は底本では「。」］一│時（じ）にひとつのことしかできません。
He wanted to be a poet, and he was one;	詩人になりたいというと、詩人になりました。
he now wished to be a merry chirping bird:	こんどは小鳥になりたいというと、小鳥になりました。
but when he was metamorphosed into one, the former peculiarities ceased immediately.	とたんに詩人の心は消えました。
"It is really pleasant enough,"	「こいつは実におもしろいぞ。」
said he:	と、書記はとびながら、なおかんがえつづけました。
"the whole day long I sit in the office amid the driest law-papers,	「わたしは昼間、役所につとめて、石のように堅い椅子に腰をかけて、おもしろくないといって、およそこの上ない法律書類のなかに首をつッこんでいる。
and at night I fly in my dream as a lark in the gardens of Fredericksburg;	夜になると夢をみて、ひばりになって、フレデリクスベルグ公園の木のなかをとびまわる。
one might really write a very pretty comedy upon it."	こりゃあ、りっぱに大衆喜劇の種（たね）になる。」
He now fluttered down into the grass, turned his head gracefully on every side, and with his bill pecked the pliant blades of grass,	そこで、書記のひばりは草のなか［＃「なか」は底本では「なが」］に舞いおりて、ほうぼうに首をむけて、草の茎をくちばしでつつきました。
which, in comparison to his present size, seemed as majestic as the palm-branches of northern Africa.	それはいまのじぶんの大きさにくらべては、北アフリカのしゅろの枝ほどもありそうでした。
Presently black night overshadowed our enthusiast,	すると、だしぬけにまわりがまっ暗やみになってしまいました。
some vast object seemed to be thrown over him.	なにか大きなものが、上からかぶさって来たようにおもわれました。
It was a large oil-skin cap, which a sailor-boy of the quay had thrown over the struggling bird;	これはニュウボデルから来た船員のこどもが、大きな帽子を小鳥の上に投げかけたものでした。
a coarse hand sought its way carefully in under the broad rim, and seized the clerk over the back and wings.	やがて下からぬっと手がはいって来て、書記のひばりのせなかとつばさをひどくしめつけたので、おもわずぴいぴい鳴きました。
In the first moment of fear, he called, indeed, as loud as he could	そして、びっくりした大きな声で
--"You impudent little blackguard!	「このわんぱく小僧め、
I am a copying-clerk at the police-office;	おれは警察のお役人だぞ。」
This fine tirade sounded, however, to the ungodly sailor-boy like a mere "Pippi-pi."	けれどもこどもには、ただぴいぴいときこえるだけでした。
He gave the noisy bird a knock on his beak, and walked on.	そこでこの男の子は鳥のくちばしをたたいて、つかんだままほうぼうあるきまわりました。
He was soon met by two schoolboys of the upper class	やがて、並木道（なみきみち）で、男の子はほかのふたりのこどもに出あいました。
--that is to say as individuals, for with regard to learning they were in the lowest class in the school;	身分をいう人間の社会では、いい所のこどもというのですが、学校では精紳がものをいうので、ごく下の級に入れられていました。
and they bought the stupid bird.	このこどもたちが、シリング銀貨二、三枚で小鳥を買いました。
So the copying-clerk came to Copenhagen as guest, or rather as prisoner in a family living in Gother Street.	そこで、ひばりの書記は、またコペンハーゲンのゴーテルス通のある家へつれてこられることになりました。
"'Tis well that I'm dreaming,"	「夢だからいいようなものだが。」
said the clerk,	と、書記はいいました。
"or I really should get angry.	「さもなければ、おれはほんとうにおこってしまう。
First I was a poet; now sold for a few pence as a lark;	はじめに詩人で、こんどはひばりか。
no doubt it was that accursed poetical nature which has metamorphosed me into such a poor harmless little creature.	しかもわたしを小鳥にかえたのは、詩人の気質がそうしたのだよ。
It is really pitiable, particularly when one gets into the hands of a little blackguard,	それがこどもらの手につかまれるようになっては、いかにもなさけない。
all I should like to know is, how the story will end."	このおしまいは、いったいどうなるつもりか、見当がつかない。」
The two schoolboys, the proprietors now of the transformed clerk, carried him into an elegant room.	やがて、こどもたちはひばりをたいそうりっぱなおへやにつれこみました。
A stout stately dame received them with a smile;	ふとったにこにこした奥さまが、こどもたちをむかえました。
but she expressed much dissatisfaction that a common field-bird, as she called the lark, should appear in such high society.	けれども、このおかあさまは、ひばりのことを「下等な野そだちの鳥」とよんで、そんなものをうちのなかへ入れることをなかなかしょうちしてくれません。
For to-day, however, she would allow it;	やっとたのんで、ではきょう一日だけということで許してもらえました。
and they must shut him in the empty cage that was standing in the window.	で、ひばりは窓のわきにある、からッぽなかごのなかに入れられなければなりませんでした。
"Perhaps he will amuse my good Polly,"	「おうむちゃん、きっと、うれしがるでしょうよ。」
added the lady, looking with a benignant smile at a large green parrot that swung himself backwards and forwards most comfortably in his ring, inside a magnificent brass-wired cage.	と、奥さまはいって、上のきれいなしんちゅうのかごのなかの輪で、お上品ぶってゆらゆらしている大きなおうむにわらいかけました。
"To-day is Polly's birthday,"	「きょうはおうむちゃんのお誕生日だったねえ。」
said she with stupid simplicity:	と、奥さまはあまやかすようにいいました。
"and the little brown field-bird must wish him joy."	「だから、このちっぽけな野そだちの鳥もお祝をいいに来たのだろうよ。」
Mr. Polly uttered not a syllable in reply,	おうむちゃんはこれにひとことも返事をしませんでした。
but swung to and fro with dignified condescension;	ただお上品ぶってゆらゆらしていました。
while a pretty canary, as yellow as gold, that had lately been brought from his sunny fragrant home, began to sing aloud.	すると、去年の夏、あたたかい南の国のかんばしい林のなかから、ここへつれてこられた、かわいらしいカナリヤが、たかい声で歌をうたいはじめました。
"Noisy creature! Will you be quiet!"	「やかましいよ。」
screamed the lady of the house,	と、奥さまはいいました。
covering the cage with an embroidered white pocket handkerchief.	そうして白いハンケチを鳥かごにかけてしまいました。
"Chirp, chirp!"	「ぴい、ぴい。」
sighed he.	と、カナリヤはため息をつきました。
"That was a dreadful snowstorm";	「おそろしい雪おろしになって来たぞ。」
and he sighed again, and was silent.	こういってため息をつきながら、だまってしまいました。
The copying-clerk, or, as the lady said, the brown field-bird, was put into a small cage, close to the Canary,	書記は、いや、奥さまのおっしゃる下等な野そだちの鳥は、カナリヤのすぐそばのちいさなかごに入れられました。
and not far from "my good Polly."	おうむからもそう遠くはなれてはいませんでした。
The only human sounds that the Parrot could bawl out were,	このおうむちゃんのしゃべれる人間のせりふはたったひとつきり、それは、
"Come, let us be men!"	「まあ、人になることですよ。」
Everything else that he said was as unintelligible to everybody as the chirping of the Canary,	そのほかに、ぎゃあぎゃあいうことは、カナリヤの歌と同様、人間がきいてもまるでわけがわかりませんでした。
except to the clerk, who was now a bird too: he understood his companion perfectly.	ただ書記だけは、やはり小鳥のなかまにはいったので、いうことはよくわかりました。
"I flew about beneath the green palms and the blossoming almond-trees,"	「わたしはみどりのしゅろの木や、白い花の咲くあんずの木の下をとんでいたのだ。」
sang the Canary;	と、カナリヤがうたいました。
"I flew around, with my brothers and sisters, over the beautiful flowers, and over the glassy lakes,	「わたしは男のきょうだいや女のきょうだいたちと、きれいな花の咲いた上や、鏡のようにあかるいみどりの上をとんでいたのだ。
where the bright water-plants nodded to me from below.	みずうみの底には、やはり草や木が、ゆらゆらゆられていた。
There, too, I saw many splendidly-dressed paroquets, that told the drollest stories, and the wildest fairy tales without end."	それからずいぶん、ながいお話をたくさんしてくれるきれいなおうむさんにもあった。」
"Oh! those were uncouth birds,"	「ありゃ野そだちの鳥よ。」
answered the Parrot.	と、おうむがこたえました。
"They had no education,	「あれらはなにも教育がないのだ。
"If my mistress and all her friends can laugh at what I say, so may you too, I should think.	奥さんやお客さんたちがわらったら、おまえもわらう。
It is a great fault to have no taste for what is witty or amusing	娯楽に趣味をもたないのは欠点です。
--come, let us be men."	まあ人になることですよ。」
"Ah, you have no remembrance of love for the charming maidens that danced beneath the outspread tents beside the bright fragrant flowers?	「おまえさん、おぼえているでしょう。
Do you no longer remember the sweet fruits, and the cooling juice in the wild plants of our never-to-be-forgotten home?"	花の咲いた木の下に、天幕を張って、ダンスをしたかわいらしいむすめたちのことを、野に生えた草のなかに、あまい実がなって、つめたい汁の流れていたことを。」
"Oh, yes,"	「うん、そりゃ、おぼえている。」
said the Parrot;	と、おうむがこたえました。
"but I am far better off here.	「だが、ここのお内で、ぼくはもっといいくらしをしているのだ。
I am well fed, and get friendly treatment.	ごちそうはあるし、だいじに扱われている。
I know I am a clever fellow; and that is all I care about.	この上ののぞみはないのさ。
Come, let us be men.	まあ、人になることですよ。
You are of a poetical nature, as it is called	きみは詩人のたましいとかいうやつをもっている。
--I, on the contrary, possess profound knowledge and inexhaustible wit.	ぼくはなんでも深い知識ととんちをもっている。
You have genius; but clear-sighted, calm discretion does not take such lofty flights,	きみは天才はあるが、思慮（しりょ）がないよ。
and utter such high natural tones.	持ってうまれた高調子で、とんきょうにやりだす、
For this they have covered you over	すぐ上からふろしきをかぶされてしまうのさ。
--they never do the like to me;	そこはぼくになるとちがう。
for I cost more.	どうしてそんな安ッぽいのじゃない。
Besides, they are afraid of my beak;	この大きなくちばしだけでも、威厳（いげん）があるからな。
and I have always a witty answer at hand.	しかもこのくちばしで、とんちをふりまいて人をうれしがらせる。
Come, let us be men!"	まあ、人になることですよ。」
"O warm spicy land of my birth,"	「ああ、わがなつかしき、花さく熱帯の故国よ。」
sang the Canary bird;	とカナリヤがうたいました。
"I will sing of thy dark-green bowers, of the calm bays where the pendent boughs kiss the surface of the water;	「わたしはあのみどりしたたる木立と、鏡のような水に枝が影をうつしている静かな入江をほめたたえよう。
I will sing of the rejoicing of all my brothers and sisters where the cactus grows in wanton luxuriance."	『沙漠（さばく）の泉の木』が茂って、そこにうつくしくかがやくきょうだいの鳥たちのよろこびをほめたたえよう。」
"Spare us your elegiac tones,"	「さあ、たのむから、もうそんななさけない声を出すのはよしておくれ。」
said the Parrot giggling.	と、おうむがいいました。
"Rather speak of something at which one may laugh heartily.	「なにかわらえるようなことをうたっておくれ。
Laughing is an infallible sign of the highest degree of mental development.	わらいはいとも高尚な心のしるしだ。
Can a dog, or a horse laugh?	犬や馬がわらえるかね。
No,	どうだ。
but they can cry.	どうして、あれらはなくだけです。
The gift of laughing was given to man alone.	わらいは人にだけ与えられたものだ。
Ha! ha! ha!"	ほッほッほ。」
screamed Polly,	こうおうむはわらってみせて、
and added his stereotype witticism.	「まあ、人になることですよ。」
"Come, let us be men!"	とむすびました。
"Poor little Danish grey-bird,"	「もし、もし、そこに灰色しているデンマルクの小鳥さん。」
said the Canary;	と、カナリヤがひばりに声をかけました。
"you have been caught too.	「きみもやはり囚人（しゅうじん）になったんだな。
It is, no doubt, cold enough in your woods,	なるほど、きみの国の森は寒いだろう。
but there at least is the breath of liberty;	だが、そこにはまだ自由がある。
therefore fly away.	とびだせ。
In the hurry they have forgotten to shut your cage,	きみのかごの戸はしめるのを忘れている。
and the upper window is open.	上の窓はあいているぞ。
Fly, my friend; fly away. Farewell!"	逃げろ、逃げろ。」
Instinctively the Clerk obeyed; with a few strokes of his wings he was out of the cage;	カナリヤがこういうと、書記はついそれにのって、すうとかどをとびだしました。
but at the same moment the door, which was only ajar, and which led to the next room, began to creak, and supple and creeping came the large tomcat into the room,	そのとたん、となりのへやの、半分あいた戸がぎいと鳴ると、みどり色した火のような目の飼いねこがしのんで来ました。
and began to pursue him.	そうして、いきなりひばりを追っかけようとしました、
The frightened Canary fluttered about in his cage;	カナリヤはかごのなかをとびまわりました。
the Parrot flapped his wings,	おうむもつばさをばさばさやって
and cried,	「まあ、人になることですよ。」
"Come, let us be men!"	とさけびました。
The Clerk felt a mortal fright, and flew through the window, far away over the houses and streets.	書記は、もう死ぬほどおどろいて、窓から屋根へ往来へとにげました。
At last he was forced to rest a little.	とうとうくたびれて、すこし休まなければならなくなりました。
The neighboring house had a something familiar about it;	すると、むこうがわの家が、住み心地のよさそうなようすをしていました。
a window stood open; he flew in; it was his own room.	窓がひとつあけてあったので、［＃「、」は底本では「。」］そこからつういととび込むと、そこはじぶんのへやの書斎でした。
He perched upon the table.	ひばりはそこのつくえの上にとびおりました。
"Come, let us be men!"	「まあ、人になることですよ。」
said he, involuntarily imitating the chatter of the Parrot,	と、ひばりはついおうむの口まねをしていいました。
and at the same moment he was again a copying-clerk;	そのとたんに、書記にもどりました。
but he was sitting in the middle of the table.	ただつくえの上にのっかっていました。
"Heaven help me!"	「やれ、やれおどろいた。」
cried he.	と、書記はいいました。
"How did I get up here	「どうしてこんな所にのっかっているのだろう。
--and so buried in sleep, too?	しかもひどく寝込んでしまって、
After all, that was a very unpleasant, disagreeable dream that haunted me!	なにしろおちつかない夢だった。
The whole story is nothing but silly, stupid nonsense!"	しまいまで、くだらないことばかりで、じょうだんにもほどがある。」
VI. The Best That the Galoshes Gave	六　うわおいぐつのさずけてくれたいちばんいい事
The following day, early in the morning, while the Clerk was still in bed, someone knocked at his door.	明くる日、朝早く、書記君まだ寝床にはいっていますと、戸をこつこつやる音がきこえました。
It was his neighbor, a young Divine, who lived on the same floor.	それはおなじ階でおとなり同士の若い神学生で、
He walked in.	はいって来てこういいました。
"Lend me your Galoshes,"	「きみのうわおいぐつを貸してくれたまえ。」
said he;	と、学生はいいました。
"it is so wet in the garden, though the sun is shining most invitingly.	「庭はひどくしめっているけれど、日はかんかん照っている。
I should like to go out a little."	おりていって、一服やりたいとおもうのだよ。」
He got the Galoshes, and he was soon below in a little duodecimo garden,	学生にうわおいぐつをはいて、まもなく庭へおりました。
where between two immense walls a plumtree and an apple-tree were standing.	庭にはすももの木となしの木がありました。
Even such a little garden as this was considered in the metropolis of Copenhagen as a great luxury.	これだけのちょっとした庭でも、都のなかではどうして大したねうちです。
The young man wandered up and down the narrow paths, as well as the prescribed limits would allow;	学生は庭の小みちをあちこちあるきまわりました。
the clock struck six; without was heard the horn of a post-boy.	まだやっと六時で、往来には郵便馬車のラッパがきこえました。
"To travel!	「ああ、旅行。
to travel!"	旅行。」
exclaimed he,	と、学生はさけびました。
"That is the happiest thing in the world!	「これこそ、この世のいちばん大きな幸福だ。
That is the highest aim of all my wishes!	これこそぼくの希望のいちばんたかい目標だ。
Then at last would the agonizing restlessness be allayed, which destroys my existence!	旅に出てこそぼくのこの不安な気持が落ちつく、
But it must be far, far away!	だが、ずっととおくではなければなるまい。
I would behold magnificent Switzerland;	うつくしいスウィスがみたい。
I would travel to Italy, and--"	イタリアへいきたい――」
It was a good thing that the power of the Galoshes worked as instantaneously as lightning in a powder-magazine would do,	いや、うわおいぐつがさっそくしるしをみせてくれたことは有りがたいことでした。
otherwise the poor man with his overstrained wishes would have travelled about the world too much for himself as well as for us.	さもないと、じぶんにしても、他人のわたしたちにしても、始末のわるい遠方までとんでいってしまうところでした。
In short, he was travelling.	さて、学生は旅行の途中です。
He was in the middle of Switzerland, but packed up with eight other passengers in the inside of an eternally-creaking diligence;	スウィスのまんなかで、急行馬車に、ほかの八人の相客といっしょにつめこまれていました。
his head ached till it almost split, his weary neck could hardly bear the heavy load, and his feet, pinched by his torturing boots, were terribly swollen.	頭痛がして、首がだるくて、足は血が下がってふくれた上をきゅうくつな長ぐつでしめつけられていました。
He was in an intermediate state between sleeping and waking;	眠っているとも、さめているともつかず、うとうとゆられていました。
In his right pocket he had his letter of credit, in the left, his passport,	右のかくしには信用手形を入れ、左のかくしには、旅券を入れていました。
and in a small leathern purse some double louis d'or, carefully sewn up in the bosom of his waistcoat.	ルイドール金貨が胸の小さな革紙入にぬい入れてありました。
Every dream proclaimed that one or the other of these valuables was lost;	うとうとするとこのだいじな品物のうちどれかをなくした夢をみました。
wherefore he started up as in a fever;	それで、熱のたかいときのように、ひょいととびあがりました。
and the first movement which his hand made, described a magic triangle from the right pocket to the left, and then up towards the bosom, to feel if he had them all safe or not.	そうしてすぐと手を動かして、右から左へ三角をこしらえて、それから胸にさわってまだなくさずに持っているかどうかみました。
From the roof inside the carriage, umbrellas, walking-sticks, hats, and sundry other articles were depending, and hindered the view, which was particularly imposing.	こうもりがさと帽子とステッキは、あたまの上の網のなかでゆれてぶら下がっていて、せっかくのすばらしいそとの景色をみるじゃまをしていました。
He now endeavored as well as he was able to dispel his gloom, which was caused by outward chance circumstances merely, and on the bosom of nature imbibe the milk of purest human enjoyment.	でも、その下からのぞいてみるだけでして、そのかわり学生は心のなかで、詩人とまあいってもいいでしょう、わたしたち知っているさる人が、スウィスで作って、そのまままだ印刷されずにいる詩をうたっていました。
Grand, solemn, and dark was the whole landscape around.	みるかぎりの自然に、大きく、おごそかで、うすぐらくもみえました。
The gigantic pine-forests, on the pointed crags, seemed almost like little tufts of heather, colored by the surrounding clouds.	もみの木の林が、高い山の上で、草やぶかなんぞのようにみえました。
It began to snow, a cold wind blew and roared as though it were seeking a bride.	やがて雪が降りはじめて、風がつめたく吹いて来ました。
"Augh!"	「おお、寒い。」
sighed he,	と、学生はため息をつきました。
"were we only on the other side the Alps,	「これがアルプスのむこうがわであったらいいな。
then we should have summer, and I could get my letters of credit cashed.	あちらはいつも夏景色で、その上、この信用手形でお金が取れるのだろうが。
The anxiety I feel about them prevents me enjoying Switzerland.	金の心配で、せっかくのスウィスも十分に楽しめない。
Were I but on the other side!"	どうかはやくむこうへいきたいなあ。」
And so saying he was on the other side in Italy, between Florence and Rome.	こういうと、もう学生は山のむこうがわのイタリアのまんなかの、フィレンツェとローマのあいだに来ていました。
Lake Thracymene, illumined by the evening sun, lay like flaming gold between the dark-blue mountain-ridges;	トラジメーネのみずうみは、夕ばえのなかで、暗いあい色の山にかこまれながら、金色のほのおのようにかがやいていました。
here, where Hannibal defeated Flaminius, the rivers now held each other in their green embraces;	ここは昔、ハンニバルがフラミウスをやぶったところで、そこにぶどうのつるが、みどりの指をやさしくからみあっていました。
lovely, half-naked children tended a herd of black swine, beneath a group of fragrant laurel-trees, hard by the road-side.	かわいらしい半裸体のこどもらが、道ばたの香り高い月桂樹（げっけいじゅ）の林のなかで、まっ黒なぶたの群を飼っていました。
Could we render this inimitable picture properly, then would everybody exclaim,	もしこの景色をそのまま画にかいてみせることができたら、たれだって
"Beautiful, unparalleled Italy!"	「ああ、すばらしいイタリア。」
But neither the young Divine said so, nor anyone of his grumbling companions in the coach of the vetturino.	けれどもさしあたり神学生も、おなじウェッツラ（四輪馬車）にのりあわせた旅の道づれも、それをくちびるにのせたものはありませんでした。
The poisonous flies and gnats swarmed around by thousands;	毒のあるはえやあぶが、なん千となく、むれて馬車のなかへとびこんで来ました。
in vain one waved myrtle-branches about like mad; the audacious insect population did not cease to sting;	みんな気ちがいのように、ミルテの枝をふりまわしましたが、はえはへいきで刺しました。
nor was there a single person in the well-crammed carriage whose face was not swollen and sore from their ravenous bites.	馬車の客は、ひとりだってさされて顔のはれあがらないものはありませんでした。
The poor horses, tortured almost to death, suffered most from this truly Egyptian plague; the flies alighted upon them in large disgusting swarms;	かわいそうな馬は腐れ肉でもあるかのようにはえのたかるままになっていました。
and if the coachman got down and scraped them off, hardly a minute elapsed before they were there again.	たまにぎょ者がおりて、いっぱいたかっている虫をはらいのけると、そのときだけいくらかほっとしました。
The sun now set:	いま、日は沈みかけました。
a freezing cold, though of short duration pervaded the whole creation; it was like a horrid gust coming from a burial-vault on a warm summer's day	みじかい、あいだですが、氷のような冷やかさが万物にしみとおって、それはどうにもこころよいものではありません。
--but all around the mountains retained that wonderful green tone which we see in some old pictures, and which, should we not have seen a similar play of color in the South,	でも、まわりの山や雲が、むかしの画にあるような、それはうつくしいみどり色の調子をたたえて、いかにもあかるくすみとおって――まあなんでも、じぶんでいってみることで、書いたものをよむだけではわかりません。
we declare at once to be unnatural.	まったくたとえようのないけしきです。
It was a glorious prospect;	この旅行者たちたれもやはりそうおもいました。
but the stomach was empty, the body tired;	でも――胃（い）の腑（ふ）はからになっていましたし、からだも疲れきっていました。
all that the heart cared and longed for was good night-quarters;	ただもう今夜のとまり、それだけがたれしもの心のねがいでした。
yet how would they be?	さてどうそれがなるのか。
For these one looked much more anxiously than for the charms of nature, which every where were so profusely displayed.	うつくしい自然よりも、そのほうへたれの心もむかっていました。
The road led through an olive-grove,	道は、かんらんの林のなかを通っていきました。
and here the solitary inn was situated.	やがてそこにさびしい宿屋をみつけました。
Ten or twelve crippled-beggars had encamped outside.	足なえのこじきがひとかたまり、そこの入口に陣取っていました。
The healthiest of them resembled, to use an expression of Marryat's, "Hunger's eldest son when he had come of age"; 	なかでいちばんす早いやつでも、ききんの惣領（そうりょう）息子が丁年になったような顔をしています。
the others were either blind, had withered legs and crept about on their hands, or withered arms and fingerless hands.	そのほかは、めくらかいざりかどちらかでしたから、両手ではいまわるか、指の腐れおちた手をあわせていました。
It was the most wretched misery, dragged from among the filthiest rags.	これはまったくみじめがぼろにくるまって出て来た有様でした。
"Excellenza, miserabili!"	＊「エチェレンツア・ミゼラビリ」(＊旦那さま、かわいそうなものでございます。)
sighed they, thrusting forth their deformed limbs to view.	と、こじきはため息まじりにかたわな手をさしだしました。
Even the hostess, with bare feet, uncombed hair, and dressed in a garment of doubtful color, received the guests grumblingly.	なにしろこの宿屋のおかみさんからして、はだしでくしを入れないぼやぼやのあたまに、よごれくさったブルーズ一枚でお客を迎えました。
The doors were fastened with a loop of string;	戸はひもでくくりつけてありました。
the floor of the rooms presented a stone paving half torn up;	へやのゆかは煉瓦（れんが）が半分くずれた上を掘りかえしたようなていさいでした。
bats fluttered wildly about the ceiling; and as to the smell therein--no--that was beyond description.	こうもりが天井（てんじょう）の下をとびまわって、へやのなかから、むっとくさいにおいがしました――。
"You had better lay the cloth below in the stable,"	「そうだ、いっそ食卓はうまやのなかにもちだすがいい。」
said one of the travellers;	と、旅人のひとりがいいました。
"there, at all events, one knows what one is breathing."	「まだしもあそこなら息ができそうだ。」
The windows were quickly opened,	窓はあけはなされました。
to let in a little fresh air.	そうすればすこしはすずしい風がはいってくるかとおもったのです。
Quicker, however, than the breeze, the withered, sallow arms of the beggars were thrust in, accompanied by the eternal whine of "Miserabili, miserabili, excellenza!"	ところが風よりももっとす早く、かったいぼうの手がでて来て、相変らず「ミゼラビリ・エチェレンツア」と鼻をならしつづけました。
On the walls were displayed innumerable inscriptions, written in nearly every language of Europe, some in verse, some in prose, most of them not very laudatory of "bella Italia."	壁のうえにはたくさん楽書（らくがき）がしてありましたが、その半分は＊「ベルラ・イタリア」にはんたいなことばばかりでした。(＊イタリアよいとこ。)
The meal was served.	夕飯がでました。
It consisted of a soup of salted water, seasoned with pepper and rancid oil.	それはこしょうと、ぷんとくさい脂で味をつけた水っぽいスープとでした。
The last ingredient played a very prominent part in the salad;	そのくさい脂がサラダのおもな味でした。
stale eggs and roasted cocks'-combs furnished the grand dish of the repast;	かびくさい卵と、鶏冠（とさか）の焼いたのが一とうのごちそうでした。
the wine even was not without a disgusting taste	ぶどう酒（しゅ）までがへんな味がしました。
--it was like a medicinal draught.	それはたまらないまぜものがしてありました。
At night the boxes and other effects of the passengers were placed against the rickety doors.	夜になると、旅かばんをならべて戸に寄せかけました。
One of the travellers kept watch while the others slept.	ほかのもののねているあいだ、旅人のひとりが交代で起きて夜番をすることになりました。
The sentry was our young Divine.	そこで神学生がまずその役にあたりました。
How close it was in the chamber!	ああ、なんてむんむすることか。
The heat oppressive to suffocation	暑さに息がふさがるようでした。
--the gnats hummed and stung unceasingly	蚊（か）がぶん、ぶん、とんで来て刺しました。
--the "miserabili" without whined and moaned in their sleep.	おもての「ミゼラビリ」は夢のなかでも泣きつづけていました。
"Travelling would be agreeable enough,"	「そりゃ旅行もけっこうなものさ。」
said he groaning,	と、神学生はいいました。
"if one only had no body,	「人間に肉体というものがなければな。
or could send it to rest while the spirit went on its pilgrimage unhindered, whither the voice within might call it.	からだは休ましておいて、心だけとびあるくことができたらいいさ。
Wherever I go, I am pursued by a longing that is insatiable	どこへいってもぼくは心をおされるよう不満にであう。
I want something better than what is but what is fled in an instant.	ぼく［＃「ぼく」は底本では「くぼ」］ののぞんでいたのは、現在の境遇より少しはいいものなのだ。
But what is it, and where is it to be found?	だが、それはどこにある。
Yet, I know in reality what it is I wish for.	心のそこには求めているものがなにかよくわかっている。
Oh! most happy were I, could I but reach one aim	わたしは幸福を目あてにしたいのだ。
--could but reach the happiest of all!"	すべてのもののなかでいちばん幸福なものをね。」
And as he spoke the word he was again in his home; the long white curtains hung down from the windows,	すると、いうがはやいか、学生は、もうじぶんの内へかえっていました、長い、白いカーテンが窓からさがっていました。
and in the middle of the floor stood the black coffin;	そうしてへやのまんなかに、黒い棺（かん）がおいてありました。
in it he lay in the sleep of death.	そのなかで、学生は死んで、しずかに眠っていたのでした。
His wish was fulfilled	のぞみははたされたのです
--the body rested, while the spirit went unhindered on its pilgrimage.	――肉体は休息して、精神だけが自由に旅をしていました。
"Let no one deem himself happy before his end,"	「いまだ墓にいらざるまえ、なにびとも幸福というを得ず。」
were the words of Solon;	とは、ギリシアの賢人ソロンの言葉でした。
and here was a new and brilliant proof of the wisdom of the old apothegm.	ここにそのことばが新しく証明されたわけです。
Every corpse is a sphynx of immortality;	すべて、しかばねは不死不滅のスフィンクスです。
here too on the black coffin the sphynx gave us no answer to what he who lay within had written two days before:	いま目のまえの黒い棺（かん）のなかにあるスフィンクスも、死ぬつい三日まえ書いた、次のことばでそのこたえをあたえているのです。
"O mighty Death! thy silence teaches nought,	いかめしい死よ、おまえの沈黙は恐怖をさそう。
Thou leadest only to the near grave's brink;	おまえの地上にのこす痕跡（あと）は寺の墓場だけなのか。
Is broken now the ladder of my thoughts?	たましいは＊ヤコブのはしごを見ることはないのか。
Do I instead of mounting only sink?	墓場の草となるほかに復活の道はないのか。
Our heaviest grief the world oft seeth not,	この上なく深いかなしみをも世間はしばしばみすごしている。
Our sorest pain we hide from stranger eyes:	おまえは孤独のまま最後の道をたどっていく。
And for the sufferer there is nothing left	しかもこの世にあって心の荷（にな）う義務はいやが上に重い、
But the green mound that o'er the coffin lies."	それは棺の壁をおす土よりも重いのだ。
Two figures were moving in the chamber.	ふたつの姿がへやのなかでちらちら動いていました。
We knew them both;	わたしたちはふたりとも知っています。
it was the fairy of Care, and the emissary of Fortune.	それは心配の妖女（ようじょ）と、幸福の女神の召使でした。
They both bent over the corpse.	ふたりは死人の上にのぞきこみました。
"Do you now see,"	心配がいいました。
said Care,	「ごらん、おまえさんのうわおいぐつがどんな幸福をさずけたでしょう。」
"To him, at least, who slumbers here, they have brought an imperishable blessing,"	「でも、とにかくここに寝ている男には、ながい善福をさずけたではありませんか。」
answered the other.	と、よろこびがこたえました。
"Ah no!"	「まあ、どうして。」
replied Care.	と、心配がいいました。
"He took his departure himself; he was not called away.	「この人はじぶんで出て行ったので、まだ召されたわけではなかったのですよ。
His mental powers here below were not strong enough to reach the treasures lying beyond this life, and which his destiny ordained he should obtain.	この人の精神はまだ強さが足りないので、当然掘り起さなければならないはずの宝を掘り起さずにしまいました。
I will now confer a benefit on him."	わたしはこの人に好いことをしてやりましょう。」
And she took the Galoshes from his feet;	こういって、心配は学生の足のうわおいぐつをぬがしてやりました。
his sleep of death was ended; and he who had been thus called back again to life arose from his dread couch in all the vigor of youth.	すると、死の眠がおしまいになって、学生は目をさまして立ちあがりました。
Care vanished,	心配の姿は消えました。
and with her the Galoshes.	それといっしょにうわおいぐつも消えてなくなりました。
She has no doubt taken them for herself, to keep them to all eternity.	――きっと心配が、そののちそれをじぶんの物にして、もっているのでしょう。
