The Stock-Broker's Clerk	株式仲買店々員
Conan Doyle	コナンドイル
Shortly after my marriage I had bought a connection in the Paddington district.	結婚してからほどなく、私はパッディングトン区にお得意づきの医院を買った。
Old Mr. Farquhar, from whom I purchased it, had at one time an excellent general practice;	私はその医院を老ハルクハー氏から買ったのであるが、老ハルクハー氏は一時はかなり手広く患者をとっていたのであった。
but his age, and an affliction of the nature of St. Vitus's dance from which he suffered, had very much thinned it.	しかし寄る年波とセント・ビタス・ダンスをする習慣があったためすっかりからだを悪くしたので、だんだんお客をなくして淋（さび）れてしまった。
The public not unnaturally goes on the principle that he who would heal others must himself be whole, and looks askance at the curative powers of the man whose own case is beyond the reach of his drugs.	世間の人と云うものは、病人を治療する人間は、その人自身が健康でなくてはならない。
Thus as my predecessor weakened his practice declined, until when I purchased it from him it had sunk from twelve hundred to little more than three hundred a year.	つまりそれと同じような理由で、ハルクハー氏は次第に医院をさびれさせていって、私がその医院を買うまでに一年に千二百人からあった患者が三百人ほどもないくらいにまで減ってしまった。
I had confidence, however, in my own youth and energy and was convinced that in a very few years the concern would be as flourishing as ever.	けれども私は、私の若さと体力とに自信があったので、二三年の間には昔と同様に繁盛するだろうと確信していた。
For three months after taking over the practice I was kept very closely at work	私は仕事を始め出してから三ヶ月の間、最も熱心に注意深く働いた。
and saw little of my friend Sherlock Holmes, for I was too busy to visit Baker Street,	そのため、私はベーカー街に行くには余りにいそがしすぎて、ほとんどシャーロック・ホームズと会わなかった。
and he seldom went anywhere himself save upon professional business.	そして彼自身も、自分の職業上の仕事以外には、どこへも出かけなかった。
I was surprised, therefore, when, one morning in June, as I sat reading the British Medical Journal after breakfast, I heard a ring at the bell, followed by the high, somewhat strident tones of my old companion's voice.	それ故、六月のある朝、朝飯（あさはん）をすましてブリティッシ・メディカル・雑誌を読んでいると、玄関のベルが鳴り、つづいて私の親友の大きな甲高い調子の声がきこえて来たので、私はびっくりした。
``Ah, my dear Watson,''	「やあ、ワトソン君」
said he, striding into the room,	彼は部屋の中に這入（はい）って来ると云った。
``I am very delighted to see you!	「君に会えて嬉しいよ。
I trust that Mrs. Watson has entirely recovered from all the little excitements connected with our adventure of the Sign of Four.''	――君は例の『四つの暗号』事件以来、からだはすっかりいいんだろう？」
``Thank you,	「有難う。
we are both very well,''	――お蔭さまで二人とも丈夫だよ」
said I, shaking him warmly by the hand.	私は彼と友情のこもった握手をしながら云った。
``And I hope, also,''	「そう。
he continued, sitting down in the rocking-chair,	と、彼は廻転椅子の上に腰をおろしながらつづけた。
``that the cares of medical practice have not entirely obliterated the interest which you used to take in our little deductive problems.''	「医者の仕事に本気になりすぎて、僕たちの推理的探偵問題に持っていた君の興味が、全然なくなっちまわないとなお結構なんだけれどね……」
``On the contrary,''	「ところがその反対なんだよ」
I answered,	と、私は答えた。
``it was only last night that I was looking over my old notes, and classifying some of our past results.''	「つい昨夜、僕は古いノートを引っぱり出して調べて、やって来た仕事を分類したばかりなんだよ」
``I trust that you don't consider your collection closed.''	「今までを最後にして、君の蒐集を分類してもう仕事を止めちまおうと思ったわけじゃないんだろうね」
``Not at all.	「全然そうじゃないさ。
I should wish nothing better than to have some more of such experiences.''	それどころか、もっといろいろな経験を積みたいと思ってるくらいだもの。
``To-day, for example?''	「じゃ、きょうからでも、すぐ仕事にかかってくれるかい？」
``Yes,	「やるとも。
to-day, if you like.''	きょうからでも、君が必要だと云うなら……」
``And as far off as Birmingham?''	「遠くってもいいかい？
``Certainly,	「いいとも。
if you wish it.''	君がそこへ行けと云うなら」
``And the practice?''	「けれども商売のほうはどうする？」
``I do my neighbour's when he goes.	「隣の家に住んでる男がどこかへ出かける時はいつも僕が留守を預かってやっていたから、
He is always ready to work off the debt.''	その代り僕が留守をする時は、その男が代りをしてくれることになってるんだ」
``Ha!	「ハハア、
nothing could be better,''	そりア至極好都合だ」
said Holmes, leaning back in his chair and looking keenly at me from under his half-closed lids.	とホームズは椅子にかけたまま後ろにそり反（かえ）って、細めた目で私を鋭く見つめながら云った。
``I perceive that you have been unwell lately.	「君は最近風邪をひいたらしいね。
Summer colds are always a little trying.''	――夏の風邪って云う奴はどうもいかんね」
``I was confined to the house by a severe chill for three days last week.	「先週三日ばかり、馬鹿に寒気がしてね、家に閉じこめられちまったよ。
I thought, however, that I had cast off every trace of it.''	けれどもうすっかりいいつもりなんだ」
``So you have.	「そうらしいね。
You look remarkably robust.''	丈夫そうに見えるよ」
``How, then, did you know of it?''	「けれど、どうして僕が最近風邪をひいたって云うことが分かったんだい？」
``My dear fellow, you know my methods.''	「君は、いつもの僕のやり方を知ってるじゃないか」
``You deduced it, then?''	「じゃ、やっぱり推定したんだね」
``Certainly.''	「無論さ」
``And from what?''	「じゃ、何から？」
``From your slippers.''	「君のスリッパから……」
I glanced down at the new patent-leathers which I was wearing.	私は自分の穿いている護謨革（ごむがわ）の新しいスリッパを見下ろした。
``How on earth -- ''	「だが、一体どうして――？」
I began,	私は云いかけた。
but Holmes answered my question before it was asked.	がホームズは私が云い終らないうちに、私の質問に答えてくれた。
``Your slippers are new,''	「君のスリッパは新しいんだろう」
he said.	と彼は云った。
``You could not have had them more than a few weeks.	「君はそれをまだ二三週間以上は穿いてないよ。
The soles which you are at this moment presenting to me are slightly scorched.	それだのに、今、君が僕のほうにむけているそのスリッパの底は、どこか焦げたような色に変色しているんだ。
For a moment I thought	そこで僕は考えたんだ。
they might have got wet	このスリッパは湿ったに違いない。
and been burned in the drying.	そして乾かす時に焦がされたんだ、とね。
But near the instep there is a small circular wafer of paper with the shopman's hieroglyphics upon it.	――ところがそのかがとのほうに、何か商店のマークのようなものが書いてある丸い紙が貼られてるだろう。
Damp would of course have removed this.	もし全体がぬらされたものだとすると、無論そんな紙ははがれてなくちゃならないさ。
You had, then, been sitting with your feet outstretched to the fire, which a man would hardly do even in so wet a June as this if he were in his full health.''	そこで、君は腰かけていて、火に足をさし出していたんだと云うことになったんだけれど、この六月なんて云う暖い季候に、いかにスリッパが湿ったからと云って、普通の健康体の人間なら火に足をかざすなんてことはしっこないからね」
Like all Holmes's reasoning the thing seemed simplicity itself when it was once explained.	ホームズの推理はすべて、いったん説明されると、いかにも単純そのもののように見えてしまう。
He read the thought upon my features, and his smile had a tinge of bitterness.	彼は私の顔色をうかがってから、微苦笑した。
``I am afraid that I rather give myself away when I explain.''	「僕はどうも思うように説明出来ないので困るんだよ」
said he.	と彼は云った。
``Results without causes are much more impressive.	「原因の分らない結果と云う奴のほうが、実際深く印象されるからね。
You are ready to come to Birmingham, then?''	――それはそうと、君はバーミングハムへ来てくれられるんだね？」
``Certainly.	「無論行くとも。
What is the case?''	――どんな事件なんだい？」
``You shall hear it all in the train.	「汽車の中で話すよ。
My client is outside in a four-wheeler.	――この事件の依頼人が表の四輪馬車の中にいるから。
Can you come at once?''	すぐいかれるかい？」
``In an instant.''	「ああ、すぐ」
I scribbled a note to my neighbour,	私はすぐ隣の住んでいる男に手紙を書いた。
rushed upstairs to explain the matter to my wife, and joined Holmes upon the doorstep.	そして二階へ駈け上って、妻に理由を話し、入口の敷居の上に立っていたホームズと一しょになった。
``Your neighbour is a doctor.''	「お隣さんって云うのは、お医者さんかい？」
said he, nodding at the brass plate.	と、彼は隣の家の真鍮の門札をのぞき込みながら云った。
``Yes,	「ああ、そうだ。
he bought a practice as I did.''	僕と同じように、医院を買ったんだ」
``An old-established one?''	「だいぶ古くからあった医院だったのかい？」
``Just the same as mine.	「僕が買った医院と同時に開かれたものだ。
Both have been ever since the houses were built.''	家が建てられて以来、ずっと二軒とも医院だったらしい」
``Ah!	「ハハア、
then you got hold of the best of the two.''	すると君はそのうちではやるほうを買ったんだね」
``I think I did.	「ああ、そうしたつもりなんだ。
But how do you know?''	けれどどうしてそれが分かる？」
``By the steps, my boy.	「玄関の階段を見れば分かるさ、君。
Yours are worn three inches deeper than his.	君の家のは隣ののよりは三インチも余計にへってるもの。
But this gentleman in the cab is my client, Mr. Hall Pycroft.	――ところで馬車の中にいる男は、依頼人のホール・ピイクロフトと云う男だがね、
Allow me to introduce you to him.	今、君を紹介するから。
Whip your horse up, cabby, for we have only just time to catch our train.''	――オイ、馭者君、汽車にカチカチに間に合うくらいしか時間がないから、いそいで飛ばしてくれ」
The man whom I found myself facing was a well-built, fresh-complexioned young fellow, with a frank, honest face and a slight, crisp, yellow moustache.	私が向き合って坐ったその依頼人と云う男は、あけっ放しな正直そうな顔つきをした、薄いちぢれた黄色い髭をはやした男で、体格のガッシリした活々とした様子の若者だった。
He wore a very shiny top-hat and a neat suit of sober black,	彼はピカピカ光るシルクハットを冠（かぶ）って、手入れのとどいた地味な黒い服を着ていた。
which made him look what he was	がそれは彼が、軽快な若い都会人、
-- a smart young City man, of the class who have been labelled cockneys, but who give us our crack volunteer regiments, and who turn out more fine athletes and sportsmen than any body of men in these islands.	――それも代表的なロンドンっ児で、この国の他のどの階級よりもより多くの義勇兵と競争者と運動家とを出す階級に属している人間であることを、物語っていた。
His round, ruddy face was naturally full of cheeriness, but the corners of his mouth seemed to me to be pulled down in a half-comical distress.	そして彼の丸々とした血色のいい顔は、自然に愉快さで満されていたが、しかしその口の端には、彼が半分はむしろ喜劇的な不幸のためにすっかり沈んでいるらしい所が見えた。
It was not, however, until we were in a first-class carriage and well started upon our journey to Birmingham that I was able to learn what the trouble was which had driven him to Sherlock Holmes.	もっとも彼がどんな不幸に会って、シャーロック・ホームズの所へ飛び込んで来たかと云うことについては、私たちが一等車に乗り込んで、バーミングハムの旅に旅立ってからようやくきくことが出来たのではあったけれど……。
``We have a clear run here of seventy minutes,''	「七十分間この汽車で走るんだが……」
Holmes remarked.	とホームズは云った。
``I want you, Mr. Hall Pycroft, to tell my friend your very interesting experience	「ねえ、ホール・ピイクロフト［＃「ピイクロフト」は底本では「ビイクロフト」］さん、あなたの出会った今度の興味深い事件を、私の友達にも話してやって下さいませんか。
exactly as you have told it to me, or with more detail if possible.	私に話して下すったと同じように正確に、いや、もし願われるなら、それよりも精密に。
It will be of use to me to hear the succession of events again.	――私ももう一度事件の関係をおききしたほうが、いろいろ参考にもなるんです。
It is a case, Watson, which may prove to have something in it, or may prove to have nothing,	――ワトソン君、つまりこの事件の中に何事かがあるか、あるいは何もないかをしらべればいいんだ。
but which, at least, presents those unusual and outre features	しかし少くも事件は、実に奇妙な常規を逸したものなんだ。
which are as dear to you as they are to me.	そしてそれは私にも君にも非常に興味のある事件なんだよ。
Now, Mr. Pycroft.	――どうぞピイクロフトさん、お話しになって下さい。
I shall not interrupt you again.''	私はもうしゃべりませんから……」
Our young companion looked at me with a twinkle in his eye.	私たちの若い同行者は、目の玉をクルリと廻して私を見た。
``The worst of the story is,'' said he, ``that I show myself up as such a confounded fool.	「今度のことで一番に悪かったことは、私が私自身を、すっかり狼狽しちまって、まるで馬鹿のように振舞ったと云う所にあるんです。
Of course it may work out all right,	――無論、それでも私は全力をつくしてやったんです。
and I don't see that I could have done otherwise;	私にはそれより外に出来ることがあるとは思えなかったんです。
but if I have lost my crib and get nothing in exchange I shall feel what a soft Johnny I have been.	けれども、もし私が切札をなくしてその代りに何もとらなかったら、私は自分を、何と云う馬鹿な英国人だろうと感じたでしょう。
I'm not very good at telling a story, Dr. Watson,	――ワトソンさん、私はお話するのが、余り上手ではありません。
but it is like this with me:	――けれどありのままを申上げましょう。
``I used to have a billet at Coxon & Woodhouse's, of Draper Gardens, but they were let in early in the spring through the Venezuelan loan, as no doubt you remember, and came a nasty cropper.	私は呉服屋街のコクソンの店に務めていたんですが、この春大きな損をしまして、たぶん御存じかと思いますが、店がいけなくなっちまったんです。
I have been with them five years,	私はそこに五年おりました。
and old Coxon gave me a ripping good testimonial when the smash came,	だものですから、いよいよ店が破産する時に、私には実に立派な証明書をくれました。
but of course we clerks were all turned adrift, the twenty-seven of us.	――無論、我々事務員は、みんなで二十七人もいたんですが、店が潰れると同時に、みんな散り散りばらばらになってしまいました。
I tried here and tried there, but there were lots of other chaps on the same lay as myself,	――私はあっちへもこっちへも口を頼んでみたんですが、しかしそこにいる連中の運命もまた、私の経験した運命と同じような位置におかれている奴ばかりなんです。
and it was a perfect frost for a long time.	そんなわけで、私は長い間、全く失業状態におちてしまいました。
I had been taking three pounds a week at Coxon's, and I had saved about seventy of them,	私はコクソンの店にいる時は、一週に三ポンドもらっていましたので、それを貯金して七十磅（ポンド）持っていました。
but I soon worked my way through that and out at the other end.	私はそのお金のあるうちに、何か仕事をさがし出さなくてはならないのです。
I was fairly at the end of my tether at last,	けれどほどなくそのお金もなくなってしまいました。
and could hardly find the stamps to answer the advertisements or the envelopes to stick them to.	そして求人広告に応募して手紙を出したくてもその切手もまた切手を貼る封筒もなくなってしまったんです。
I had worn out my boots	私は歩き廻りました。
paddling up office stairs,	靴の底がすり切れるまでほうぼうの事務所の階段を上ったり下ったりしました。
and I seemed just as far from getting a billet as ever.	私はもう前のような職にありつくことは出来ないかと思いました。
``At last	ところがとうとう見つけたんです。
I saw a vacancy at Mawson & Williams's, the great stock-broking firm in Lombard Street.	ロンバルト街の大きな株式仲買店で、モーソン・ウィリアム商会と云う所に欠員を。
I dare say E. C. is not much in your line, but I can tell you that this is about the richest house in London.	そりア、そんなロンドンの中央東部郵便区なんて云う場所は、あなたの趣味には合わないでしょうけれど、しかしその商会はロンドンでも最も金持ちのほうなんです。
The advertisement was to be answered by letter only.	――それは前に、広告を見て手紙を出しといたんですけど、たったそこ一軒だけから返事が来たんです。
I sent in my testimonial and application,	そこで私は証明書と願書とを送りました。
but without the least hope of getting it.	でもその職業に有りつけようなどとは考えてもいなかったんです。
Back came an answer by return, saying that if I would appear next Monday I might take over my new duties at once, provided that my appearance was satisfactory.	――ところが返事が来て、次の月曜日に間違いなく時間までに来てくれれば、その日からすぐに私に仕事につかしてくれると云って来ました。
No one knows how these things are worked.	――どうしてそんな風にして、思いがけなく仕事にありつけたものか、誰にも分かりません。
Some people say that the manager just plunges his hand into the heap and takes the first that comes.	ある人は、たぶんそこの支配人が、山と積まれている願書の中へ手を突っ込んで、最初に手に触れたものを引っ張り出したんだろうと申しています。
Anyhow it was my innings that time,	が、とにかく私の所へ順番があたったんです。
and I don't ever wish to feel better pleased.	私はこんなに嬉しかったことはありません。
The screw was a pound a week rise, and the duties just about the same as at Coxon's.	――給料も一週に一磅（ポンド）のぼりましたし、それでいて仕事はコクソンの店とちょうど同じようなことなんです。
``And now I come to the queer part of the business.	さあ、いよいよ話の本題にやって来ました。
I was in diggings out Hampstead way,	――私はハムステッド町に間借をしてたんです。
17 Potter's Terrace.	ポーター・テラス十七番地です。
Well, I was sitting doing a smoke that very evening after I had been promised the appointment,	――ちょうど、私の勤めがきまった日の夕方、私は煙草を吸いながら腰かけておりました。
when up came my landlady with a card which had `Arthur Pinner, Financial Agent,' printed upon it.	するとそこへ下宿のおかみさんが、『アーサー・ピナー会計代理店』と印刷してある名刺を持って昇って来ました。
I had never heard the name before and could not imagine what he wanted with me,	私はそんな名前を耳にしたことがなかったので、その男が何の用でやって来たのか想像が出来ませんでした。
but of course I asked her to show him up.	けれど無論私は、おかみさんに中へ通すように云いました。
In he walked,	その男は這入って来ました。
a middle-sized dark-haired, dark-eyed, black-bearded man, with a touch of the sheeny about his nose.	――中肉中脊で、髪の毛の濃い、目の黒い、そして黒い髭を生やして、鼻のそばに何か光る筋を持った男でした。
He had a brisk kind of way with him and spoke sharply, like a man who knew the value of time.	彼は時間の尊さを知ってる男であるかのように、はきはきした男で、はっきりどんどん思うことをしゃべるのでした。
```Mr. Hall Pycroft,	「ホール・ピイクロフトさん、
I believe?'	――でいらっしゃいましたね」
said he.	と彼は云いました。
'' `Yes, sir,'	「ええ、そうです」
I answered, pushing a chair towards him.	私はそう答えて、彼のほうに椅子を押しやりました。
```Lately engaged at Coxon & Woodhouse's?'	「最近までコクソン・ウッドハウスの店にいらっしゃいましたか？」
'' `Yes, sir.'	「ええ、おりました」
```And now on the staff of Mawson's.'	「で、ただいまは、モウソンの所に？」
'' `Quite so.'	「そうです」
```Well,'	「ああそうですか」
said he,	と彼は申しました。
`the fact is that I have heard some really extraordinary stories about your financial ability.	「実はあなたの会計的才能につきまして、実に素晴らしいお噂をうかがいましたもので、
You remember Parker, who used to be Coxon's manager.	あなたはコクソンの支配人だったパーカーを御存じですか？
He can never say enough about it.'	――彼が別にあなたのことを云ったと云うわけじゃありませんけど……」
``Of course I was pleased to hear this.	無論私はこの話をきいて喜びました。
I had always been pretty sharp in the office, but I had never dreamed that I was talked about in the City in this fashion.	私は事務所では実際いつも如才なくキビキビと働いてはいましたけれど、しかし世間でこんな風に私の噂をしていようとは夢にも思っていませんでした。
```You have a good memory?'	「あなたは大変記憶がおよろしいんですって？」
said he.	と彼が云いました。
'' `Pretty fair,'	「少しばかり」
I answered modestly.	と、私は慎み深く答えました。
```Have you kept in touch with the market while you have been out of work?'	「職にお離れになってた間も、株のことに関心をお持ちでしたか？」
he asked.	彼はききました。
```Yes.	「ええ、
I read the stock-exchange list every morning.'	毎朝、株式取引の高低表は見ております」
```Now that shows real application!'	「そうだ、それが本当の適不適を示してくれる」
he cried.	と、彼は叫びました。
`That is the way to prosper!	「これが一番いい方法だ。
You won't mind my testing you, will you?	――あなたを試験するようなことをしても気にしないで、
Let me see.	私にやらせて下さい、ね。
How are Ayrshires?'	――アイルシャイアーの株はどのくらいですか？」
```A hundred and six and a quarter to a hundred and five and seven-eighths.'	「百五磅（ポンド）から百五磅（ポンド）四分ノ一まで」
```And New Zealand consolidated?'	「では、ニュウジーランド国庫公債は？」
'' `A hundred and four.'	「百四磅（ポンド）」
```And British Broken Hills?'	「ブリティッシ・ブローラン・ヒルは？」
'' `Seven to seven-and-six.'	「七磅（ポンド）から七磅（ポンド）六まで」
```Wonderful!'	「素適だ！」
he cried with his hands up.	と、彼は両手を振り上げて叫びました。
`This quite fits in with all that I had heard.	「私がきいたのと、すっかりみんな合ってる。
My boy, my boy,	ねえ、ねえ、あなた。
you are very much too good to be a clerk at Mawson's!'	――あなたはモーソンの店の事務員になるなんて勿体なさすぎますよ」
``This outburst rather astonished me,	この叫びはむしろ私を驚かしたんです。
as you can think.	あなたもそうお思いになるでしょう。
`Well,'	「いや、どうも」
said I,	と、私は申しました。
`other people don't think quite so much of me as you seem to do,	「世間の人はあなたが考えるようには、私を買い被ってくれませんよ。
Mr. Pinner.	ピナーさん。
I had a hard enough fight to get this berth, and I am very glad to have it.'	――私はこの地位を得るのにずいぶん苦労したんですから、私はこの職にありつけたのを喜んでおりますよ」
```Pooh, man; you should soar above it.	「馬鹿な、世間の人、こんなものからは超越すべきですね。
You are not in your true sphere.	あなたはあなたの真価に応（ふさわ）しい位置にはいませんよ。
Now, I'll tell you how it stands with me.	――そこで私はあなたに御相談があるんですが、私と一しょに仕事をしていただきたいと思って。
What I have to offer is little enough when measured by your ability, but when compared with Mawson's it's light to dark.	――そりア私があなたについていただきたいと思ってる地位だって、あなたの才能に比しては不充分なものなんですけれど、でもモウソンの所の地位と較べたら、暗（やみ）と光ほどの相違です。
Let me see.	まあ、お話しましょう。
When do you go to Mawson's?'	――あなたはいつ［＃「いつ」は底本では「いつも」］モウソンの所へいらっしゃいますか［＃「いらっしゃいますか」は底本では「いらっやいますか」］？」
```On Monday.'	「月曜日です」
'' `Ha, ha!	「ハッハッ！
I think I would risk a little sporting flutter that you don't go there at all.'	――あなたはあそこへは断じていらっしゃいませんよ。
```Not go to Mawson's'? `	「モウソンの所へいかないって？」
''' No, sir.	「そうですよ。
By that day you will be the business manager of the Franco-Midland Hardware Company, Limited,	――その日までに、あなたはフランス中部鉄器株式会社の営業支配人におなりになるでしょう。
with a hundred and thirty-four branches in the towns and villages of France, not counting one in Brussels and one in San Remo. '	その会社はフランスの町や村に百三十四の支店と、その他に、ブラッセルに一つとサン・レモに一つ支店を持っています」
``This took my breath away.	この話は私を呼吸（いき）づまらせるほど驚かせました。
`I never heard of it.'	「私はそんな会社の話はききませんよ」
said I.	私は申しました。
```Very likely not.	「そりア、話をきこうわけはありません。
It has been kept very quiet,	それは非常に秘密にされたんです。
for the capital was all privately subscribed, and it's too good a thing to let the public into.	なぜなら資本家がみんな匿名だったからですが、しかし公にしたほうがいいんです。
My brother, Harry Pinner, is promoter, and joins the board after allotment as managing director.	――私の兄弟のハリー・ピナーは発企人（ほっきにん）なんですが、選挙の結果、専務取締として評議員に加わっています。
He knew I was in the swim down here and asked me	彼は私がこちらへやって来ることを知ってたものですから、私に申しました。
to pick up a good man cheap.	不遇な才能ある人間を抜擢して来てくれとね。
A young, pushing man with plenty of snap about him.	――元気のいい前途有望な若い人をね。
Parker spoke of you,	――あなたのことはパーカーが話してくれたんです。
and that brought me here to-night.	そして今夜こちらへつれて来てくれた人です。
We can only offer you a beggarly five hundred to start with.'	私たちは初任給として、あなたに五百磅（ポンド）さし上げることが出来るにすぎませんが――」
```Five hundred a year!'	「五百磅（ポンド）、一年に！」
I shouted.	と私は叫びました。
'' `Only that at the beginning;	「それは最初だけの話です。
but you are to have an overriding commission of one per cent on all business done by your agents,	しかしあなたの周旋でされた取引に対してはすべて、一パーセントの過勤割戻しをとることが出来るんです。
and you may take my word for it that this will come to more than your salary.'	そして正直の所、これがあなたの俸給より多くなることは受合いです」
```But I know nothing about hardware.'	「けれど私は鉄器類のことについては何も知りませんよ」
'' `Tut, my boy,	「しようがないな、君は。
you know about figures.'	――形は分かるでしょう」
``My head buzzed, and I could hardly sit still in my chair.	私の頭の中は騒然として、私は静かに椅子に腰かけていられなくなりました。
But suddenly a little chill of doubt came upon me.	けれど、ふとかすかな疑いが、私におこりました。
```I must be frank with you,'	「ざっくばらんに申上げますが……」
said I.	と私は云いました。
`Mawson only gives me two hundred,	「モウソンは私に二百磅（ポンド）くれるだけです。
but Mawson is safe.	けれどモウソンのほうは確かなんです。
Now, really, I know so little about your company that -- '	が、真実の所、私はあなたの会社についてはほとんど知らないのですからね、――」
```Ah, smart, smart!'	「ああ、あなたは実にきびきびしている！」
he cried in a kind of ecstasy of delight.	と、彼は喜びで夢中になっているような調子で叫びました。
`You are the very man for us.	「あなたは私たちがほしいと思ってた通りの方です。
You are not to be talked over, and quite right, too.	それ以上おっしゃらなくても、ちゃんと分かっています。
Now, here's a note for a hundred pounds,	さあ、ここに百磅（ポンド）の小切手があります。
and if you think that we can do business you may just slip it into your pocket as an advance upon your salary.'	――もしあなたが私達の仕事をしようとお思いになったら、これを給料の前渡し分としてお納めになって下さい」
```That is very handsome,'	「分かりました。
said I.	私は申しました。
`When should I take over my new duties?'	「で、いつから私は仕事にかかったらいいんでしょう？」
```Be in Birmingham to-morrow at one,'	「すぐに明日、バーミングハムへいってもらいたいんです」
said he.	と、彼は云いました。
`I have a note in my pocket here which you will take to my brother.	「ポケットの中へ、私は手紙を持って来てますから、それを私の兄弟の所へ持って行って下さい。
You will find him at 126B Corporation Street,	コーポレーション街一二六番地ですから、分かります。
where the temporary offices of the company are situated.	そこに会社の仮事務所があるんです。
Of course he must confirm your engagement, but between ourselves it will be all right.'	――もちろん、あなたとのお約束は彼が確実に取きめてくれるでしょうが、しかし私たちの間にはちゃんと話がしてあるんですから……」
```Really, I hardly know how to express my gratitude,	「本当に、私は、あなたにどう云ってお礼を申上げたらいいか分かりません。
Mr. Pinner,'	ピナーさん」
said I.	私は申しました。
```Not at all,	「そんなお礼なんかなさることはありませんよ。
You have only got your deserts.	あなたはただあなたが当然受くべきものを受けたにすぎないんですもの。
There are one or two small things	――だが、ちょっとしといていただかなければならない、
-- mere formalities	――単なる形式なんですが、
-- which I must arrange with you.	――つまらないことが一つ二つあるんです。
You have a bit of paper beside you there.	そこへ紙を一枚お出しになって下さいませんか。
Kindly write upon it	そしてすみませんが、
'' I am perfectly willing to act as business manager to the Franco-Midland Hardware Company, Limited, at a minimum salary of 500 pounds. ``'	「最低俸給五百磅（ポンド）にて、フランス中部鉄器株式会社営業支配人として働くことに同意致し候」
``I did as he asked,	私は彼の云う通りにしました。
and he put the paper in his pocket.	そして彼はその紙をポケットの中へしまい込みました。
```There is one other detail,'	「それからもう一つ精（くわ）しくおききしたいのは、あなたはモウソンのほうはどうなさるおつもりですか？」
said he.	彼は云いました。
``I had forgotten all about Mawson's in my joy.	――私はモウソンのことについては、余り喜んだので、すっかり忘れてしまっていたんです。
`I'll write and resign,'	「手紙を書いて、辞職しましょう」
said I.	私は答えました。
``' Precisely what I don't want you to do.	「私がお願いしないことはなさらないように。
I had a row over you with Mawson's manager.	――私はあなたをモウソンの店の支配人として知ったわけです。
I had gone up to ask him about you,	そこで私はモウソンにあなたのことをきいてみました。
and he was very offensive;	すると彼は大変機嫌を悪くして、
accused me of coaxing you away from the service of the firm, and that sort of thing.	――あなたを私が誘惑してあそこの店からつれ出すか、何かそんなことをするのだと云って私を非難しました。
At last I fairly lost my temper.	そんなわけで私はとうとう我慢がしきれなくなってしまったんです。
'' If you want good men you should pay them a good price, ``	「もしあなたが有為な人がほしいなら、もっとたくさん報酬をお払いにならなくてはなりませんよ」
said I.	と私は云っちまったんです。
``''' He would rather have our small price than your big one, ``	すると彼は
said he.	と云うんです。
``''' I'll lay you a fiver, ``	そこで私は
said I,	「あらかじめお断りしておきますが、あの男が私の店へ来るようになっても、あなたはお咎めになさらないでしょうな」
'' that when he has my offer you'll never so much as hear from him again. ``	と云うと
``''' Done! `` said he. '' We picked him out of the gutter, and he won't leave us so easily. ``	「僕はあの男をどぶの中から引き抜いてやったんだから、そんなに容易（たやす）くは僕の店から出て行きあしないよ」
Those were his very words. '	と、こう云う彼の云い草なんですよ」
```The impudent scoundrel!'	「失敬な奴だな」
I cried.	私は叫びました。
`I've never so much as seen him in my life.	「もう生涯あいつん所へは行くものか。
Why should I consider him in any way?	どんな点から云ったって、何故（なにゆえ）私は彼に気兼ねをしなくちゃならないでしょう。
I shall certainly not write	――私は何も云ってやりますまい。
if you would rather I didn't.'	あなたがそうすることに賛成して下さるなら」
```Good!	「賛成！
That's a promise,'	じゃ、お約束しましたよ」
said he, rising from his chair.	彼は椅子から立ち上りながら云いました。
`Well, I'm delighted to have got so good a man for my brother.	「本当に、私は私の兄弟のためにあなたのような有為な人を得られて喜んでいます。
Here's your advance of a hundred pounds,	――これは俸給の前払いの百磅（ポンド）です。
and here is the letter.	それからこれは手紙です。
Make a note of the address,	向うの所番地をお書とめになって下さい。
126B Corporation Street,	コーポレーション街一二六番地。
and remember that one o'clock to-morrow is your appointment.	それから明日の一時までにいらっして下さる［＃「下さる」は底本では「下る」］ことをお忘れにならないように――。
Good-night,	じゃおいとまします。
and may you have all the fortune that you deserve!'	万事うまくおやりになるように」
``That's just about all that passed between us,	これがその時、私たちの間に起きたことの、ほとんどそのままなんです。
as near as I can remember.	私はごく最近のことなんではっきり覚えているんです。
You can imagine, Dr. Watson, how pleased I was at such an extraordinary bit of good fortune.	――ワトソンさん、私がその素敵な幸運に出会って、どんなに喜んだかは、想像していただけるでしょう。
I sat up half the night hugging myself over it,	私はその夜嬉しく夜中すぎまで起きてました。
and next day I was off to Birmingham in a train that would take me in plenty time for my appointment.	そしてその翌日、私は約束の時間に充分間に合うような汽車に乗ってバーミングハムへ出かけて行きました。
I took my things to a hotel in New Street, and then I made my way to the address which had been given me.	私はひとまず新開通りにあるホテルに荷物を届けて、それから指定通りの所番地へ出かけました。
``It was a quarter of an hour before my time, but I thought that would make no difference,	私はそこへ約束の時間より十五分前に着いたんですが、前の晩にきいたことに何の間違いもないと思いました。
126B was a passage between two large shops, which led to a winding stone stair, from which there were many flats, let as offices to companies or professional men.	一二六番地と云うのは大きな二軒の商店の間にある出入口で、曲りくねって石の階段がありましたが、そこから何階もある各階の、会社や商人の事務所へ行けるらしいのでした。
The names of the occupants were painted at the bottom on the wall, but there was no such name as the Franco-Midland Hardware Company, Limited.	――ところが、居住者の名前はそこの壁の下のほうに書いてありましたが、フランス中部鉄器株式会社なんて云うそんな名前はないのです。
I stood for a few minutes with my heart in my boots,	――私はしばらくの間、何か不安に駈られながらそこに立っておりました。
wondering whether the whole thing was an elaborate hoax or not,	これは何か念入りないたずらなんじゃなかろうかなどと考えながら。
when up came a man and addressed me.	――するとそこへ一人の男がやって来て私に声をかけました。
He was very like the chap I had seen the night before, the same figure and voice,	その男は前の晩私が会った奴とそっくりでして、顔形も声も同じなんです。
but he was clean-shaven and his hair was lighter.	ただその男はきれいに頭髪を刈って髪の毛を光らせていました。
```Are you Mr. Hall Pycroft?'	「あなたはホール・ピイクロフトさんですか？」
he asked.	その男は訊ねました。
'' `Yes,'	「ええ、そうです」
said I.	私は答えました。
```Oh!	「ああ、そうですか。
I was expecting you,	私はあなたをお待ちしてたんです。
but you are a trifle before your time.	けれどあなたのほうがお約束の時間より少し早くいらっしったんです。
I had a note from my brother this morning in which he sang your praises very loudly.'	――けさは、私の兄弟から手紙を貰らいましてね、兄弟はその手紙の中で大変あなたのことをほめておりましたよ」
```I was just looking for the offices when you came.'	「あなたがいらしった時、ちょうど、事務所をさがしてたんです」
```We have not got our name up yet,	「まだ名前を出しとかないもので。
for we only secured these temporary premises last week.	先週からここへ仮事務所をおくことにきめたばかりだものですからね。
Come up with me,	――一しょにおいでになって下さい。
and we will talk the matter over.'	お話致しましょう」
``I followed him to the top of a very lofty stair,	私は彼について、ずいぶん急な階段の頂上までのぼりました。
and there, right under the slates, were a couple of empty, dusty little rooms, uncarpeted and uncurtained, into which he led me.	と、その屋根裏に、空っぽの誰もいないほこりだらけな、敷物もしいてなければカーテンもかけてない小さいな二つの部屋があって、その中へ私は案内されました。
I had thought of a great office	――正直な所、私は大きな事務所を予想して来たんです。
with shining tables and rows of clerks, such as I was used to,	それまでと同じような、幾つものチャカチャカしたテエブルや大勢の事務員がズラリと並んでるようなそう云う大きな事務所を。
and I daresay I stared rather straight at the two deal chairs and one little table,	――包まず申上げますが、私はその二つの安い椅子と一つの小さなテエブルとをしげしげと眺めました。
which with a ledger and a waste-paper basket, made up the whole furniture.	その他に元帳が一冊と屑籠が一つと、それだけが全部の家具なんですからねえ。
```Don't be disheartened, Mr. Pycroft,'	「がっかりなすっちゃいけませんよ、ピイクロフトさん」
said my new acquaintance, seeing the length of my face.	と、私のこの新しい知り合いは、私の顔の上から下まで見下ろしながら云うのでした。
`Rome was not built in a day,	「ローマは一日で築き上げられませんよ。
and we have lots of money at our backs, though we don't cut much dash yet in offices.	――事務所は貧弱でも、私たちは背後にたくさんお金は持ってますから、
Pray sit down,	――まあ、おかけなさい。
and let me have your letter.'	そして持ってらした手紙を見せて下さい」
``I gave it to him,	私は彼に手紙をやりました。
and he read it over very carefully.	彼はそれを大変叮嚀（ていねい）に読みました。
```You seem to have made a vast impression upon my brother Arthur,'	「あなたはよほど深く私の兄弟を感心させたと見えますな」
said he,	彼は申しました。
`and I know that he is a pretty shrewd judge.	「だが、私の兄弟は本当に鋭い批判家です。
He swears by London, you know;	――私の兄弟はあなたとロンドンでお約束をしたんで、
and I by Birmingham;	私はバーミングハムでするわけなんですが、
but this time I shall follow his advice.	しかし今度は、彼の云う通りに従いましょう。
Pray consider yourself definitely engaged.'	――では、どうぞそのおつもりで、お願いします」
```What are my duties?'	「私の仕事はどんなことなんでしょう？」
I asked.	私はききました。
'' `You will eventually manage the great depot in Paris, which will pour a flood of English crockery into the shops of a hundred and thirty-four agents in France.	「つまり、フランスにある百三十四軒の代理店へ、英国製の器具を送り出す所のパリの本店を支配して下さればいいんですよ。
The purchase will be completed in a week, and meanwhile you will remain in Birmingham and make yourself useful.'	取引きの約束は一週間のうちにきまりますから、その間あなたはバーミングハムにいて下すって、あなたの仕事をしていて下さればいいんです」
```How?'	「と云いますと、どんなことをしたら？」
'' For answer, he took a big red book out of a drawer.	彼は答えの代りに、曳出（ひきだ）しから大きな赤い本を出して来ました。
```This is a directory of Paris,'	「これはパリの人名住所録ですが」
said he,	と彼は云いました。
`with the trades after the names of the people.	「名前の下に職業が書き込んであります。
I want you to take it home with you and to mark off all the hardware-sellers, with their addresses.	これをお宅へお持ちになって、この中にある鉄器商を全部住所と共に書き抜いていただきたいんです。
It would be of the greatest use to me to have them.'	そうして下されば、私たちに非常に役に立つんです」
```Surely,	「かしこまりました。
there are classified lists?'	この中に分類目録がありますね」
I suggested.	私は念のためにきいてみました。
'' `Not reliable ones.	「確実なものじゃないんです。
Their system is different from ours.	――この編纂方法は私たちのとは違ってます。
Stick at it,	――それをやっていただきたいんです。
and let me have the lists by Monday, at twelve.	そして月曜日の十二時までに目録を私に下さいませんか。
Good-day, Mr. Pycroft.	――ではさよなら、ピイクロフトさん。
If you continue to show zeal and intelligence you will find the company a good master.'	あなたが熱心にお骨折り下すって、会社の有為な主脳部になっていただきたいんです」
``I went back to the hotel with the big book under my arm, and with very conflicting feelings in my breast.	私はその大きな本を小側（こわき）に抱え、胸の中に矛盾した困惑した感情を持ちながらホテルに帰って来たのです。
On the one hand, I was definitely engaged and had a hundred pounds in my pocket;	一方では確実に仕事をする約束をして、百磅（ポンド）をポケットの中に持っていながら、
on the other, the look of the offices, the absence of name on the wall, and other of the points which would strike a business man had left a bad impression as to the position of my employers.	一方では、事務所の外見、壁の上に会社の名前が出ていなかったこと、それからその他事務家の注意しないではいられない部分などが、私のその雇主の位置に対して悪印象を残しているのでした。
However, come what might, I had my money,	が、とは云え、よしどんなことが起きて来ようとも、私はお金を貰っているのです。
so I settled down to my task.	そしてお見目得（みめえ）もすんでしまったのです。
All Sunday I was kept hard at work,	――私は日曜一日一生懸命に仕事を致しました。
and yet by Monday I had only got as far as H.	けれども月曜日までに、たったＨの部までやっただけでした。
I went round to my employer, found him in the same dismantled kind of room, and was told to keep at it until Wednesday, and then come again.	で、私は雇主の所へいって、彼は同じ何の装飾もないガランとした例の部屋におりましたが、水曜日まで待ってもらうように話して帰って来ました。
On Wednesday it was still unfinished, so I hammered away until Friday	ところが水曜日になってもまだ終らなかったので、金曜日までのばしてしまったのです。
-- that is, yesterday.	――それが、昨日のことです。
Then I brought it round to Mr. Harry Pinner.	そこで私はそれをハリー・ピナー氏の所へ持って行きました。
```Thank you very much,'	「どうも本当に有難う」
said he,	と彼は申しました。
`I fear that I underrated the difficulty of the task.	「思ったより仕事がむずかしかったかと恐れてた所です。
This list will be of very material assistance to me.'	この表は実によい私の助手になってくれますよ」
```It took some time,'	「だいぶひまがかかって……」
said I.	私は申しました。
'' `And now,'	「では今度は……」
said he,	彼は云いました。
`I want you to make a list of the furniture shops,	「家具商の表をつくっていただきたいんです。
for they all sell crockery.'	家具商もみんな鉄具類を売りますからね」
```Very good.'	「よろしゅうございます」
'' `And you can come up to-morrow evening at seven	「それから明日の夕方七時にいらしって下さい。
and let me know how you are getting on.	そしてどのくらい仕事をなすったか私に見せていただきとうございます。
Don't overwork yourself.	――労働過度にならないように。
A couple of hours at Day's Music Hall in the evening would do you no harm after your labours.'	夕方二時間ばかりミュジック・ホールへいらっしゃるのは、一日働いたあとに害にはなりませんよ」
He laughed as he spoke,	彼はそう云って笑いました。
and I saw with a thrill that his second tooth upon the left-hand side had been very badly stuffed with gold. ``	その時私は、彼の左側のほうの、金で不体裁に詰めてある二番目の歯を見てギクッとしました」
Sherlock Holmes rubbed his hands with delight,	シャーロック・ホームズは喜んで彼の手をこすった。
and I stared with astonishment at our client.	私は喫驚（びっくり）して私達のお客を見詰めた。
``You may well look surprised, Dr. Watson, but it is this way,''	「ワトソンさん、あなたは大変お驚きになったようですが、それはこう云うわけなんです」
said he:	私たちのお客は話し続けた。
``When I was speaking to the other chap in London, at the time that he laughed at my not going to Mawson's, I happened to notice that his tooth was stuffed in this very identical fashion.	「今、ロンドンで会ったもう一人の男のことを申上げましたが、その時、私がモウソンの店へ行くことはやめようと云いますと、その男は喜んで笑ったのですが、その笑った時に私はこれとそっくりのやり方で詰められている彼の歯を見たんです。
The glint of the gold in each case caught my eye, you see.	あなたもお分かりになるように、その時も今度の時も、金の光りが私の眼を捕えたのです。
When I put that with the voice and figure being the same, and only those things altered which might be changed by a razor or a wig, I could not doubt that it was the same man.	――そこで私は以上のことの上に、声と様子とが同じであると云うことと、そして剃刀（かみそり）と仮髪（かつら）とさえあれば人間の顔貌（がんぼう）は変えられると云うことを考え合せると、私はその二人が同じ人間であると疑わざるを得なかったのです。
Of course you expect two brothers to be alike,	無論あなたは兄弟は似ているとおっしゃるでしょう。
but not that they should have the same tooth stuffed in the same way.	しかし同じ歯を同じようなやり方でうめるわけがないではありませんか。
He bowed me out,	――彼は私を送り出しました。
and I found myself in the street, hardly knowing whether I was on my head or my heels.	そして私は通りへ出ましたが、無我夢中で、足で歩いてるのか頭で歩いてるのか分かりませんでした。
Back I went to my hotel, put my head in a basin of cold water, and tried to think it out.	私はホテルへ帰りつくと、冷たい水で頭をひやして、そのことを考えてみました。
Why had he sent me from London to Birmingham?	――なぜ彼はロンドンからバーミングハムへ私を寄越したんだろう
Why had he got there before me?	……またなぜ彼は私に近寄って来たのだろう。
And why had he written a letter from himself to himself?	そして何の必要があって彼は、自分自身から自分自身へあてた手紙などを私に持たせてよこしたのだろう？
It was altogether too much for me, and I could make no sense of it.	――これらのことは私にはあまりに問題が多すぎて、判断が出来ないのです。
And then suddenly it struck me that what was dark to me might be very light to Mr. Sherlock Holmes.	その時ふと私は、私には何が何だか分からないことも、シャーロック・ホームズさんには分かるだろうと云う事に考えついたんです。
I had just time to get up to town by the night train to see him this morning, and to bring you both back with me to Birmingham.''	で、私はすぐさま夜中（やちゅう）に乗り込んで、今朝お目にかかって、そのままバーミングハムへ私と一しょに来ていただこうと思ってやって来たわけなのでございます」
There was a pause after the stock-broker's clerk had concluded his surprising experience.	株式仲買店事務員は彼の不思議な経験を話し終ってから、ちょっとだまった。
Then Sherlock Holmes cocked his eye at me, leaning back on the cushions with a pleased and yet critical face, like a connoisseur who has just taken his first sip of a comet vintage.	と、シャーロック・ホームズは、ちょうどお酒の鑑賞家が、素晴らしい葡萄酒の最初の一滴を一吸い吸い込んだ時のような、嬉しそうなそれでいて何かを批判しているような顔つきをして、クッションに背をもたせながら、私のほうへ斜に視線を投げかけた。
``Rather fine,	「面白い問題じゃないか。
Watson, is it not?''	ねえ、ワトソン」
said he.	と、ホームズは云った。
``There are points in it	「これには僕を喜ばせる点があるよ。
which please me.	君も賛成するだろう。
I think that you will agree with me that an interview with Mr. Arthur Harry Pinner in the temporary offices of the Franco-Midland Hardware Company, Limited, would be a rather interesting experience for both of us.''	二人でアーサー・ハリー・ピナー氏に、そのフランス中部鉄器株式会社の仮事務所で会見することは、むしろ我々に興味のある経験だと云うことに」
``But how can we do it?''	「しかしどうしたら会えるだろう？」
I asked.	私はきいた。
``Oh, easily enough,''	「ああそりアごくやさしいことですよ」
said Hall Pycroft cheerily.	と、ホール・ピイクロフトは快活に云った。
``You are two friends of mine who are in want of a billet, and what could be more natural than that I should bring you both round to the managing director?''	「あなた二人は職をさがしている私の友達で、何かに使ってもらおうと思って専務取締役に引き合せるためにつれて来た、と云うこれより自然な方法はないでしょう？」
``Quite so, of course,''	「もちろん、そうだ！」
said Holmes.	ホームズは云った。
``I should like to have a look at the gentleman and see if I can make anything of his little game.	「私はその男に会って、私が何かその男のやってる小さな計画（けいが）についてしてやることが出来るように見せかけなくちゃならないね。
What qualities have you, my friend, which would make your services so valuable?	――ところで、君はどんなことをするかね、最も有効に働くには？
Or is it possible that -- ''	それとも出来れば……」
He began biting his nails	彼は爪をかみ初めた。
and staring blankly out of the window,	そして窓から外を一心に眺め初めた。
and we hardly drew another word from him until we were in New Street.	そうして私たちはそのまま、私たちが新開通りへつくまで一言も彼から言葉を引き出すことは出来なかった。
×　　　　×　　　　×　　　　×　　　　× At seven o'clock that evening we were walking, the three of us, down Corporation Street to the company's offices.	その日の夕方七時、私たち三人は歩いて、コーポレーション通りを会社の事務所のあるほうへ下っていった。
``It is no use our being at all before our time,''	「時間が来るまでは私たちは用なしのからだですよ」
said our client.	と私たちの依頼人は云った。
``He only comes there to see me, apparently,	「明（あきら）かに、彼は私に合うだけにあそこへ来るんです。
for the place is deserted up to the very hour he names.''	なぜって、時間が来るまでは、事務所はガラ空きになってるって、彼が言明してますもの」
``That is suggestive,''	「何か曰くがありそうだな」
remarked Holmes.	ホームズは云った。
``By Jove, I told you so!''	「確かにそうなんですよ。
cried the clerk.	――ほら、あそこへやって来ました。」
``That's he walking ahead of us there.''	と、その事務員は叫んだ。
He pointed to a smallish, dark, well-dressed man who was bustling along the other side of the road.	彼は道路の反対側をいそぎ足で歩いている、小柄なブロンドのきちんとした服装をしている男を指さした。
As we watched him he looked across at a boy who was bawling out the latest edition of the evening paper, and, running over among the cabs and busses, he bought one from him.	私たちが彼に注意している時、彼は馬車やバスの間から飛び出して来た。
Then, clutching it in his hand, he vanished through a doorway.	そしてそれを手に掴（にぎ）りながら入口から中へ消えてしまった。
``There he goes!''	「あそこへいった」
cried Hall Pycroft.	ホール・ピイクロフトは叫んだ。
``These are the company's offices into which he has gone.	「彼が這入ってった所に事務所があるんです。
Come with me,	私と一しょにお出で下さい。
and I'll fix it up as easily as possible.''	出来るだけ無雑作にやっちまいましょう」
Following his lead, we ascended five stories,	私たちは彼について五階まで登った。
until we found ourselves outside a half-opened door,	すると私たちは入口の戸が半分開きかかっている部屋の前に出た。
at which our client tapped.	私たちの依頼人はそこでノックした。
A voice within bade us enter,	「お這入り下さい」
and we entered a bare, unfurnished room such as Hall Pycroft had described.	そこで私たちは、ホール・ピイクロフトが話した通りな、飾りつけのしてない丸裸の部屋の中に這入っていった。
At the single table sat the man whom we had seen in the street, with his evening paper spread out in front of him,	たった一つしかない机の前に、私たちが通りで見た男が、自分の前に夕刊をひろげたまま坐っていた。
and as he looked up at us it seemed to me that I had never looked upon a face which bore such marks of grief, and of something beyond grief -- of a horror such as comes to few men in a lifetime.	私は、その男が私たちのほうを振りむいた時、そんなに悲しみの跡のある、と云うより悲しみ以上の何ものかの跡、
His brow glistened with perspiration, his cheeks were of the dull, dead white of a fish's belly, and his eyes were wild and staring.	彼の顔は汗で輝き、頬は魚の腹のようないやな白い色をし、そして彼の両眼は野獣的で人をジロジロ眺めていた。
He looked at his clerk as though he failed to recognize him,	彼は彼の事務員を、誰だか分からないかのような顔をして見詰めた。
and I could see by the astonishment depicted upon our conductor's face that this was by no means the usual appearance of his employer.	私は私たちの指揮者の顔に浮んだ驚きを見て、それは決してその男の平常の表情ではないことが分かった。
``You look ill, Mr. Pinner!''	「どこかお悪そうですね、ピナーさん」
he exclaimed.	と、私たちの事務員は叫んだ。
``Yes, I am not very well,''	「ええ、あまりよくはありません」
answered the other, making obvious efforts to pull himself together and licking his dry lips before he spoke.	と、その男は彼のからだを動かすのにいかにも大儀そうにしながら、何かものを云う前にはかわいた唇をなめずりながら、答えた。
``Who are these gentlemen whom you have brought with you?''	「あなたが連れて来たその方たちはどなたですか？」
``One is Mr. Harris, of Bermondsey, and the other is Mr. Price, of this town,''	「一人はハリス君と云ってバーモンドセイのもので、もう一人のほうはプライス君と云うこの町のものです」
said our clerk glibly.	私たちの事務員はすらすらと答えた。
``They are friends of mine and gentlemen of experience, but they have been out of a place for some little time,	「みんな私の友人で、経験もある者たちなんですが、しばらく失業してるんです。
and they hoped that perhaps you might find an opening for them in the company's employment.''	そんなわけで、もしかしたらあなたに、会社の空席へ雇っていただけはしないだろうか、と二人は希望してるわけなんです」
``Very possibly! very possibly!''	「幾らでも出来るとも！」
cried Mr. Pinner with a ghastly smile.	と、ピナー氏は気味悪い笑いを浮べて叫んだ。
``Yes,	「よござんす。
I have no doubt that we shall be able to do something for you.	確かに、何かあなたがたのためにお計らい出来ると思います。
What is your particular line, Mr. Harris?''	――ハリスさん、あなたの御専問はなんです？」
``I am an accountant,''	「私は会計師でございます」
said Holmes.	ホームズは云った。
``Ah, yes,	「ああ、なるほど。
we shall want something of the sort.	私たちはそんな方も何か入要でしょう。
And you.	それからあなた。
Mr. Price?''	プライスさんは？」
``A clerk,''	「事務員です」
said I.	私は答えた。
``I have every hope that the company may accommodate you.	「私はやがて、会社があなたがたのお世話が出来るようになるだろうと思っております。
I will let you know about it as soon as we come to any conclusion.	で、何か私たちが決定しましたらすぐ、あなたがたの所へお知らせ致しましょう。
And now I beg that you will go.	ですから、ただいまの所はお引取り願いたいと思います。
For God's sake leave me to myself!''	どうか、私を一人きりにさせて下さい」
These last words were shot out of him, as though the constraint which he was evidently setting upon himself had suddenly and utterly burst asunder.	この最後の言葉は、まるで彼の上にのしかかっていた圧迫を、急に全くはねのけたかのように、激しい勢いで彼の口からとび出した。
Holmes and I glanced at each other,	ホームズと私とはお互いに顔を見合った。
and Hall Pycroft took a step towards the table.	と、ホール・ピイクロフトは一歩テエブルのほうへ近寄っていった。
``You forget, Mr. Pinner,	「ピナーさん、あなた、お忘れになっては。
that I am here by appointment to receive some directions from you,''	――御命令で、何か御指図をうけたまわりに参ったのですが」
said he.	彼は云った。
``Certainly, Mr. Pycroft, certainly,''	「大丈夫だよ、ピイクロフト君、大丈夫だよ」
the other resumed in a calmer tone.	おだやかな口調で答えた。
``You may wait here a moment	「ちょっとここで待ってくれたまえ。
and there is no reason why your friends should not wait with you.	別になぜってことはないけれど、あなたのお友達があなたを待ってると云うわけにも行かないでしょうから。
I will be entirely at your service in three minutes,	三分間であなたにお願いすることをまとめましょう。
if I might trespass upon your patience so far.''	それだけの間、御迷惑でも御辛抱していて下されば……」
He rose with a very courteous air,	彼は叮嚀な様子をして立ち上った。
and, bowing to us, he passed out through a door at the farther end of the room, which he closed behind him.	そして私たちに挨拶しながら、部屋の向うの端にある出入口から出て、あとをしめていってしまった。
``What now?''	「どうしたって云うんです？」
whispered Holmes.	ホームズは小声で云った。
``Is he giving us the slip?''	「気づかれて逃げられたかな？」
``Impossible,''	「逃げられませんよ」
answered Pycroft.	ピイクロフトは答えた。
``Why so?''	「どうして？」
``That door leads into an inner room.''	「あのドアは、中の部屋へ行く口なんです」
``There is no exit?''	「そこに出口はないの？」
``None.''	「ありません」
``Is it furnished?''	「その部屋は飾つけがしてありますか？」
``It was empty yesterday.''	「昨日はからっぽでした」
``Then what on earth can he be doing?	「そうとすれば、一体、何をすることが出来るだろう？
There is something which I don't understand in this matter.	どうも私に了解出来ない何ものかがある。
If ever a man was three parts mad with terror, that man's name is Pinner.	――もし恐怖の余り気を変にしたものがあったとしたら、それはピナー自身だ。
What can have put the shivers on him?''	何が彼奴（きゃつ）をこわがらせたんだろうね？」
``He suspects that we are detectives,''	「僕たちが探偵だと云うことに感づいたんだよ」
I suggested.	私は自分の不安を云ってみた。
``That's it,''	「そうです」
cried Pycroft.	ピイクロフトは云った。
Holmes shook his head.	が、ホームズは首を横に振って
``He did not turn pale.	「あいつは蒼くはなってなかったよ。
He was pale when we entered the room,''	あいつは私たちが這入って来た時、既に蒼い顔をしてた。
``It is just possible that -- ''	考えられることは――」
His words were interrupted by a sharp rat-tat from the direction of the inner door.	ホームズの言葉は、中の部屋のほうから来る、鋭いコツコツと云う音でさまたげられた。
``What the deuce is he knocking at his own door for?''	「何だってあいつは自分の部屋をノックするんだろう」
cried the clerk.	事務員は云った。
Again and much louder came the rat-tat-tat.	再び前よりは高いコツコツと云う小音が聞えて来た。
We all gazed expectantly at the closed door.	私達はみんな、呼吸（いき）を殺ろして閉されてあるドアを見詰めた。
Glancing at Holmes, I saw his face turn rigid, and he leaned forward in intense excitement.	ホームズを見ると、彼の顔は緊張して、激しい昂奮のため、からだを前こごみにしていた。
Then suddenly came a low guggling, gargling sound, and a brisk drumming upon woodwork.	と、その時ふいに、低いゴロゴロゴロゴロと云う含嗽（うがい）するような音につづいて、木の上をはげしくたたく音が聞えて来た。
Holmes sprang frantically across the room and pushed at the door.	ホームズは気違いのように部屋を走っていって、ドアを押した。
It was fastened on the inner side.	それは内側から固く閉されていた。
Following his example, we threw ourselves upon it with all our weight.	私たちはホームズに従って、私たちの全身の重みでドアにぶつかっていった。
One hinge snapped, then the other, and down came the door with a crash.	一つの蝶番（ちょうつがい）がとれ、それからもう一つのがとれ、ドアはガタンと倒れた。
Rushing over it, we found ourselves in the inner room.	私たちはそれを乗り越えて中の部屋に飛び込んだ。
It was empty.	が、そこには誰もいなかった。
But it was only for a moment that we were at fault.	しかし私たちが油断していたのはほんのわずかな時間に過ぎなかったのだ。
At one corner,	と、片方の隅に、
the corner nearest the room which we had left, there was a second door.	――私たちが出て来た部屋に近いほうの隅に、もう一つのドアがついていた。
Holmes sprang to it and pulled it open.	ホームズはそこにとびついて引きあけた。
A coat and waistcoat were lying on the floor, and from a hook behind the door, with his own braces round his neck, was hanging the managing director of the Franco-Midland Hardware Company.	するとそこの床の上には、上衣（うわぎ）やチョッキがぬぎすててあって、そしてドアの背後についている鉤金（かぎがね）に、フランス中部鉄器株式会社の専務取締役が、自分の首の廻りに自分のズボンツリをまきつけてブラさがっていた。
His knees were drawn up, his head hung at a dreadful angle to his body,	彼は両足を揃えて、彼の首は前のほうへ無気味な恰好にダランとたれていた。
and the clatter of his heels against the door made the noise which had broken in upon our conversation.	そして彼の踵は、私たちの話を邪魔した、あの音を立て得るくらいに床とすれすれになっていた。
In an instant I had caught him round the waist,	私はすぐさま彼の胴に抱きついて彼のからだを持ち上げた。
and held him up while Holmes and Pycroft untied the elastic bands which had disappeared between the livid creases of skin.	そしてホームズとピイクロフトとは、灰色になった皮の皺の間に食い込んでいる、ズボンツリをといた。
Then we carried him into the other room, where he lay with a clay-coloured face,	それから私たちは彼をほかの部屋に運んで来て、そこへ寝かした。
puffing his purple lips in and out with every breath	彼は石盤のような顔色になり、紫色になった唇は泡をブツブツやって、
-- a dreadful wreck of all that he had been but five minutes before.	――たった五分前までは生きていた彼のからだは、恐ろしい骸（むくろ）になっていた。
``What do you think of him, Watson?''	「ワトソン、君はどう思うね？」
asked Holmes.	と、ホームズはきいた。
I stooped over him and examined him.	私は彼の上にかがみこんで診察してみた。
His pulse was feeble and intermittent,	彼の脈は弱く、絶えたりつづいたりしていた。
but his breathing grew longer,	けれども呼吸はだんだん長くなって来た。
and there was a little shivering of his eyelids, which showed a thin white slit of ball beneath.	そして目ぶたは軽くふるえて、下にある薄白い眼球をかすかに見せていた。
``It has been touch and go with him,''	「やってみよう」
said I,	私は云った。
``but he'll live now.	「まだ生きてる。
Just open that window, and hand me the water carafe.''	――窓を開いて、水を持って来てくれたまえ」
I undid his collar, poured the cold water over his face, and raised and sank his arms until he drew a long, natural breath.	私は彼のカラーをはずして顔の上に冷（つめた）い水を注ぎかけ、そして長い自然な呼吸をするようになるまで、彼の腕を上下した。
``It's only a question of time now,''	「こうなればもう時間の問題だ」
said I as I turned away from him.	私は彼から離れてそう云った。
Holmes stood by the table, with his hands deep in his trousers' pockets and his chin upon his breast.	ホームズは、彼の両手をズボンのポケットに深くつっこんで、顎を胸に埋（うず）めたまま、テエブルの側（そば）に立っていた。
``I suppose we ought to call the police in now,''	「今のうちに巡査を呼びにいっといたほうがいいと僕は思うんだが」
said he.	と、彼は云った。
``And yet I confess that I'd like to give them a complete case when they come.''	「そして実は、巡査が来たら、終りになったこの事件をこのまま向うへ引渡してしまいたいと思ってるんだけれどね」
``It's a blessed mystery to me,''	「私には忌わしい謎だ。
cried Pycroft, scratching his head.	――何の目的で、あいつ等は私をわざわざここまで連れ出したんだろう。
``Whatever they wanted to bring me all the way up here for, and then -- ''	そしてそれから――」
``Pooh!	「馬鹿な！
All that is clear enough,''	そりアもうすっかり分かりますよ」
said Holmes impatiently.	と、ホームズはいらいらして云った。
``It is this last sudden move.''	「分からないのは、この最後の急な自殺騒ぎです」
``You understand the rest, then?''	「じゃ、他のことはみんなお分かりになってるんですね」
``I think that it is fairly obvious.	「極めて明瞭に分ってるつもりです。
What do you say, Watson?''	君の意見はどうかね、ワトソン？」
I shrugged my shoulders.	私は肩をすくませた。
``I must confess that I am out of my depths,'' said I.	「云いにくいけれど、僕には力に余るんだ」
said I.	私は云った。
``Oh,	「そうかね。
surely if you consider the events at first they can only point to one conclusion.''	だが、最初に、事件をよく注意して見れば、解決はただ一点に帰着するだけだよ」
``What do you make of them?''	「君はどんな風に解決したんだい？」
``Well, the whole thing hinges upon two points.	「いいかね、この事件のすべては、二つの点が中心となっている。
The first is the making of Pycroft write a declaration by which he entered the service of this preposterous company.	第一の点は、ピイクロフトがこの盛大なる結構な会社の職にありつく時、宣誓書を書かされたと云うことだ。
Do you not see how very suggestive that is?''	――君は、そこが実に怪しいとは思わないかね」
``I am afraid I miss the point.''	「どうもよく分からないね」
``Well, why did they want him to do it?	「じゃ、なぜあいつ等は、ピイクロフトにそんなものを書かせたんだろう？
Not as a business matter,	――それは事務的な目的ではない。
for these arrangements are usually verbal,	なぜなら普通これらの約束は言葉だけでやってるんだから。
and there was no earthly business reason why this should be an exception.	とすれば何か他に目的がない限り、事務の上ではそんなことをする理由は絶対にないんだ。
Don't you see, my young friend,	――ね、ピイクロフト君、お分かりになりませんか？
that they were very anxious to obtain a specimen of your handwriting, and had no other way of doing it?''	あいつ等はあなたの手跡の雛形をとりたいと苦心していたので、あの時、あなたにそうさせるより他に方法がなかったのだと云うことが、――」
``And why?''	「だが、なぜそんなものがほしかったのでしょう？」
``Quite so.	「そこです。
Why?	なぜ？
When we answer that we have made some progress with our little problem.	それにお答えすれば、この事件の解決も少し進むわけなのです。
Why?	なぜそれがほしかったか？
There can be only one adequate reason.	それにはうなずける理由はただ一つしかありません。
Someone wanted to learn to imitate your writing	誰かがあなたの手跡の真似をするために習おうと思ったのです。
and had to procure a specimen of it first.	そしてそのためには、まずその見本をせしめなければならなかったのです。
And now if we pass on to the second point we find that each throws light upon the other.	そこで第二の点に行くわけですが、そうなればこの二つの点が、お互いに重大な関係を保ち合ってると云うことが分かるんです。
That point is the request made by Pinner that you should not resign your place, but should leave the manager of this important business in the full expectation	――第二の点と云うのは、あなたに辞表を出させないで、しかも有望なこの堂々たる商売の支配人と云う地位をそのまま手もふれずに残させるようにした、ピナーの要求です。
that a Mr. Hall Pycroft, whom he had never seen, was about to enter the office upon the Monday morning.''	ピナーから云えば、その支配人と云う地位は、彼が会ったこともない、ホール・ピイクロフトと云う人間が、月曜日の朝から来ることになっていたのです」
``My God!''	「ああ神様よ」
cried our client,	私たちの事務員は叫んだ。
``what a blind beetle I have been!''	「私は何と云う盲目野郎だったんだろう！」
``Now you see the point about the handwriting.	「これであなたは、その手跡のことを想像してごらんなさい。
Suppose that someone turned up in your place who wrote a completely different hand from that in which you had applied for the vacancy, of course the game would have been up.	何者かがあなたの代りになって、あなたがとっておいた就職口に行くのです。
But in the interval the rogue had learned to imitate you,	しかしその悪漢は、ひまひまにあなたの字の真似を習います。
and his position was therefore secure,	そしてそのために彼の位置は安全になります。
as I presume that nobody in the office had ever set eyes upon you.	少くもその事務所に誰一人、前にあなたを見たものがいないかぎりは」
``Not a soul,''	「畜生め！」
groaned Hall Pycroft.	ホール・ピイクロフトは呻（うめ）いた。
``Very good.	「まったくですよ。
Of course it was of the utmost importance to prevent you from thinking better of it,	――もちろん、あなたに、あなたが得た就職口をよく思わせないようにすることが、非常に大切なことだったんです。
and also to keep you from coming into contact with anyone who might tell you that your double was at work in Mawson's office.	それからまた、あなたが誰か、モウソン事務所であなたの名をかたってる奴があなたの代りに働いていると云うことを、あなたに話すような男と寄りさわらないようにすることも。
Therefore they gave you a handsome advance on your salary, and ran you off to the Midlands,	そこであいつ等は、あなたに給料の前払いをして、バーミングへ追っ払ったんです。
where they gave you enough work to do to prevent your going to London,	そうしてあなたがロンドンへ行かないように、そこであなたに仕事をやらせたわけです。
where you might have burst their little game up.	けれどあなたは彼等のたくらみを見破ることが出来たんです。
That is all plain enough.''	――からくりの全部はこうなんですよ」
``But why should this man pretend to be his own brother?''	「けれどなんだってこの男は、兄弟に化けたりなんかする必要があったんでしょう？」
``Well, that is pretty clear also.	「なるほど、それは分かりきってますよ。
There are evidently only two of them in it.	この事件には、判然と、人間は二人いるきりです。
The other is impersonating you at the office.	一方では、モーソンの事務所で、あなたの代りになっています。
This one acted as your engager,	それからこっちのほうでは、あなたの雇主として活躍したわけです。
and then found that he could not find you an employer without admitting a third person into his plot.	ところが、あなたを雇うのに、誰か第三者を彼のこの計画の中に入れて、その人にあなたを推薦させないでは工合が悪るかったのです。
That he was most unwilling to do.	けれど第三者を中に入れることは、いやだったんですよ。
He changed his appearance as far as he could, and trusted that the likeness, which you could not fail to observe, would be put down to a family resemblance.	そこで彼は出来るだけ自分の容貌をかえたんですね、そしてそれでもまだ似ている所は、あなたも見破れなかったように、兄弟だから似ているのだと云うように思わせてしまったのです。
But for the happy chance of the gold stuffing, your suspicions would probably never have been aroused.''	しかし不幸なことに、金の入れ歯で、あなたに疑いを起されたのです」
Hall Pycroft shook his clenched hands in the air.	ホール・ピイクロフトは拳を空中に振り上げた。
``Good Lord!''	「有難いぞ！」
he cried,	彼は叫んだ。
``while I have been fooled in this way, what has this other Hall Pycroft been doing at Mawson's?	「私がこんな馬鹿を見ている間に、もう一人のホール・ピイクロフトはモウソンの事務所で働いていたんだ！
What should we do, Mr. Holmes?	ホームズさん、私たちはどうしましょう。
Tell me what to do.''	どうか話して下さい」
``We must wire to Mawson's.''	「モウソンの所へ手紙をやるのですね」
``They shut at twelve on Saturdays.''	「土曜日は十二時に店をしめちまうんです」
``Never mind.	「大丈夫です、
There may be some door-keeper or attendant -- ''	誰か門番かでなければ留守番がいるでしょう――」
``Ah, yes,	「ええいます。
they keep a permanent guard there on account of the value of the securities that they hold.	――いろんな株券だとか保証金だとかがありますから、いつも番人がおいてあります。
I remember hearing it talked of in the City.''	そんなことをちょっと耳にしてたように記憶してます」
``Very good,	「好都合だ。
we shall wire to him and see if all is well,	モウソンに手紙をやりましょう。
and if a clerk of your name is working there.	そして変り事はないか、またあなたの名前を使ってる事務員がそこで働いているかどうかきき合せましょう。
That is clear enough,	それでこの事はハッキリします。
but what is not so clear is why at sight of us one of the rogues should instantly walk out of the room and hang himself.''	けれどハッキリしないのは、なぜこの悪漢が、私たちを見た瞬間部屋から逃げ出していって、首をくくったかと云うことです」
``The paper!''	「新聞」
croaked a voice behind us.	私たちの後ろで声がした。
The man was sitting up, blanched and ghastly,	その男は真蒼な顔をして薄気味悪い顔をして起き上っていた。
with returning reason in his eyes, and hands which rubbed nervously at the broad red band which still encircled his throat.	彼の目はたしかに生き返ったらしい光りを見せながら、まだ彼の喉にまいてある巾広の赤色のバンドを彼はいじくっていた。
``The paper!	「新聞！
Of course!''	そうだ！」
yelled Holmes in a paroxysm of excitement.	ホームズはひどく昂奮して喚くように云った。
``Idiot that I was!	「俺はなんて阿呆なんだ！
I thought so much of our visit that the paper never entered my head for an instant.	ここの事件ばかりに気をとられていて、新聞のことはちっとも頭に這入って来なかった。
To be sure, the secret must lie there.''	――たしかにそこに何か秘密があるに違いない」
He flattened it out upon the table,	彼はテエブルの上に新聞をひろげた。
and a cry of triumph burst from his lips.	と、彼の唇からは、勝誇ったような叫び声がとび出した。
``Look at this, Watson,''	「これを見たまえ、ワトソン」
he cried.	彼は叫んだ。
``It is a London paper,	「ロンドンの新聞だ。
an early edition of the Evening Standard.	イブニング・スタンダードの早出しだ。
Here is what we want.	ここに僕たちの知りたいと思ってたことが出ている。
Look at the headlines:	頭の仕事を見たまえ。
`Crime in the City.	――『市中の犯罪、
Murder at Mawson & Williams's.	モウソン・ウィリアム会社の殺人。
Gigantic Attempted Robbery.	巨怪なる強盗の襲来。
Capture of the Criminal.'	犯人の逮捕』
Here, Watson, we are all equally anxious to hear it,	――ワトソン、みんなそれを知りたいんだ。
so kindly read it aloud to us.''	すまないが声を立てて読んでくれたまえ」
It appeared from its position in the paper to have been the one event of importance in town,	それは都会における重大事件の一つとして、新聞の報導記事に取扱ってあった。
and the account of it ran in this way:	そしてその記事は次のように書かれていた。
``A desperate attempt at robbery, culminating in the death of one man and the capture of the criminal, occurred this afternoon in the City.	――本日午後当市において、兇暴なる強盗現れ、人一人殺害したるも、犯人は捕縛せられたり。
For some time back Mawson & Williams, the famous financial house, have been the guardians of securities which amount in the aggregate to a sum of considerably over a million sterling.	有名なる仲買店モウソン・ウィリアム会社には、常に百万磅（ポンド）以上に相当する株券、債券、あるいは保証金などのあるため、番人を常備しありたる上、
So conscious was the manager of the responsibility which devolved upon him in consequence of the great interests at stake that safes of the very latest construction have been employed, and an armed watchman has been left day and night in the building.	支配人は用心深く、彼が負わされているそれらの重用物件のために、最新式の金庫を数個用意し、その上ビルディング内には、昼夜の別なく見張人を残しありたるなり。
It appears that last week a new clerk named Hall Pycroft was engaged by the firm.	ちょうど先週より、事務所に雇われたるホール・ピイクロフトと云う、新しき書記現れたり。
This person appears to have been none other than Beddington, the famous forger and cracksman,	この男こそ、かの有名なる偽造者にして強盗犯人たるベディッグトン以外の何者でもなかりしなり。
who, with his brother, has only recently emerged from a five years' spell of penal servitude.	彼は彼の兄弟と共に、最近五年間の牢獄生活より出たるばかりの男。
By some means, which are not yet clear, he succeeded in winning, under a false name, this official position in the office,	しかるにいかなる方法にてか、その方法は未だに不明なるも、偽名を用いてうまうまと事務所の事務員の位置をかち得たるなり。
which he utilized in order to obtain mouldings of various locks, and a thorough knowledge of the position of the strongroom and the safes.	そは事務所内のあらゆる鍵の合鍵と、堅固なる部屋と金庫のある位置とに関しての知識を得んがために、利用したるなり。
'' It is customary at Mawson's for the clerks to leave at midday on Saturday.	モウソンの事務所にては、土曜日は事務員たちは半日にて帰ることを習慣となせり。
Sergeant Tuson, of the City police, was somewhat surprised, therefore, to see a gentleman with a carpet-bag come down the steps at twenty minutes past one.	しかるに一時二十分すぎに、一人の紳士、革の袋を持ちて事務所の階段を下り来たるを見て、市内の巡視のテュウソン巡査部長は少なからず不審に思い、疑いを起こしたり。
His suspicions being aroused, the sergeant followed the man, and with the aid of Constable Pollock succeeded, after a most desperate resistance, in arresting him.	すなわち部長はその男を尾行し、巡査の応援を得て、兇猛なる格闘の後彼を捕縛することに成功せり。
It was at once clear that, a daring and gigantic robbery had been committed.	大胆なる兇賊の犯罪を行いて来たりたることに間違いはなかりき。
Nearly a hundred thousand pounds' worth of American railway bonds, with a large amount of scrip in mines and other companies, was discovered in the bag.	その袋の中よりは、十万磅（ポンド）に近き価格のあるアメリカの鉄道の社債やその他巨額の、炭鉱あるいは諸会社の株券などが発見せられたり。
On examining the premises the body of the unfortunate watchman was found doubled up and thrust into the largest of the safes,	また事務所内を調べたる所、気の毒なる見張人の惨殺されたる死体が、最大の金庫内に投げ込まれありたるを発見せり。
where it would not have been discovered until Monday morning had it not been for the prompt action of Sergeant Tuson.	もしテュウソン部長のこの勇敢なる行為なかりせば、その死体は月曜の朝まで発見さるることなかりしなり。
The man's-skull had been shattered by a blow from a poker delivered from behind.	――見張人の頭骸骨は、背後より加えられし、火掻棒ようのものの一撃によってめちゃめちゃとなりおりたり。
There could be no doubt that Beddington had obtained entrance by pretending that he had left something behind him, and having murdered the watchman, rapidly rifled the large safe, and then made off with his booty.	ベディックトン［＃「ベディックトン」は底本では「ベディックドン」］は入口を、何か忘れ物をしたと云う口実にて通りたるに相違なく、しかして見張人を殺害し、手早く最大の金庫を開らきて、中の目ぼしきものを持ち去りたるに相違なきなり。
His brother, who usually works with him, has not appeared in this job as far as can at present be ascertained, although the police are making energetic inquiries as to his whereabouts. ``	常に彼と共に犯罪を行うを習慣としたる彼の兄弟は、この犯行には現れることなく、警察にて彼の行衛（ゆくえ）について極力捜査中なるも、現在未だに不明なり。――
``Well, we may save the police some little trouble in that direction,''	「そうだ、僕たちはその行衛について、幾らでも警察を助けてやることが出来るのだ」
said Holmes, glancing at the haggard figure huddled up by the window.	と、ホームズは、窓ぎわに目ばかり光らせているその男を見やりながら云った。
``Human nature is a strange mixture, Watson.	「人間の性質と云うものは不思議に入り組んだものだ。
You see that even a villain and murderer can inspire such affection that his brother turns to suicide when he learns that his neck is forfeited.	君は、強盗や人殺しでさえも、彼の兄弟の首に縄がかかったと云うことを知って、自殺する気になるほどな肉親の愛情を起こすものであることが、分かったろう。
However, we have no choice as to our action.	しかしもう私たちは私たちの行動について躊躇しなくてもよい。
The doctor and I will remain on guard, Mr. Pycroft, if you will have the kindness to step out for the police.''	私とワトソンとはこの男の番をしてますから、ピイクロフトさん、あなたはどうか警察へこのことを知らせにいって下さいませんか」
